"date (UTC)",description,"moneyIn (Satoshi)","moneyOut (Satoshi)","tx hash","current balance (Satoshi)"
20190417,"PAYMENT RECEIVED",1295438354,0,679314252eb621840c66db76d2b08061fba5acdd56719a58fe2e32d91df435ca,70331385978
20190417,"PAYMENT RECEIVED",1325189026,0,cb22d1901675946915e4eb4744f047f730bacac15fdff4e71a06360d37adda12,69035947624
20190417,"PAYMENT RECEIVED",1321089698,0,746363461675d348f314549d03a887c05d1270ff042b352a1609f15694e4dce8,67710758598
20190417,"PAYMENT RECEIVED",1308266930,0,badcfc099caeee7c2610d4dc9cf99a5704f5071821256e8820fd30907fbec096,66389668900
20190416,"PAYMENT RECEIVED",1291566919,0,f6e08bc17e6d1c0a72153cb0ff77d744b6982d56c9953755e6799439b2becd52,65081401970
20190416,"PAYMENT RECEIVED",1260746709,0,5dca44a9bab000fcb3cd06986fb7669311c7e382873d1a68d556f6b79fe999ef,63789835051
20190416,"PAYMENT RECEIVED",1290695696,0,b3a425ad85d18aae3287f221d8e44bb9ac764a11c18a509c5b61905a0bc14e8f,62529088342
20190416,"PAYMENT RECEIVED",1299479470,0,476c94355140412df26984a5d49469a59f5dcaf36bf799231448a6d3a57caeba,61238392646
20190416,"PAYMENT RECEIVED",1311312074,0,e12e231d5754b46fa4a0c4d31d1d036bb2a7afb2e1977ce0d76c37b7c9d60caa,59938913176
20190416,"PAYMENT RECEIVED",1324261450,0,4eaa75ab992e7da66e3050aa0f439a7f1b167b4b77e265e63c7382e3c25b37b3,58627601102
20190416,"PAYMENT RECEIVED",1304492606,0,d18941597ab8b6436b1bc401072170e85f79afe13e55887d232691e65c2bf048,57303339652
20190416,"PAYMENT RECEIVED",1312333710,0,90a9e3579015870dfff53061c9a7908869bb6c90f0aa2d4de808ad4a2f701577,55998847046
20190416,"PAYMENT RECEIVED",1334133583,0,7cddb2ebeb4f4dc6c3701c4fcb5d2d9b6abf83404bc777af26b8643941320e22,54686513336
20190416,"PAYMENT RECEIVED",1342752545,0,4526f9fe66f7effd1eb95f17ef88e2a5193ca18f3c098a9e66f8c70eadd1b5fc,53352379753
20190416,"PAYMENT RECEIVED",1282823129,0,3334e6d3aaa4a69584cbc5a26b2750e030b20b32b5aff94ed745a65c2a9f300b,52009627208
20190416,"PAYMENT RECEIVED",1298339387,0,a2a043af8eaf970948a117f784b3a0447aee563e85c090c9bd6c7f1adbb751f3,50726804079
20190416,"PAYMENT RECEIVED",1345725055,0,e3458dfc7e9629e2936e76555fe7b7f80a4a7e77470b83575fb760ead2678df7,49428464692
20190416,"PAYMENT RECEIVED",1255445939,0,25eb42c7891570dfdb6d59ab3a605b74a1d1efa75ab5327bbb4526623d1acb01,48082739637
20190416,"PAYMENT RECEIVED",1335149948,0,5dd7ba948e9629a37c988f98ef97e30bf8a3c280e1f9dd7f5d0a0bb49bd0743e,46827293698
20190416,"PAYMENT RECEIVED",1264116733,0,7768afd925ea14d3f278b2d9055f78ec3e83f05a3b7f3a4fa8c22c2343170b03,45492143750
20190416,"PAYMENT RECEIVED",1265831125,0,5528d3c395710905023771459922f70a71ce507bf5bb826f6cd88d2af11690f9,44228027017
20190415,"PAYMENT RECEIVED",1317873072,0,2ec97ba12fb781493e3b91d1546272a8c9582ca5d83a3280aa32812b0fec0573,42962195892
20190415,"PAYMENT RECEIVED",1296360089,0,7238c8029f5c367325662ba5c8f096e7637ba214547d0f77e33bbbf42b7f87ee,41644322820
20190415,"PAYMENT RECEIVED",1266186820,0,2f7679c49299d6f996a3d6f8fe9af95fe325ddf997eacb66f2c27af25aae0ef7,40347962731
20190415,"PAYMENT RECEIVED",1324204591,0,4688ff3225c8ad504d34a5f734ee661b704a7f9fb4f574badf9e8d7b2f10efc8,39081775911
20190415,"PAYMENT RECEIVED",1268774307,0,d5fcfe7c95e348b809dab2cf401bce5f0926d38620d448e8d2647e938a49a579,37757571320
20190415,"PAYMENT RECEIVED",1289071610,0,7b9e7a0838bbe2df3bc13c22c333aae7586f3970ab506a9901993e84b310ce54,36488797013
20190415,"PAYMENT RECEIVED",1340104648,0,d4155c5c7df86e2a6d8c2d4c6aa79b323d3628e850111711c0abcf9a5156a2ce,35199725403
20190415,"PAYMENT RECEIVED",1304655380,0,292e6608825a188604df979427b93a892b0149f4e1d7fc00071bc5901d325908,33859620755
20190415,"PAYMENT RECEIVED",1256762404,0,110c83a92b40d4e56bde5f8f5e75ef4634279c84fba763f47ecfc685bef291fc,32554965375
20190415,"PAYMENT RECEIVED",1322012238,0,61bb791edde482ca54f58b6c0f393a844b90ea108810be508d6c25767d0301ba,31298202971
20190415,"PAYMENT RECEIVED",1314946708,0,529e371b6d9900b29b3cc138d28e2fbe29edabdfb4148c396fa73324ca56732d,29976190733
20190415,"PAYMENT RECEIVED",1304439436,0,88f7ef7f3cf516e3be60dae6652e272b6e0808c1576803410131e07344fd147f,28661244025
20190415,"PAYMENT RECEIVED",1343552366,0,03cd6893d046c977ae3d0bb35ef03b960281ed0197e3be0f157ee7ec3791aad6,27356804589
20190415,"PAYMENT RECEIVED",1267322155,0,f5541bc9bf445f2bd04a4e1e861d4070912b4dd9b04afd5160446180a12e79d3,26013252223
20190415,"PAYMENT RECEIVED",1270686940,0,891ab021cf26eb41de1695e218d28348889d0c4df5a542a2d037a13bd24157a6,24745930068
20190415,"PAYMENT SENT",0,-30876814323,3fa99bc1a78b3d64f1392c252da546513938eed23b1a727d7a7efd8153467038,23475243128
20190415,"PAYMENT RECEIVED",1280640547,0,b38d9852e39a8e27ea8b3272b09e3da13eab417703d2a93c205908bc05659b3b,54352057451
20190414,"PAYMENT RECEIVED",1278669953,0,4d37cf13f92d2fda5217b1dcab0df76f915d9a51540cddecc428eb5f4fe0eaa6,53071416904
20190414,"PAYMENT RECEIVED",1322078395,0,b2db1b451c888d6a8b1d62ab0fa801911ba3b2ce7ef603e65fc4d26177c1deae,51792746951
20190414,"PAYMENT RECEIVED",1268331899,0,baf729b7d44f00130a85fcf3317f79e53e79f2207fdfe3f0948b4f02a27a154c,50470668556
20190414,"PAYMENT RECEIVED",1283449611,0,6788ed4d8edc1926953bc659650b0d2f12fcc36f203b6326090c4ba23ac9c136,49202336657
20190414,"PAYMENT RECEIVED",1346610697,0,7482b8c1f0a91bfa6d1403668a6e0ba06f7f9aedbc160c31763416f649801bd3,47918887046
20190414,"PAYMENT RECEIVED",1334316539,0,bffc0063d22f2acec92a424fc36c80ae3a592d204ab5ede7860dd0aba8ce1351,46572276349
20190414,"PAYMENT RECEIVED",1319789797,0,5056fc181c56fb3567479b8696e11f4d6cd6912ec67431c4c4a8c7ba52ef238a,45237959810
20190414,"PAYMENT RECEIVED",1375548336,0,6c172075ad23c2c1f286dddd706d3732365e7f0971609a3364784564494c6ce5,43918170013
20190414,"PAYMENT RECEIVED",1361742523,0,a31c07287352c10d8abb6343a36f85742f69ed06f4757a7c452c3e5383a72b86,42542621677
20190414,"PAYMENT RECEIVED",1344856556,0,5495aba5a1c0cfc7fb917841a192c789ac959591e6eb4ef21f26d0fc4c598266,41180879154
20190414,"PAYMENT RECEIVED",1281432003,0,3b55cffd9a0e0142dcfbebe4f11db9f12e8590b974cc282c86bc244f65a6ae3c,39836022598
20190414,"PAYMENT RECEIVED",1275135005,0,d336cdaae164e7f47f68967389abb765e1eaeccf56656a157988b6c7541b6465,38554590595
20190414,"PAYMENT RECEIVED",1262995131,0,489380adfada91dec65b2b79306928ff7d4753675d94cbc8862ee96002004385,37279455590
20190414,"PAYMENT RECEIVED",1282619007,0,f249be92ceaf2f5a3812b94942aa91cb14e1a72cab107985a24194c8bda27688,36016460459
20190414,"PAYMENT RECEIVED",1296544878,0,9256aa04554df7ee11055c6d17f0d365b418beac39fa8cd099a6bf6bbda1698a,34733841452
20190414,"PAYMENT RECEIVED",1252743557,0,7f6ab981b20d4588b49d147f802162c1268631b46e6166f020b9534a1f469842,33437296574
20190414,"PAYMENT RECEIVED",1292812994,0,d5015bbfaf6a80202222f4c5f4dea0b3d98a792b3f8835d3ecb9081a6c6dc7f5,32184553017
20190414,"PAYMENT RECEIVED",1294752112,0,dadb7ef7b8e64fb014baf8df79ed906245d01d367489075b39301ca03ba31b6b,30891740023
20190414,"PAYMENT RECEIVED",1311937696,0,353da1a1f81a9315644173007a18cb0aa6d9ed6691bb795efc2571afe83c739c,29596987911
20190414,"PAYMENT RECEIVED",1257270845,0,5315c1c6e817bd3a96cd749dcbe7890d540e99866f2d65e378d797b0b47459bd,28285050215
20190414,"PAYMENT RECEIVED",1275451251,0,7038c532fc292d19144bbbb781e5aa71036d5ce18c9bcd5b86ac473209dbe8c3,27027779370
20190414,"PAYMENT SENT",0,-39922118206,f2cd8a6d201087160c1dc28c40e24974c2269146cc3aaf90cad3518851126caa,25752328119
20190414,"PAYMENT RECEIVED",1253118909,0,094db3c9e1a5dc0f53d4d0c91932500a603a2911b1c0f04e045eefd1e9875b02,65674446325
20190414,"PAYMENT RECEIVED",1264601783,0,fc2c5821be0f881f96411bc10bf9a59bf13da855d4ef2d867eb28c987f4d348a,64421327416
20190413,"PAYMENT RECEIVED",1275245302,0,9b4ae8dc9392ac0245e22c39081fc2e079fb3d2614bab363d3229c0476b10a8c,63156725633
20190413,"PAYMENT RECEIVED",1267734024,0,e4b9815b2c70728b718113e8196353a69545db675ee16d888de451fa2f44512a,61881480331
20190413,"PAYMENT RECEIVED",1277190848,0,d39e5d97960177b04e408a86293697ae5b5334a06bfa414f4f315d69632bf31b,60613746307
20190413,"PAYMENT RECEIVED",1292354859,0,ce5b20e9eebe5d1a673e2f0fb7340d244e83fa7376440579e2468b168e8a15f9,59336555459
20190413,"PAYMENT RECEIVED",1280397882,0,3c1074697325e0499f0c10113e8a7f65dbfd9707c9e50bd06b9371e8b5cfaa45,58044200600
20190413,"PAYMENT RECEIVED",1357861119,0,d39c3bd72fb1bba8a25c347ae6d539a9e133ebaeeabee32dd12cf4877cb3289a,56763802718
20190413,"PAYMENT RECEIVED",1333260887,0,0124b5022846ad7184018694b63e17ddb73b977377e5e92bce07a511fb6c3065,55405941599
20190413,"PAYMENT RECEIVED",1379031489,0,c679d0d847c9fa46fc6e97ad037527139eb1e7070ac61406471c75bdefb70c91,54072680712
20190413,"PAYMENT RECEIVED",1258151451,0,89496762cc81ed4bc1c812636ff200927692552fcbc6a6382f44b35ea16e3a16,52693649223
20190413,"PAYMENT RECEIVED",1328904289,0,9d9aab77bb2543b0025af212484b42ae8a33965bc493a5f5253d0722808fab5e,51435497772
20190413,"PAYMENT RECEIVED",1361741144,0,1f1833ad8f2db65933e2f572b2ce1836c17437fa34dd81026988e7abc4f46224,50106593483
20190413,"PAYMENT RECEIVED",1258642844,0,9a4ff11b00bd09f328d6575ea435970843d6741f1c7d12f19ba19b95d470eaa2,48744852339
20190413,"PAYMENT RECEIVED",1303334179,0,feed7f574b8cd5ba0a5a3b81bf80c9dedefdf3f5f0c3b8d46c0b81416fb07e5d,47486209495
20190413,"PAYMENT RECEIVED",1283291403,0,b858e36898d32ddb853875b10fe3d263524bbcb338b62b63649c000abdc1475b,46182875316
20190413,"PAYMENT RECEIVED",1355130545,0,ee7abf38b0a8260920d7b8e620ba95f730fa3383d62a9a4223f359ad39ca93ae,44899583913
20190413,"PAYMENT RECEIVED",1290001059,0,3498976b8b11fce22d212299e993842f528bac310b4db3cd22ed40e1fc38942b,43544453368
20190413,"PAYMENT RECEIVED",1285161417,0,f7beb7c6fe6cfd4f5a2e570893feefcd86170b1c139e31401b077528a1a43108,42254452309
20190413,"PAYMENT RECEIVED",1250078248,0,e47b16173c0b9a7d33b966473f938be3d7e86ec775b50151b58588d8793f1a1e,40969290892
20190413,"PAYMENT RECEIVED",1268275320,0,fb576f02321efe9bc0e2323a92a3556c02cfe12070d4d5d1960a2a7cc536824a,39719212644
20190412,"PAYMENT RECEIVED",1314236136,0,31a06cf9e399ca2a47ce1c8a37d9f319354ef11a330ca5fc6e9fb1d140785ab0,38450937324
20190412,"PAYMENT RECEIVED",1267362593,0,fe516f07c1085638fa6bde9071ae81789380bfb3b9fff4f94f671443aa73ede7,37136701188
20190412,"PAYMENT RECEIVED",1354613266,0,2c01dd3aa4ca213462e17071761a878ca9d3006e3ff9a96fad5f6033ca4a3c58,35869338595
20190412,"PAYMENT RECEIVED",1313834408,0,f912e2dca8a344403fb5283e1be979ca8baa8c497d16cd191a4ef9debea84f07,34514725329
20190412,"PAYMENT RECEIVED",1336131314,0,85260e36980b60827c0beda3a4ab3afc0d7fbc067356eac1ee953f04f589ba00,33200890921
20190412,"PAYMENT RECEIVED",1301032946,0,d0a624ce29ac078c7470028dd78978ad73df75a7458e651dc92901535a32f055,31864759607
20190412,"PAYMENT RECEIVED",1383834708,0,f5f5c1043fb6c1cd3e0aefba3db90813f127c4c2824a6418159e9695cd47e370,30563726661
20190412,"PAYMENT RECEIVED",1256763660,0,5a4c630c8205314b9cd7a03c840144e80676f1f9960cfa6194d30fd80eb4a4fa,29179891953
20190412,"PAYMENT RECEIVED",1299918008,0,775fc963f6704318ed6dce55710a17c01f26071074d144c1566a545e8ecdf111,27923128293
20190412,"PAYMENT RECEIVED",1379055949,0,4dd37e8d20b88000f3dbbefad37ff82d3a10cf34415eb1b9e0ca78e4f897be01,26623210285
20190412,"PAYMENT RECEIVED",1329536320,0,cf0aaac80f10c357a0e34e165a76bbd951d5ad08a648aee7ad41ee85e383b181,25244154336
20190412,"PAYMENT RECEIVED",1358476907,0,43bac40077a10f360aac7fe26f7a56f1991b924ef3798412dd9e399d739c279c,23914618016
20190412,"PAYMENT RECEIVED",1307824135,0,d0923c855a3cd787c6a11fb23131e5a6ead3ad8bd23876cbba660e853d50a3fc,22556141109
20190412,"PAYMENT RECEIVED",1347571693,0,448ee13a16b0d1c7ba7b96790a6b8c3bc1d7a687025001614c3eb8c897da43d6,21248316974
20190412,"PAYMENT RECEIVED",1312804763,0,e748a360184b4d47bbbaf7f69ac997e5db8a572525955385a909266cfdbb03e7,19900745281
20190412,"PAYMENT RECEIVED",1369930523,0,eed69ef40e9d6de750902d601ba07f88af8c7d43767c7b61d1ad22d44a1e6555,18587940518
20190412,"PAYMENT SENT",0,-59622118886,017324673b45d2b619d40f83dd16a386ec2229da5e6ea1307fdc215030752b6f,17218009995
20190412,"PAYMENT RECEIVED",1313027354,0,6ab1c8dd6502b033e30ac050a55bb2bb525b6dd73c1393de4c3e09d743d191b2,76840128881
20190412,"PAYMENT RECEIVED",1257326821,0,bf722a9ab8f5b64621a504b09ccec9ceb9dce2999be9a408b5750f49201acbcb,75527101527
20190412,"PAYMENT RECEIVED",1374731895,0,8168a85de554a823c80cd54fc9307baff3e006a4eb836f7d7b62186aa01be6d6,74269774706
20190412,"PAYMENT RECEIVED",1347344439,0,d870de1ee6574afd1cf8a88d589310a8091ea24ba5882db3af3fc78f197f3c51,72895042811
20190412,"PAYMENT RECEIVED",1291048431,0,d12ff16bfba858367a9375ea26cdbc041847b5fdd4dbe619f63aed1d3f925135,71547698372
20190411,"PAYMENT RECEIVED",1256526365,0,99317c94dd3adbcd687dde48bf5b9b727ba8676940b75ef7bebe9a2fc3031465,70256649941
20190411,"PAYMENT RECEIVED",1260104792,0,071efd8906b96c5ccc56d71ac258992fd5e76eee21510afdd646b1fa6b65f527,69000123576
20190411,"PAYMENT RECEIVED",1355036743,0,764baae752b88faa99e93b42bfb271a55d4aba20a090d511fb567546ccbfe334,67740018784
20190411,"PAYMENT RECEIVED",1354937773,0,42356777ec67123c9d9337d23259964b05c5eb73884ec29b6aa169ede2626456,66384982041
20190411,"PAYMENT RECEIVED",1371972807,0,807442e6d9f88ea030d300a1d55f5a2d540aa1f289bea8d5a4c904d358653735,65030044268
20190411,"PAYMENT RECEIVED",1392737413,0,b4492630fbd49167458451099c08f8e10dc69f65ce630adf1018cc0b769c7368,63658071461
20190411,"PAYMENT RECEIVED",1324277290,0,86dde5858c20e81058ed077095a1b645698a8cc8f7670299ab418b5e22c4ab2c,62265334048
20190411,"PAYMENT RECEIVED",1318937872,0,de10421074f3357b593c4595f2e3ee832794d60080a3c231141606ad03d3b398,60941056758
20190411,"PAYMENT RECEIVED",1410069202,0,6120ea735f8b98e3c40bfa07386a8999c626c0e79b195657fbe1b2cd4ad3c71f,59622118886
20190411,"PAYMENT RECEIVED",1388527630,0,31adabaa9775f0466d158c6d6964872e76971c4059d4c0d75c6621790c08948a,58212049684
20190411,"PAYMENT RECEIVED",1381274087,0,a716a5c1796c04f43a8f8705cd3127efbd5bf41ba56d8dd3c2b82768c5147bfb,56823522054
20190411,"PAYMENT RECEIVED",1291578528,0,bb8f88bcd8d031ebd0e35c51056a1cdd2ece5a3d82f082160432d357f0aa85f4,55442247967
20190411,"PAYMENT RECEIVED",1302354045,0,20a8e119aaccbe177ad84089e94e01bd7ca8fa087637f7c7fedf6995d615ef27,54150669439
20190411,"PAYMENT RECEIVED",1314151404,0,1e193ac51c728ff0632c9ec0bad20dad9908b830ccb055a08081001e36ecba70,52848315394
20190411,"PAYMENT RECEIVED",1344781113,0,4af72e2128e4a481e2ace0a9a345ebe00cf694887c4200dbfbb430710d35a1a9,51534163990
20190411,"PAYMENT RECEIVED",1378283886,0,025a826b7361bbf1a966d30ce3678ed7f6d9ee4326885e3bcd48078499830e48,50189382877
20190411,"PAYMENT RECEIVED",1317993390,0,7d3a1412bcfcbf3697a50a456881c4e974d205da2e7a82fe15d001b1130733bd,48811098991
20190411,"PAYMENT RECEIVED",1254568154,0,1301d45ec199c2c29ad0a700e547260f01fb687e896ab54357a28af527da10d0,47493105601
20190410,"PAYMENT RECEIVED",1254037005,0,ef2a4ec897a3dbe30bf9fb679742c57ac260280272fc51416f058b89e3fdbfed,46238537447
20190410,"PAYMENT RECEIVED",1286753214,0,e48b549a8acd76c0fb16e20c5ea9a195b1d5131cb22a6dc5ffb0783e9caff88d,44984500442
20190410,"PAYMENT RECEIVED",1309399579,0,19fa8bef8fc860ab1c1a84dd13caa5368d281a89bae073df7af5a3e1f1bb454c,43697747228
20190410,"PAYMENT RECEIVED",1345529587,0,12024c8056ec05e92d97ec0ae9cb9e1703b2d6777594e6daf80e48a3c41d8036,42388347649
20190410,"PAYMENT RECEIVED",1361140627,0,1098340cf3639ff6583a50864dddf7bc989bbb95fe146555530a3440c5407e9a,41042818062
20190410,"PAYMENT RECEIVED",1308727867,0,064f17abc5bc2cc8088dae3ff7a11002fce11dffc832ba70af1336d6a26c551b,39681677435
20190410,"PAYMENT RECEIVED",1346080982,0,4c27093ab22ac8730029d400893afceedaa7b5567c818a79f2304bb7ef9caacd,38372949568
20190410,"PAYMENT RECEIVED",1411060743,0,2c66d3b30a57dc4061a7cad2b35779f4ab8665068d528543d66bbc81ce1bc5b3,37026868586
20190410,"PAYMENT RECEIVED",1322419575,0,5f070b74fdd96ec965e2c2c6a7fddd0c478f369695d40d5073b76e3adbb60a8f,35615807843
20190410,"PAYMENT RECEIVED",1365440905,0,66e2fe1bd27a4e4c5e5b3c2d6b57b866b589b42220b052b564763ec281d8f1ab,34293388268
20190410,"PAYMENT RECEIVED",1371112780,0,a35fb588f128072e69d97102e13e12a53e30b0ffe57a02dedf85efea2103963d,32927947363
20190410,"PAYMENT RECEIVED",1288894042,0,828479a1be16818447aa59c11b0e33841307ae24970118b20756f10776b78f59,31556834583
20190410,"PAYMENT RECEIVED",1296188012,0,af60a6ad90e7fb8e72b8d1f6e1f98720f108681582e9d2f4bfc0d37c330617e0,30267940541
20190410,"PAYMENT RECEIVED",1270526057,0,bef5e54be3e07253d12dc618c24c1c54bbe2fb1fa471d4eb21dbc7c650645725,28971752529
20190410,"PAYMENT SENT",0,-19710969383,7c1475780c3d28130c1f678a0ed383ab741fbd37be98da153a7e1ce611271b97,87533476083
20190410,"PAYMENT SENT",0,-59832249611,c48806f79fd9d367faf8a534edb27c40b07f6d3ff0a9acc64c5e39d83b99065a,27701226472
20190410,"PAYMENT RECEIVED",1380844914,0,04b431414fc61748703821e1d6a67b02455db9ac49944db5d592e97d0ef4b00e,107244445466
20190410,"PAYMENT RECEIVED",1296724263,0,4694c42367f3f3d69f59e38b20b98e2571218be3c31155541ad839f6cc804dc4,105863600552
20190409,"PAYMENT RECEIVED",1381635755,0,e19bc6484ceaacd15928ba5c60dee133ce012117b529b8a80aecb86af68df4ef,104566876289
20190409,"PAYMENT RECEIVED",1377920500,0,7acd6f249696ee9412617b0d39db8d0014ad4cfbd92a7fe2368b843fe4b889ce,103185240534
20190409,"PAYMENT RECEIVED",1339132705,0,dd436e71c51bf17f7f11f321a01cbf03cf7aff9bd63182fed82e64a4d1edf4b3,101807320034
20190409,"PAYMENT RECEIVED",1317320489,0,6f90c3f765f3d566c5884d8a283b8111aa92a36e332f799c90c13890eb61f4dd,100468187329
20190409,"PAYMENT RECEIVED",1277444189,0,495642cde7b039090e5784ec8c32c5a2687bc8c4606ac01349cf0fd3583caea6,99150866840
20190409,"PAYMENT RECEIVED",1365369693,0,c6982522b0b27c96fc82d3706d6fd6b88032ada168e8a05afa09d33b260f19ae,97873422651
20190409,"PAYMENT RECEIVED",1309636708,0,9fc23ebc8a5ce82030294ca7ddf08c2a5f5f5f1ffccb23d4e39029a6b9bc8890,96508052958
20190409,"PAYMENT RECEIVED",1378762777,0,a44e8a7767d824cbdabbfca6a6504e0a204c0a5b3d7eec251955eea169992626,95198416250
20190409,"PAYMENT RECEIVED",1317011469,0,90f2a32363a9017e2abd318d963f667caa8d78b109e1731e2581249d43e5f6f9,93819653473
20190409,"PAYMENT RECEIVED",1354791149,0,cd502fc1d054fd27a9d0aea03de0a9b9e8128474a43cdc4412774a7d9dc85240,92502642004
20190409,"PAYMENT RECEIVED",1304091509,0,29ed16631e56dea0d129b9d3b5b793aa6cee7bc8e7d2988c14168ec00cb1a19b,91147850855
20190409,"PAYMENT RECEIVED",1401442991,0,786f0da210529cba9c5a3320d334658f586f20e632cc22181f2aa59b80b05c04,89843759346
20190409,"PAYMENT RECEIVED",1300646161,0,aefc6b0bf7f68705f81a74d43bf501be542cf87072d053fe603992633674cd1a,88442316355
20190409,"PAYMENT RECEIVED",1302173253,0,9d00538af35a3da612e122a49e9b6cfa5ae27f2676457cfaa4024e937be42872,87141670194
20190409,"PAYMENT RECEIVED",1383229582,0,8e45dc031130ca1861826871eb56d94fd4e3fa3f75b697ab15b25bca2ce9a1f7,85839496941
20190409,"PAYMENT RECEIVED",1357330488,0,44d82de388cacbc54a516b00f3e3b0078e62e8ab1b6284916e1c3f3c7a68346b,84456267359
20190409,"PAYMENT RECEIVED",1378672974,0,83b380ec952efa3e41b7690c2876058476362077ddcb4121db0d7f981b9338c3,83098936871
20190409,"PAYMENT RECEIVED",1260527542,0,b5aa34d60ee08b0aee40e52e3f6a40e8690a63b2e62f0d3dfa2b53aee1c88a27,81720263897
20190409,"PAYMENT RECEIVED",1339661779,0,de11ec1588273d432536e9fa76bf7ee3c5f3021abcc9c228b134773f18afc780,80459736355
20190408,"PAYMENT RECEIVED",1264135893,0,3337b6c629f2c6603ebe91b4ccef0736111e4d12dce33d6d390827560bd32ea5,79120074576
20190408,"PAYMENT RECEIVED",1338431486,0,38129794654c1e133cce0079e6a9a6cb565ffce53d3502535bb3c2aef7f13382,77855938683
20190408,"PAYMENT RECEIVED",1347640075,0,7fd62e1b4ab843ffba23fd4811642edbfab4b55f387c016c932c844498b0920e,76517507197
20190408,"PAYMENT RECEIVED",1265526531,0,e6f185b517ad3b52d188e80195df7998cb20ff676d509837fe7e7911ec977219,75169867122
20190408,"PAYMENT RECEIVED",1335463090,0,e6fe1ff0dbb647f51f27083e1a419f4c681769f7b94334446f5d8a708b35b865,73904340591
20190408,"PAYMENT RECEIVED",1348935841,0,4d33594cb92be3f593cbf439bbcbe2a706eadadec60949c05c31cb487f5f15cf,72568877501
20190408,"PAYMENT RECEIVED",1397725227,0,fb2e1642178d0b4885e8a183adf9b89ca9b9fe1b731a708eebd256a6878e380d,71219941660
20190408,"PAYMENT RECEIVED",1424464206,0,c897ed302cb95e8803fe42270b719b0e5ee7561156ee8182487a9dfa047aac9c,69822216433
20190408,"PAYMENT RECEIVED",1364384922,0,45edd68629ecc4285b1863582d8ab63ddde4654842f777d5d4e2fdeca6cd2735,68397752227
20190408,"PAYMENT RECEIVED",1380683885,0,b833e7804f2f8bc526069acb5dde8d9c490e6e69e2c8b2341bd7c8c07187ac42,67033367305
20190408,"PAYMENT RECEIVED",1401589177,0,84b126f491347eb806b79839140a1b09814e55d7c9455fa2182e4648126f2519,65652683420
20190408,"PAYMENT RECEIVED",1383077384,0,670d6fce1bf5914d16ec731c3cfccee59b1a4e33e7b94aaf88d7e57425989cc3,64251094243
20190408,"PAYMENT RECEIVED",1334571043,0,b90fb336504bc5e32ab85e187e4eab37fe3b5b954d8c5e92a54c67283a3155a0,62868016859
20190408,"PAYMENT RECEIVED",1336512305,0,58bfeeed51b3e11a9eca306df0dea21013b06d336d65765ae7417b296f4ce337,61533445816
20190408,"PAYMENT RECEIVED",1359400166,0,2ac5b13f8688480197ca74c1b5365527f4ad093dd0de76917714513fe1598856,60196933511
20190408,"PAYMENT RECEIVED",1372476510,0,c41adfaf574e06492c4444645a98913e374940d873e2697ef1930a765e17d685,58837533345
20190408,"PAYMENT RECEIVED",1360449859,0,94e09ab32b34fa50eb315c1e88a3042ef361d24061db5915bf52b381e31195b5,57465056835
20190408,"PAYMENT RECEIVED",1310820938,0,68ccc67365414dad217d34d960011802cb0be5c13c8f20f1944a9e07343703ce,56104606976
20190408,"PAYMENT RECEIVED",1368033937,0,801244d264b35175744ab41f3316719f776c46014691b43e1f7d0c16bd271f5b,54793786038
20190408,"PAYMENT RECEIVED",1296854490,0,45d30664a54b7dfecf5ab1b50eb8be0014c1c0511bc191be92efafb2e613b711,53425752101
20190407,"PAYMENT RECEIVED",1269221858,0,6c668d73694f50eee8e17dfa3c9b8ef1d8fc222cbaa10b522f338b71705044d0,52128897611
20190407,"PAYMENT RECEIVED",1271634554,0,320371b45aba9d7ebfbf9caef9ca4c0d42ab08f7dc7bc731265e6c80d67ed231,50859675753
20190407,"PAYMENT RECEIVED",1292859947,0,2eafeda7aba7d9ab4b9707dac2db308ba89d2c163566e6fc2a76f4c331121d7d,49588041199
20190407,"PAYMENT RECEIVED",1287019610,0,bb0b966788bbbabdf86c8b1dca68d050008439b7de84fbd1b5d91c06b72f864b,48295181252
20190407,"PAYMENT RECEIVED",1280994853,0,8be25ec136d05f42a4a1671fa78fb9bac8e7f1b94f5fb117ff23f064e493b878,47008161642
20190407,"PAYMENT RECEIVED",1336845500,0,6d7d1719a1df6d637583385dbcbbec169ed63d023bc0fdd73bb725e5a441d59b,45727166789
20190407,"PAYMENT RECEIVED",1293658898,0,89f7edede36878714eb81e0342dc7f87f3727841385b292fdd231b7f2fb5e40d,44390321289
20190407,"PAYMENT RECEIVED",1313244790,0,365cdfdd5d96313982eecc7f717aac2bafd15623b8dc55718a6e9e859bffd530,43096662391
20190407,"PAYMENT RECEIVED",1339265236,0,1a66cc011b8c107e2672b1742f02acd6dde3f94cf14bb428b0bbea4d2cc0a0d2,41783417601
20190407,"PAYMENT RECEIVED",1365379976,0,87a2176f97c26b05b643322967d7cb9e8a0a8e2ad970aa445a792906393cd39a,40444152365
20190407,"PAYMENT RECEIVED",1410311734,0,3ac8d67853a8f111945ff4efbbc2f2b5276d97b949a3904bfb40581fed984883,39078772389
20190407,"PAYMENT RECEIVED",1374740104,0,46806898214a32c3deaf6d201c4508ade6a3f7e53cb9edb1dba14a54d68677b7,37668460655
20190407,"PAYMENT RECEIVED",1324595017,0,e354014428b2740f846e719c918067531abec157ec04066887a7bfb924499caa,36293720551
20190407,"PAYMENT RECEIVED",1269622508,0,adf3fb77cb27d83fa0ea1b36319c39fb823db6f06ff8149650b766201719c958,34969125534
20190407,"PAYMENT RECEIVED",1280193025,0,7a20d198a1709c02bb1a1b3db41fe4e8be0c4a9c8e5fbfd645eff1d1ebba3789,33699503026
20190407,"PAYMENT RECEIVED",1289501803,0,511d3310f551701d5f383a41a84dddd39b96bcca95755c8dbf4fc216fc6cc38b,32419310001
20190407,"PAYMENT RECEIVED",1256633658,0,a7048a7cfd79037f57197c4eb38f7b801a8fa2c136424e90c1bd3275d1f064de,31129808198
20190407,"PAYMENT RECEIVED",1310056929,0,eb1feef5670757fa25eaa2ac46031ef7304cb19c5c6dc1ec63254cb01c4316b6,29873174540
20190407,"PAYMENT RECEIVED",1300745037,0,0148a75fefe81c6ab8e96b55b4144c4eb7f6d8a8efa575a4d036316c9e0b786c,28563117611
20190407,"PAYMENT SENT",0,-39902869155,4822f3659556e12704435aaa6c42783f356e68b0c36c0199de96e3e79fe309bb,27262372574
20190406,"PAYMENT RECEIVED",1260631829,0,2a60e351addd4cc6c6022f5131c0185594e80827947c4320eb8142755fe30ec3,67165241729
20190406,"PAYMENT RECEIVED",1316048654,0,c61fbcb0c74812764fb1bb4775a8ba9f68a5647794118ce7ba0e19d77f33e9e4,65904609900
20190406,"PAYMENT RECEIVED",1335223930,0,d92d43e4da23e2f798cf7aff9d250e1dce8106a1bb0d5af7c877694a0e474b78,64588561246
20190406,"PAYMENT RECEIVED",1256581018,0,36eb91fcc03ddf933db8b4c22b8b42c6384c1b4227564ccae0742d35d5976f13,63253337316
20190406,"PAYMENT RECEIVED",1321839853,0,544ed356fe3f979b2d7e5ca3d290461e1e9a81a543b8538e94c5568f3c512778,61996756298
20190406,"PAYMENT RECEIVED",1433317258,0,f0c3955611bba9b3a0243e0303453f59003cc65da1b2ee88e024584632fa8e06,60674916445
20190406,"PAYMENT RECEIVED",1257319565,0,b7d3d8ec0125f995d6bd769d023991353925671936c9b183eae299d663ea17ba,59241599187
20190406,"PAYMENT RECEIVED",1292593963,0,bb7f83c1774d842ad824f18be4b0a223356edc2a542c25a13665404a082b5302,57984279622
20190406,"PAYMENT RECEIVED",1268957449,0,91cf9bcf3a09153e5e055f97fe0e1a50d1984398515783093f842d0114996d81,56691685659
20190406,"PAYMENT RECEIVED",1268713690,0,8eb76257e61865d03696750505c82075d30045a7f4b9d2370e5039250e621090,55422728210
20190406,"PAYMENT RECEIVED",1258238740,0,3b2f3986dca9c09c654cb35089c6d594661d4ad05759fe763c519821184dc70a,54154014520
20190406,"PAYMENT RECEIVED",1287581446,0,0e0abf82a936b46abc485e2c986256c171c5479b3add852a141a6d2fec1f81dd,52895775780
20190406,"PAYMENT RECEIVED",1337554695,0,d1deb06c1a7f586f69b1775c9718bd382d0591942a66a61ee340408019aa6a30,51608194334
20190406,"PAYMENT RECEIVED",1321436743,0,9b6d1cc07d1b9f71146ea6d69ac32bbb6dcf1d12ab7078c218106198a3f3b54f,50270639639
20190406,"PAYMENT RECEIVED",1265794596,0,60e67c8a0ad809aad3f929e3bd5fb34d3bd5c0af65291042e91e1383eaadd368,48949202896
20190406,"PAYMENT RECEIVED",1264914546,0,10d2057f8f5137d6cf669ba0f89f47613baae8bb3b7ed5df4acc3d5a4e5ae529,47683408300
20190406,"PAYMENT RECEIVED",1280543715,0,0328025a470528296b238fd24f3aac123154c768b90fef888d04dde09e51893c,46418493754
20190406,"PAYMENT RECEIVED",1372561427,0,589b21e87fa308bb68301fd5cb053065c70b258f20b6dda290e8816cb49de695,45137950039
20190406,"PAYMENT RECEIVED",1283465572,0,cc1cf4fd245fd6c295ca4645bc60655ab856e4d1196b8ce3881c80b9425e17bc,43765388612
20190406,"PAYMENT RECEIVED",1293991933,0,85a81bb74c9102cf8d056f39b68e7ac1b86342a0750ad3b3cb5b13fb8d845424,42481923040
20190406,"PAYMENT RECEIVED",1290718905,0,efa6c161b9a1682e82733433c28c5710dc20ad4b8b01aff307c88c62a45307d1,41187931107
20190405,"PAYMENT RECEIVED",1270988770,0,648c747b5d63731002a175732cd7a3a4e4a69d0a13419dec8ca58348872ffc16,39897212202
20190405,"PAYMENT RECEIVED",1288201806,0,da07932ec71ee8abb1cb2cb510e38db0925931680b308d7fe4cf6da574a9e9c7,38626223432
20190405,"PAYMENT RECEIVED",1379435714,0,d2ad41f5c46d46e4ebbeb493531e1ce63099759cb3885add56045e983481b409,37338021626
20190405,"PAYMENT RECEIVED",1274624430,0,8fd3eccc17b8cf8b88b62e210b10e6088be6eec9c58c70c16f658a5e43ad94e9,35958585912
20190405,"PAYMENT RECEIVED",1385670220,0,1f446f2fe3bfa042718a564a9bfb07c168496c1d15c17ee9e611c8821d54d313,34683961482
20190405,"PAYMENT RECEIVED",1289004340,0,0e859b2f0bae1c9b73f52a8dcb84b0a5353342ed1df9298e4eb4e6fabc2e98fd,33298291262
20190405,"PAYMENT RECEIVED",1349543314,0,43b23f89f0c5c94d2a72e38f4d14ea6744df775bfee80c073a83aa0f3dcb9e75,32009286922
20190405,"PAYMENT RECEIVED",1371067712,0,7651a2e4dffcb1fbef26327d45e96700d1cf37d9db53735f6a67420e1dfca697,30659743608
20190405,"PAYMENT RECEIVED",1256327209,0,d426fcbabf963756ad4062aab1b758fb9d3344b722368e6561eefb20adff47a9,29288675896
20190405,"PAYMENT RECEIVED",1307742606,0,3aac81bdf8739d8dfd01dc19f1e863dd0531a2f5aa7487c4c6ab1b7cc003670a,28032348687
20190405,"PAYMENT RECEIVED",1304624672,0,c1714a6eb4cee261c48d4624751342ab96638dfbe6f1b86298191417b5a3225c,26724606081
20190405,"PAYMENT RECEIVED",1356901618,0,891b609aee19d086a36fd5144854e7049b8198ab6c9ae67554712dcc34b4eaf7,25419981409
20190405,"PAYMENT RECEIVED",1343112499,0,17189ea1dfab8e7986224bffc097f7543b95a54d0bcb337f810264b50132b7f7,24063079791
20190405,"PAYMENT SENT",0,-60457908341,de5b657b31a1309b6783231a9ef2a534a6ee35008eccca9268341dee0fa50511,22719967292
20190405,"PAYMENT RECEIVED",1263085025,0,2da0b955a23687e73fdb11817ced918f02282c6943d410f59f029af7b18913b1,83177875633
20190405,"PAYMENT RECEIVED",1303099686,0,791f747e80767dfc056da0971e6c02a70c93a5961ab9250bfb18ae649286eb1b,81914790608
20190405,"PAYMENT RECEIVED",1355832996,0,bcde18f599d16f86d25e6da169f3f76abe2c04e1fbfadc48ffe94053501f7027,80611690922
20190404,"PAYMENT RECEIVED",1278364467,0,6e822df981ec24835922ad5a1830683ee2bc8afc83cf864194fc274f6228d8e4,79255857926
20190404,"PAYMENT RECEIVED",1293056202,0,621cea0b72840fbd9cab660052a1303d20bc69a576bdbb009ac37a43324c055c,77977493459
20190404,"PAYMENT RECEIVED",1329347011,0,2184cfb3fe9355e0222c1a2908eba7c5fd73a00dca178c2d3882db049f8748a7,76684437257
20190404,"PAYMENT RECEIVED",1346969677,0,98f58f4b3b5945311b81bf0abf0e50664f6d2c2563394592a796bf12efdd3ce4,75355090246
20190404,"PAYMENT RECEIVED",1395187011,0,6aef033a0616b16073f6765249a46d7732a05f11b69337a94ed770ae11ae8a31,74008120569
20190404,"PAYMENT RECEIVED",1402552830,0,e260bc2c2fedb5dcac32f6fea67a807b6ef28b5deebe1a5e3e92b0b5ea4e6d5d,72612933558
20190404,"PAYMENT RECEIVED",1395429681,0,0e65eea6808ba6bbcb6de2901e14289c42556cf3efcf5c86fb6dc2ce3ff6e311,71210380728
20190404,"PAYMENT RECEIVED",1386859797,0,3d324d3663a9faff27c2563416866a0ddcef79e1785a96d0ec0556ee99c02f23,69814951047
20190404,"PAYMENT RECEIVED",1377460912,0,4dd671b57bfc14c22dcd07cdea01c486e73774e23e21f7f4db96c917ab9cfad9,68428091250
20190404,"PAYMENT RECEIVED",1327739964,0,f71f704a8ea0d4dd2684492312f59d73a113e18b29be6ba85ab96fb02f2bfec7,67050630338
20190404,"PAYMENT RECEIVED",1396062721,0,9024255a1b9dd8662c5f73fa9af87e7731e0cf15e80f8362c8f9443b8e063897,65722890374
20190404,"PAYMENT RECEIVED",1338288892,0,14ec8e951e5baef22116818df8cca5cd1f9eef880c4abc5dfb05e01ca04f2d5b,64326827653
20190404,"PAYMENT RECEIVED",1351628940,0,30955f472f402cdd46ab08443233bc766d6c86fca29828f4e1b3f3aa3e12c915,62988538761
20190404,"PAYMENT RECEIVED",1302940176,0,f5db529f911c7d2cc10134ca29e0106e945ee5e27dcbb3619ff39b050dbac978,61636909821
20190404,"PAYMENT RECEIVED",1353703785,0,2e83bff4b5d206a2c9032233dfba47c9757367a63a763b55e22f94942df34272,60333969645
20190404,"PAYMENT RECEIVED",1391171395,0,964f1f9624f49991b7572eca64be83d5e16710094a7f5210a506cac704d0f094,58980265860
20190404,"PAYMENT RECEIVED",1335171667,0,c457fde31ae51a30e5135a59af829e6fa1981284f936ae919087566aac2e5f04,57589094465
20190404,"PAYMENT RECEIVED",1349694498,0,207022f42220f97964699f169a266c5cd63c28cde68516e5ffe2421fd0da7b2e,56253922798
20190404,"PAYMENT RECEIVED",1295674928,0,c7ba564ce8aae63d9755e7de90c9f6c094a6fb96f1fdff04a3d392aaabb73c76,54904228300
20190404,"PAYMENT RECEIVED",1314765408,0,6a0225f21cbf4df85740fb71b85724c769f1772d4a52b357ccab3f40409fd4ff,53608553372
20190404,"PAYMENT RECEIVED",1371373300,0,6c9d599a8bfdf3c1e14bdd28fe4a824e7f37c4b4de40ccff32d4e37e7ecf4d81,52293787964
20190404,"PAYMENT RECEIVED",1329267632,0,aa02d7c62ea06e7b02e2d84d724af70dfdd1bba1c49536d4e2d847abf07b96e1,50922414664
20190404,"PAYMENT RECEIVED",1372070808,0,ab663b35aa01375a5883b2e6c67824015e7aa4967c593e1e628c66e87e8bf026,49593147032
20190403,"PAYMENT RECEIVED",1375413621,0,fbeee60885f4ca8253cc52e682c324919b38ede8385fc2b2dd34af48b202e5a0,48221076224
20190403,"PAYMENT RECEIVED",1401456884,0,0dc03093319b8cd29cca1ee626d846c6edbad6e31de4b089668b9444ccd67e32,46845662603
20190403,"PAYMENT RECEIVED",1382084919,0,d32e295ec695015da6b6adcf6d82108d5a2b62d9966a08ca600bea04745dcfe3,45444205719
20190403,"PAYMENT RECEIVED",1363959678,0,ac13d3538bf8b76bb7901791c80ae546cc5dacebce6df9cb89cd4a2ba659427a,44062120800
20190403,"PAYMENT RECEIVED",1326009729,0,acbb38165a2bedaa74a5355b4ab70795204c2516a03d96d1c6b648ec8372c790,42698161122
20190403,"PAYMENT RECEIVED",1376413114,0,0cade7a0f9430a2d0d8718a059d006cfc2422f82b43893093f2355fade6d84ed,41372151393
20190403,"PAYMENT RECEIVED",1338582201,0,f94456e1eaa3e4dc2980a6c01e2d10f28ff589b299acfcd12487a5c43ae94056,39995738279
20190403,"PAYMENT RECEIVED",1428442324,0,bbbbdc34fcf5f22730d0dd14da27855d30f0f0cfa928906a9839fda5006a7f6e,38657156078
20190403,"PAYMENT RECEIVED",1336372662,0,d8a584aa6e9a471bed0176747e9fd10533948fe7a6c855b072ba54ee586ca545,37228713754
20190403,"PAYMENT RECEIVED",1360253715,0,b5dff7f664db03af3bcd0fd03149766379b1c64c10594f56cb63abc775811ada,35892341092
20190403,"PAYMENT RECEIVED",1406944281,0,d321ef3d8b658dcdfb70d3dbc3cde3f6500c78c8aa56ed90ecfa7c931dea2661,34532087377
20190403,"PAYMENT RECEIVED",1364847088,0,a69c6a3c26c8bdfdf63405a47fc955a11ea611b43254189564a963295c480def,33125143096
20190403,"PAYMENT RECEIVED",1329308117,0,2384dc8b2ea3ee308ed3bb0bdb1968af357792b322ce19b91509694448c88c8a,31760296008
20190403,"PAYMENT RECEIVED",1398826391,0,080653b42653ad964f2b8704860c0c7497c8de23c56ecd56ba8a37a92f0af511,30430987891
20190403,"PAYMENT RECEIVED",1325469861,0,f7e628bec1eb51f66dfe85fc4b304efff548db2f67fef11a489a7f2a982f3f39,29032161500
20190403,"PAYMENT RECEIVED",1357792596,0,262197a69d221bcef9c187c508ea6c9147e2268d6e8b50b6be408f16302f1cf2,27706691639
20190403,"PAYMENT RECEIVED",1350279025,0,61289d8b5d89574c67be54f7899a9edd2f91d8906f60147f62e088f0993b1576,26348899043
20190403,"PAYMENT RECEIVED",1327178833,0,586f25b6ad6e1b4cc06dabd28eb081c282f8c44ccdda8629f083c0993bfb93ca,24998620018
20190403,"PAYMENT RECEIVED",1300794819,0,38e8ab96655ddca7cc19c304970c012c6f2ce86e75d5f55c12ddc53a81ab5414,23671441185
20190403,"PAYMENT RECEIVED",1334278187,0,51a1a07c3b49fa0155944464b88113960869a602199f286b2383627ec3a98ec6,22370646366
20190403,"PAYMENT RECEIVED",1291540803,0,c0cf3c05fa4fd472599e0cb97264b44a3fc0b55d8c65ec82eb62493f44f5d79e,21036368179
20190403,"PAYMENT RECEIVED",1323762375,0,5009e7160dc2bf97ea6dab73fecb994567dbf675214b1b572a4e6b1b2775ccaf,19744827376
20190403,"PAYMENT RECEIVED",1329327991,0,ea395b175260fdd476c65f9bccc1b1bf99300aee8e80b72d17fc7f10132d9d73,18421065001
20190403,"PAYMENT RECEIVED",1298624194,0,e7858428cdd81c7c1fe5df87f44d84f12f6612e6d6cf1f7f33e306c7f6213c6b,17091737010
20190403,"PAYMENT SENT",0,-30000229772,0da28a1ab3a19338c96b5194bf347bddc683b802c6398372eb3e3a0369ad3598,15793112816
20190403,"PAYMENT SENT",0,-50289807268,3385e1d6959162ee504c6dc4227292bc5b957428043650212e72c7f019870a26,45793342588
20190403,"PAYMENT RECEIVED",1317107364,0,31feec56cedbc67f73f4d1ea3214a803f8f78820292a83de83e1075d1f3592c3,96083149856
20190402,"PAYMENT RECEIVED",1318379597,0,16be0f074034558102b3915276a5b27b94cc101bfcce762af175cd27b3e66550,94766042492
20190402,"PAYMENT RECEIVED",1307128126,0,7c2d911f4671a1d934f12d0f3abc0636a54b579a2003aba62114f7172abfa37b,93447662895
20190402,"PAYMENT RECEIVED",1337035339,0,553db526ef4b2ed39bbf53b8686a10b84f11f8d5eb4e99b5d7f1c206fb73976e,92140534769
20190402,"PAYMENT RECEIVED",1352094981,0,7247b5e038d7596a3f3cf0599d9d471be0f11e97c709eb82be4ed7a9a31d9c92,90803499430
20190402,"PAYMENT RECEIVED",1318257758,0,b2d66a6de60bf7f1c300ec8a2e218b6bccbf9195ebdb08abd4547a227a0ce6b2,89451404449
20190402,"PAYMENT RECEIVED",1342708740,0,788ee516bfbfe044fd6aae2222c8633dd16c418a216b221882b5fa690fc073e8,88133146691
20190402,"PAYMENT RECEIVED",1317207829,0,665eb8c3e4b90b09aa7b605a128f3974f96b5957e538ff0c8dc28453bbed678c,86790437951
20190402,"PAYMENT RECEIVED",1333106709,0,861aebcebed439223126f36c4faa0d46e078d74bcdef3eec8a9ab6c37af8c205,85473230122
20190402,"PAYMENT RECEIVED",1325164454,0,88b876370d985de87a4455481265f3ffc04f6aa80f19a9e4be106091b6eeffb3,84140123413
20190402,"PAYMENT RECEIVED",1285685128,0,3ee40b20147d79c3da24e1c44d01bb59ae04999386011f961150759daffb60b3,82814958959
20190402,"PAYMENT RECEIVED",1282393460,0,850039bf081ad580aba73217752647e640929624e11e71d21011511e48a98e04,81529273831
20190402,"PAYMENT RECEIVED",1298695365,0,3031222075016d4e4644b2eefe77e7ac01e98c76a4a68f4dd6d333d597a67f76,80246880371
20190402,"PAYMENT RECEIVED",1300161304,0,c4675bc05e7241f337314bab3746d05f708c8d2dd6a1adaa544ad7f74e6d93f4,78948185006
20190402,"PAYMENT RECEIVED",1319997630,0,e3822e91173f721d17894f9702536951d682b26da8e0b4b7cb02e03430d74324,77648023702
20190402,"PAYMENT RECEIVED",1313005345,0,e91b80143bfd7b2c58d1de8105a738c31e46d0b8f5adafdc757c94d4fb00b87d,76328026072
20190402,"PAYMENT RECEIVED",1306886838,0,d26e94d85422ba614a4f21bee76dae7380d0424fa834fb1b2d78ed9ef9c2c2fd,75015020727
20190402,"PAYMENT RECEIVED",1315568104,0,929068ba5915aae6421a31ed7fff9aa7e0d33c6cd83cd84485257c3be135a7f4,73708133889
20190401,"PAYMENT RECEIVED",1313207736,0,7e371a7f64ad80ce896fac603b395f8f9bec4beb2ff9f06289ca9f4aaef6f123,72392565785
20190401,"PAYMENT RECEIVED",1289418143,0,67dccdb95695c63b92f6784a8206e1de66ad24b49ee81bff1141a0f61dd6893c,71079358049
20190401,"PAYMENT RECEIVED",1318114466,0,6e12e7eb18cca117276a97c94ef54c536a191188a19efb1164bae933e7a0fb77,69789939906
20190401,"PAYMENT RECEIVED",1302820404,0,7871e6b5f016539075caa57fe557d8863cea8bc158c3402f0a79498911eb2c0e,68471825440
20190401,"PAYMENT RECEIVED",1317038242,0,6e19fb4f197dadf2bd03cbb0ef1117eedbdc4b2b171a022851f8fbe870625b5a,67169005036
20190401,"PAYMENT RECEIVED",1310364485,0,b1ab2c976d56bc0645116dd571cae1e672b91f11b84296c6295bbeb7b545e99c,65851966794
20190401,"PAYMENT RECEIVED",1311887514,0,fefaade21905710fb2cbd460b413161917e425f7c3d1e7190a89c4a6e26b8850,64541602309
20190401,"PAYMENT RECEIVED",1304620072,0,89f62061b985fda47851003f189ac758f3e01f8e3ce2f322424383e970962ab4,63229714795
20190401,"PAYMENT RECEIVED",1295594552,0,17511be6c29ebcb568472de4ac9d793c93892d34b2f65a2f179a208d19c93056,61925094723
20190401,"PAYMENT RECEIVED",1329945515,0,ce02675a886fb1d03dd3bceb480b0f8eca16b0541ba95457330c17c8d42c3e0e,60629500171
20190401,"PAYMENT RECEIVED",1296566467,0,2207461720b49bba7b4e489005410a986373be788a2832cc5d392d55b18cbb8b,59299554656
20190401,"PAYMENT RECEIVED",1304722022,0,2e09043a131cfbde85fea000c97ce9f1133943bc4201c36719e81d4cb8e0c391,58002988189
20190401,"PAYMENT RECEIVED",1291081463,0,a401a6c73242e3708ae93d41668f1d1d59a88589689191036c95ec7daa241bf2,56698266167
20190401,"PAYMENT RECEIVED",1288339228,0,9d231d74df6ae4c6c8825ee741adb2feb8fc447fd509e4225b8e1b8e553606c8,55407184704
20190401,"PAYMENT RECEIVED",1283103382,0,109239c4f4d156f8fe3e2fd304cbd82c2e5b8dc4ce395322aa0b91f13a27a50f,54118845476
20190401,"PAYMENT RECEIVED",1266888408,0,266dec7917945a22ecbe21f10c6675353b9b6cf6b0d2fe0d5b8d229548b56cf0,52835742094
20190401,"PAYMENT RECEIVED",1273072197,0,a8e445dd39ba2fef647ce2699397efe639de8ab0149028088371cc7e5b30327b,51568853686
20190401,"PAYMENT RECEIVED",1262746046,0,dc423d26096ae0a97e83d9d4012a220a086ca4af5317efdfd363efc3ef696dbd,50295781489
20190401,"PAYMENT SENT",0,-50097597468,42f7e813f9dea923c932806c75ed4f7b4b1f0eff90062c68cbb05d7d05b2de2c,49033035443
20190401,"PAYMENT RECEIVED",1271854640,0,ccdde4975439b8e850caa19a41f238fdc75d07031d7e8cb9f11a2157340164e5,99130632911
20190401,"PAYMENT RECEIVED",1296485481,0,84ce63d6411c47c9a8132c791a05c9a5400b7948144b95162e090ee7fff176b9,97858778271
20190401,"PAYMENT RECEIVED",1252818589,0,9e5d5a47a6cdec4ea9207ba726d05e5e5578f42f83a54864179f332555cc65d8,96562292790
20190401,"PAYMENT RECEIVED",1279445635,0,c7271fce95729a68944c8408407abab193d451710f507a835556b8e891b984fb,95309474201
20190331,"PAYMENT RECEIVED",1292106053,0,ec87bef0023d798582644d381ca8a59b793bdffe129bae9fe2745fd4bd892861,94030028566
20190331,"PAYMENT RECEIVED",1266611410,0,34cc9a27473a75af019ecc546523d58d98ba1b6166854df7c0cdf2b17e0ca160,92737922513
20190331,"PAYMENT RECEIVED",1285508340,0,1183c68fbc9fd3babd1ac53fd53515361c9faa773744c78e3fc9bbc5346d2451,91471311103
20190331,"PAYMENT RECEIVED",1298964887,0,d8c95efa2510c9abe20a948759e69996bd6cac4e5c3ef5ee46ded5a6a991ac60,90185802763
20190331,"PAYMENT RECEIVED",1307714149,0,987161c8fb47410963a213a9551f9f18d84e2006d335085dacf186ea6547dbe4,88886837876
20190331,"PAYMENT RECEIVED",1311573237,0,d153e92682107ae3d7e9731af94dcbf20aaf696f8c633d9415f6f7531da9d7e6,87579123727
20190331,"PAYMENT RECEIVED",1267470930,0,1a257e026e35c73eaba8c0788eabd556e901db73a855b6e7420da9cff8702349,86267550490
20190331,"PAYMENT RECEIVED",1285756688,0,b96b7f001027ba3d703dda734f41b84731f2b6b54f5527ed3da802091f3153b2,85000079560
20190331,"PAYMENT RECEIVED",1263212011,0,64ca4559826121964e2148a351b5fb9873083689c7b44bb554d32c459ef84ca7,83714322872
20190331,"PAYMENT RECEIVED",1272841585,0,7b38e6f3d1cdc1776d1a31e9d1c1fc1d2f8bc90da6aba5d83b0a0655ab28979e,82451110861
20190331,"PAYMENT RECEIVED",1265883246,0,98cfd71a06ac5e479dc80691bd6206998d974bdeb95f6450e732013e59af560d,81178269276
20190331,"PAYMENT RECEIVED",1282048053,0,f8bc0f1159b20443f93bf7ef788d2e65db535bd02196f601dcc7540cbf196818,79912386030
20190331,"PAYMENT RECEIVED",1284899132,0,2c871c02f73af3ea8cd567a82bbfaf251f9bddb65ba62c9e85422abc31a9d542,78630337977
20190331,"PAYMENT RECEIVED",1289229409,0,2f9acdd1cd01d67d5708123d750f8b704726cbda8c95b24b8ededc98f0dceac0,77345438845
20190331,"PAYMENT RECEIVED",1300714705,0,40292a45dd65a507570fe913d2c8674e6866658c9c39aeee690fe875b1ecc073,76056209436
20190331,"PAYMENT RECEIVED",1257779453,0,20e95ff0cdbae984fbd6a6c1c3110e4e7c21af69470cd1272c88d88f1c6ceefa,74755494731
20190331,"PAYMENT RECEIVED",1266531656,0,03dbda0335a7752bf3adcce6fbfeb7a040b1cff55cd814f531658e7427080e19,73497715278
20190331,"PAYMENT RECEIVED",1253443698,0,6c4a90f5bb6957fcb8e733d6092399d5366819c683d502a9308963e996c4a556,72231183622
20190331,"PAYMENT RECEIVED",1295838273,0,6bc0089856d9f8c862cca5d0a7d1cb8287546d7b3dd0803688982fd5ed343c90,70977739924
20190331,"PAYMENT RECEIVED",1299422486,0,91572d61a7ea06acc7aabfb08c8405e91b39b2c10cd801e532fe2ef655f8b8b3,69681901651
20190331,"PAYMENT RECEIVED",1291805116,0,30f41981cc3892a8499e2978a6e4ff07c4fe29ee708f62f198764b031df67761,68382479165
20190330,"PAYMENT RECEIVED",1303640036,0,319382a840de38e326df3bb6d410efc4620e7109f4d4955f29c1f6f70e9f4c9c,67090674049
20190330,"PAYMENT RECEIVED",1266627842,0,e2c21a4387593109aa5d0dd7dc83d2b66c5155dbbd5309c14c91fef7e8e19b1b,65787034013
20190330,"PAYMENT RECEIVED",1286866225,0,fafd376b1e014daac1d381d452b2dfb026630db8cb661e781d3a58ff69dbe9d3,64520406171
20190330,"PAYMENT RECEIVED",1305338891,0,4856e4123b9f63a3f3e6098bf2daeda9f5162b39024c7b437e486d0946035ea2,63233539946
20190330,"PAYMENT RECEIVED",1307080789,0,8de5a1a16eaa4e9a131ff7a6295e77bc16f774773cdf5b45157b4a64d0b0871a,61928201055
20190330,"PAYMENT RECEIVED",1285407166,0,569032b8c1819763e4ec33b22ce16a1a9a0f4b90bc448d445fd83fbf359f7b39,60621120266
20190330,"PAYMENT RECEIVED",1284404155,0,0dab00231360ec4097087d3ff722de11ea77970e9de4cf2a9fc27102e7389d8d,59335713100
20190330,"PAYMENT RECEIVED",1345150217,0,8c77f7bc1dc01b6e0645f6c87bac9fdf9a7b17cb3e488473e6aaca4c76eac2fb,58051308945
20190330,"PAYMENT RECEIVED",1274047941,0,bd2f377cacb63b579aefd59d19323d37f04b24587a2931864ab34cd0be58ccb6,56706158728
20190330,"PAYMENT RECEIVED",1262560923,0,1406b1b86874e14f398317423d5f7a853d10d88d194d617e6394125dbdf812b2,55432110787
20190330,"PAYMENT RECEIVED",1290744753,0,6a634049c84c61e75c81e363be7435fa8bfa16d255fa127702c3e51b2cbf155c,54169549864
20190330,"PAYMENT RECEIVED",1263388929,0,0df58db2c82bfbeeafd6d805f2b1d0e5222430b78819ba96f03c2d95938d40d8,52878805111
20190330,"PAYMENT RECEIVED",1286211700,0,0e74aecbba1a4f70f1866f129daee4e2e8be3c2bd8051c0fa882f6ffe5cf693b,51615416182
20190329,"PAYMENT RECEIVED",1291365538,0,9d5cc0c030757c0f66666cbf88cc7461b190b6a4d3ad74715e30276e827fdc2d,50329204482
20190329,"PAYMENT RECEIVED",1295411915,0,d238f0bf9a59afb6f9694c3f54e268a9fd1eb206e614858a08f69fc5fcffa406,49037838944
20190329,"PAYMENT RECEIVED",1313200703,0,7fa8d48d0af1bb18b3b9612c1ac93c453acc0b2bbba44a293f30ea05d0a49a66,47742427029
20190329,"PAYMENT RECEIVED",1314142189,0,37aa166cdc541da068cdb7ff93e3ec50ea7e5c75870925d2b1ada4665c37f00b,46429226326
20190329,"PAYMENT RECEIVED",1317617887,0,2e80a2b1129adcaa9cd506c6d930fb57b691ef5a19a79f60a7a5fc12e448bace,45115084137
20190329,"PAYMENT RECEIVED",1280894286,0,c7023868d9ce6da9fb9d72f4c1cbf85a5259d07b73f95416dee169596b494819,43797466250
20190329,"PAYMENT RECEIVED",1301920506,0,67b139aaba3ff20af911e7a9245fe3088a76cea2ee2c4be05310fa21c9252e40,42516571964
20190329,"PAYMENT RECEIVED",1291771980,0,0be4ad09728da420c709eb18249c847917054cedb18fe166447471477ea72ac7,41214651458
20190329,"PAYMENT RECEIVED",1309052323,0,411b7082a4157e33520b9be7e78283367669c2a4a9a970492d90b33606f41641,39922879478
20190329,"PAYMENT RECEIVED",1290166248,0,e732c6233db08b7d4b74a592673c2fb422eb5d4d1582e7c8cca5b27e0ee36288,38613827155
20190329,"PAYMENT RECEIVED",1321001951,0,a4a1e01304b2f2a67cd95e69d6d7326081bfdaf22311bb2f341d1ad3534febec,37323660907
20190329,"PAYMENT RECEIVED",1313709946,0,6c31b01a8cf99ee60df13d7d9a99496f2b218870d9dec889814fd714acc69ac1,36002658956
20190329,"PAYMENT RECEIVED",1321145396,0,35c8b69ea48260743ed511ca593ac5127d9496d3e03f415506b87578ef2851a3,34688949010
20190329,"PAYMENT RECEIVED",1295755790,0,1f26d5d2cdd02a5084014444ceae866a036d8d24a88784ea06b19c12aa4a89dd,33367803614
20190329,"PAYMENT RECEIVED",1290329340,0,bb7ddbecba57ceab67a8a7b3b7de23768558b8094e452604c8076dc9c76d4a90,32072047824
20190329,"PAYMENT RECEIVED",1325853199,0,50023b314c46b267f79fd003bcaaefc1b650d48c86a04eaf086e7ec443328dea,30781718484
20190329,"PAYMENT RECEIVED",1287104611,0,490168d5fe56c17e124ec25cdac8d3841e20b0656ca57494ece551b359f22618,29455865285
20190329,"PAYMENT RECEIVED",1289483522,0,75a653e78412c6597f5a35b3bef27ee91a0afa9eb215a91943f044be814e535e,28168760674
20190329,"PAYMENT RECEIVED",1252264514,0,d0dc6eec9926cd0c94bd23af0936d3520673886a0a64d632b718cadeebbab4c9,26879277152
20190329,"PAYMENT SENT",0,-49803166646,cec20eae8208044a112e74f976d62d86cf1c5ede3c50897b818f4a2cd090c7fa,25627012638
20190329,"PAYMENT RECEIVED",1252645612,0,cfa3a27918070b7f308e3f52080e1f7e5e45b4ccf70f67baf29cce65125df815,75430179284
20190329,"PAYMENT RECEIVED",1269367721,0,3cfa47b16ed1380b1aab632364203b78e2985e7b53999a9b85e5f070707835a0,74177533672
20190329,"PAYMENT RECEIVED",1291682993,0,23ff8741b79161f5159e3891e6fd05ca4d1903b915ad8e211436b52e6d98d8a8,72908165951
20190328,"PAYMENT RECEIVED",1272995026,0,a1665dbef90e7e8d50e2eacb7d65687797bf515203b3bbda5c83a6261a702d89,71616482958
20190328,"PAYMENT RECEIVED",1289641010,0,8aa70b0dfffd15ba0407ceafb6ab51ca3b621fdb4ba4cdb307e7441db2db1c22,70343487932
20190328,"PAYMENT RECEIVED",1297513961,0,e672e8e6b5d5a6423596cf6695efc39fea4ef9a104aa290313135de48ef65c16,69053846922
20190328,"PAYMENT RECEIVED",1298299110,0,8735baa973281e381f9fcccbe5f6ea4f711e650d71ee48851954adfe41eecd67,67756332961
20190328,"PAYMENT RECEIVED",1302244541,0,395ebd7e1b42d91b1be8f02fa5163d0ba6972ea7de6026bcf89602ea533a02d4,66458033851
20190328,"PAYMENT RECEIVED",1303465678,0,6d8c6b838a630fc928e9a6c56b24ea33b29a337b39f3d8e05bd11c4733d8df7c,65155789310
20190328,"PAYMENT RECEIVED",1292374822,0,98168d7ea8a2d45132038584a7d588267acc831ef2b5ea2bceb680b2d944fd40,63852323632
20190328,"PAYMENT RECEIVED",1290456327,0,ddc20fd196deb19d41243f771adce8a10c8aafd3923b1e6f796e656b1a716813,62559948810
20190328,"PAYMENT RECEIVED",1296605178,0,02badaffe47bb5d1bf8757b9e858a3df0564a35f177a4cfa945f63fe4c5621e0,61269492483
20190328,"PAYMENT RECEIVED",1291345825,0,98ac6016bb359f08cbb0405352c014bab2a4dab125d575c1d9b41118beee4912,59972887305
20190328,"PAYMENT RECEIVED",1278825171,0,ad8382e6bd2cbf5b0f0aa813d161b1328be014a4f01fe4be2291e66a34dc91d8,58681541480
20190328,"PAYMENT RECEIVED",1254692909,0,3fac54870e70079f0c454a3432a00e61c4d6e291f9af9864ea3149ffd5fa8dbb,57402716309
20190328,"PAYMENT RECEIVED",1286937543,0,b51c71ae7c03d8480e16358a9e10092cbe226ecc2f2654f3644f7b4b7804b4fd,56148023400
20190328,"PAYMENT RECEIVED",1256324024,0,a24ba36bb9a0a1c91c51bd0d3321fb2968cfdd09bcb6152b7b1ad163d83fc824,54861085857
20190328,"PAYMENT RECEIVED",1266700275,0,704419b845add9e9867e4ae22ee5fae7d89280743b0f99c25c44831d2f2929c6,53604761833
20190328,"PAYMENT RECEIVED",1266143349,0,feec5c4a608b22c2651129c713950484b9f2c6a39614ba78eaab060449519051,52338061558
20190328,"PAYMENT RECEIVED",1268813849,0,87067d13e6d4aee4b4ef9612a9671896b7b26f8d93ad866c9e4a2f64e94485b5,51071918209
20190328,"PAYMENT RECEIVED",1260351027,0,2d1bd2ec5f1041b914f8b64d146c4b32ac0b00ac2be2aeb66c9426c8fd84fd1a,49803104360
20190328,"PAYMENT RECEIVED",1261861702,0,ca9de51e4c27e19bd03a901a2b6669f759a3e83a20489066018bbb89e6e36bd4,48542753333
20190327,"PAYMENT RECEIVED",1261301153,0,197c840e84bf98f3dc78e5575083638ba56b5721d04a1da19efcae339f2cd9dd,47280891631
20190327,"PAYMENT RECEIVED",1286692534,0,3e33742fc099b92ff6987484397393870c63a7558b5398335986f6b7d2e822ba,46019590478
20190327,"PAYMENT RECEIVED",1260568712,0,e62133a75968440697c90617355a89a00bf088e7eab796c696463175a9be545a,44732897944
20190327,"PAYMENT RECEIVED",1280391887,0,64eff5c28ea4a07a6f1606e8133942d60b6b504b43b68b745e4261af4e943039,43472329232
20190327,"PAYMENT RECEIVED",1291296333,0,796cf358776c28b47d4b1f7ceb9b8d472d19e049c4b9720a7a766db724fd5e2a,42191937345
20190327,"PAYMENT RECEIVED",1288759593,0,0870247e62b4321ba6f0aa3c9b06d08c91ba55d4726d58f5e62a5f8b1957b5e2,40900641012
20190327,"PAYMENT RECEIVED",1279828093,0,0785d864cce1d5405878ac35740824bde4fb85693d6e286e5ae9105098089709,39611881419
20190327,"PAYMENT RECEIVED",1283800953,0,9667fc355a33fb756ca5c987be38328b3b376b420993e733ce97f912a04439b8,38332053326
20190327,"PAYMENT RECEIVED",1297023810,0,bbe575b38a85207421b69fad64a3440bb9ae9ee762945d42c1ce897af38f8c33,37048252373
20190327,"PAYMENT RECEIVED",1254579497,0,9017c28d907fd5ea0b492671df5d6abfad92a801e21a0fbe8076676d52e247b3,35751228563
20190327,"PAYMENT RECEIVED",1267528197,0,9ebdc6b4f6e51aa396d44a09bf8fb620d65fa44245f2eb3dfe4b9f995ae94de8,34496649066
20190327,"PAYMENT RECEIVED",1311653396,0,edaa9e042c109ef1cba037750810349f392915fd0e4bbf6f12c44fce03084ec5,33229120869
20190327,"PAYMENT RECEIVED",1254266330,0,47937230cb090efb9fa72b56da7f15b3c48ce3bc1f7df161b53c48e1306424cf,31917467473
20190327,"PAYMENT RECEIVED",1275086796,0,0b308645c87b22d99897e6f8d7a09d51c7e157ea736eecec6d44560b2a7cba74,30663201143
20190327,"PAYMENT RECEIVED",1250000000,0,b4da15f929e69269f39855bf268f20929d71f0fa1c86040f78035a742d7e9563,29388114347
20190327,"PAYMENT RECEIVED",1294867241,0,b988f00291a27a026eeba6b2378bcaa81866c1e90cf5204c0fc9d08f329d58eb,28138114347
20190327,"PAYMENT RECEIVED",1261516906,0,68b1ccc3fa84baddd30ac960da886461fb55788d34a260be355f5ba58d6f99d3,26843247106
20190327,"PAYMENT RECEIVED",1250000000,0,f4a6276035b98b5b5cb813bd9f7149b4b9fac2c201bc651a2f6592c877f7bb7c,25581730200
20190327,"PAYMENT RECEIVED",1272262190,0,4a09f5742714c8855b1f8551dc606197b3d050c19add76692ef4053c3b7344ea,24331730200
20190327,"PAYMENT RECEIVED",1298814946,0,1b5df316f4cb5da421da62ac2154c6cf1607dbb03b29ff58f5ee15a7f2dfbc2b,23059468010
20190327,"PAYMENT RECEIVED",1302226956,0,9c50ac2b149634470201dd51a036e8b156c805293bd22a84aaab8c60c9350a32,21760653064
20190327,"PAYMENT RECEIVED",1291817183,0,73bb2e146924a5db78fd5cbf8058947fa9ce2ae6d9c7156726b5ec9a61281f99,20458426108
20190327,"PAYMENT RECEIVED",1263317894,0,1563bb12a1c00a31fb3e8e55f905d64dda6d37cc8195d10035ddf6a4abf98e4f,19166608925
20190327,"PAYMENT RECEIVED",1275497299,0,7061ec3833092591739a31be8b5791bb049a45e5b7868ec4b0c791f4b01b753b,17903291031
20190327,"PAYMENT RECEIVED",1285743010,0,7c2ddaeacd4593ab2c5e116165c7e648847dfb4d5670530aeeb5e04dd7235824,16627793732
20190327,"PAYMENT SENT",0,-20197007352,95475b0ef1d7cddcd3b9b4f886de3158de06d60d91c0750b1e92c23d050014d9,15342050722
20190326,"PAYMENT RECEIVED",1250000000,0,f960a50f7f1ee34b666aabaf8b3c425f3e4924ed097471813b263023beb41584,35539058074
20190326,"PAYMENT RECEIVED",1286737564,0,dad6aff684a8b70056ffd6b033e69aaf66403987ced0cc6f415c80c3fcb3822e,34289058074
20190326,"PAYMENT RECEIVED",1292834704,0,acc59e865d0ce05f3a50e873ad66a28d1de10cd7dbd6a37da8f717c7f196f704,33002320510
20190326,"PAYMENT RECEIVED",1296556582,0,f9a1cbcc210c89a3669fb89b351933255af00e978861736a35b6f095bf045ccf,31709485806
20190326,"PAYMENT RECEIVED",1276494259,0,c6416ed10ff9f843bcaad31a79da7d845c0f2f220b7fd57eabe2677636c955e5,30412929224
20190326,"PAYMENT RECEIVED",1276276023,0,3f4294279a67df5bfae001a2cc41ba612ee058279abe40e49c4c7535f35207c2,29136434965
20190326,"PAYMENT RECEIVED",1276518632,0,6ffd5b49a316c6fe24b6b9de16896388b0646015732096ba4ab3c815a40b9f10,27860158942
20190326,"PAYMENT RECEIVED",1304027543,0,d0f387e11140ee3bf4d246c4fde299a37e8b814762e7c808754214f1cb3f596e,26583640310
20190326,"PAYMENT RECEIVED",1259345658,0,f2b9e5f502bd72c5851cd3f79dd827c0f4310b804e046e0fe4bd1aa5ff46bc7e,25279612767
20190326,"PAYMENT SENT",0,-49554050881,d470c31af657e26d492fad7027bca34551a6b70ab90e5410d1bd4a1b8e0f7542,24020267109
20190326,"PAYMENT RECEIVED",1255910955,0,987d757ba5af1c6359fd61cb398fc250d1b3579c01decb450a21936fb90fa29d,73574317990
20190326,"PAYMENT RECEIVED",1263353498,0,2c0c40ded67ab3b090724670daa63a50de0f98763b46574100bb5bf43eb91c1f,72318407035
20190326,"PAYMENT RECEIVED",1257435168,0,843109d077dd1c765551bbbbaf8d5dc711f89d1934450ec153577bd7d552ca4a,71055053537
20190326,"PAYMENT RECEIVED",1263324883,0,ad4f39b8d989ae3e71dc11a95035c4821775d4114137f9a64c3eb812bac45249,69797618369
20190326,"PAYMENT RECEIVED",1266625506,0,37cb6cb04afcb1b2e781dacd4b18bae0d59760007841bdb1ef77dfbfd38115e2,68534293486
20190326,"PAYMENT RECEIVED",1270791150,0,c3b9ad302c837198b46c6c50bdd185486e689dd261b76856178c517f90b3483f,67267667980
20190326,"PAYMENT RECEIVED",1270557088,0,2f5fef0ca2a2171ff3d5fb1864d04ff5ed9254676c6b5e91b13dae5ac69399de,65996876830
20190325,"PAYMENT RECEIVED",1269283338,0,60d1ce63c4ebfc671bed5d203b1fb925242e245c0768a7c1c2f31c8ef8be6857,64726319742
20190325,"PAYMENT RECEIVED",1286312405,0,f479e785f236fe9a69e427af2941772d097f455531d5767bdb67f40c9273ae55,63457036404
20190325,"PAYMENT RECEIVED",1257336871,0,a6dd02a8a9d242653552f50d86bf8d146e292f432633788955f9dddcaaa61ac4,62170723999
20190325,"PAYMENT RECEIVED",1271643901,0,a09f9d85e5250386aef9df45cdc656722fce0949f2caad13fbcd2aa105cfe159,60913387128
20190325,"PAYMENT RECEIVED",1277756799,0,7a3ffaeb9ec3054db578d1f1b15d1db9fcb0281d5a7454fa26477e1f2dc7c19e,59641743227
20190325,"PAYMENT RECEIVED",1293280207,0,c67e90821d57d338da58cfd764ec2f9fed102b6e6266ec8f81715e2e69025d5e,58363986428
20190325,"PAYMENT RECEIVED",1277019143,0,a90e71e814790a348ff1f9203572307fb7c36752723b8fb1f82b32959c461668,57070706221
20190325,"PAYMENT RECEIVED",1316909764,0,24bb918c5d00fe62dc69b69570641710678559968141bbc20e26f4c2ee5cd4c7,55793687078
20190325,"PAYMENT RECEIVED",1281832632,0,7202242c2d799da35ca43266fd4645d016c4b5f5bda32dcdda084587bd39d132,54476777314
20190325,"PAYMENT RECEIVED",1262937716,0,f1b9f21f7153777f300d1d4e054c9b3f1c4ab2696c9c92b7cb97a01ebef4c9ce,53194944682
20190325,"PAYMENT RECEIVED",1280019637,0,6411188b8989de6292781adc7bb98e49de1ab44da2d99e68b0c1e5d89a813238,51932006966
20190325,"PAYMENT RECEIVED",1252687150,0,90d5612ee25e7f97700aed0f528f5d22da961f159c9c38b155ddf4bd58c487b1,50651987329
20190325,"PAYMENT RECEIVED",1252571512,0,5e2b4d1a00d924c0aa8bdc6b35c1658f0b9693713da0be49bb22a10d47ed6cfd,49399300179
20190325,"PAYMENT SENT",0,-30269413652,7d979294889103875c1c4314a08ffa040a4b05f1013d3de2f48adc85a16162e7,48146728667
20190325,"PAYMENT RECEIVED",1258939164,0,0dbd0d7fcca12ced7cf0eaad808be39562fc85c8117de5f3d098a5f361d0c8c6,78416142319
20190325,"PAYMENT RECEIVED",1250000000,0,bb8391ab6adfd9f2c2cda19b9397b236cdc7d963305e7e82dafb2c2d9f09d163,77157203155
20190325,"PAYMENT RECEIVED",1272183552,0,1df5882951461012ca8d1a78fdee0fd03fff0f21e4759d8ae6c40fba3e833376,75907203155
20190325,"PAYMENT RECEIVED",1261658370,0,eeb032255ebd4bee166edfa8ccb7e4f225c7c9f1029d78066b40d7448ef390de,74635019603
20190325,"PAYMENT RECEIVED",1260434122,0,ca6d62492216463610a490e4d53edc550dff4a4d3f23d8de6675456912aa0d1b,73373361233
20190325,"PAYMENT RECEIVED",1263841962,0,f831952397be9919b499993a76a3cd9d19a14f65d50e460369db63bc312c91de,72112927111
20190325,"PAYMENT RECEIVED",1253661850,0,549980323a8812589b04795b29d0bee714b80a19e67acf88d4d439227517fc8e,70849085149
20190325,"PAYMENT RECEIVED",1261639357,0,25f63b4e86c5d5f062978af3932f82a6db182912ce2b9843dbfda47ec4c1dc72,69595423299
20190324,"PAYMENT RECEIVED",1258804656,0,2c1f6c3729dc1677758001299d1451f125ce684d91a47f1249541ed73a0b0933,68333783942
20190324,"PAYMENT RECEIVED",1258710174,0,fa4d466fd594cb9e7c9f54dbb32f5eb35493c5c28b2e1689bab331b2a6695b50,67074979286
20190324,"PAYMENT RECEIVED",1252249336,0,e207ba84eca9cfafa9d0c4cc0e6c8ff2d4c9e617b967a34f55a058f0bff1d1c2,65816269112
20190324,"PAYMENT RECEIVED",1277967343,0,c68740c731e2a2c195c72737e3dd4f7c6222e88b90e31fb71a837c4517444ef2,64564019776
20190324,"PAYMENT RECEIVED",1250735987,0,e10b940ee8ca703804b9d23997bfada24bc2995d110dfe5c4c4aae0155ecc2ea,63286052433
20190324,"PAYMENT RECEIVED",1261769525,0,67bdd38e1873dbedd6e59fd220176eb9f55241f9b1b55f57f8a8fda44153d0ca,62035316446
20190324,"PAYMENT RECEIVED",1260483099,0,8df68ade762a7e5ab31a6eeb0a9c0908da197e89aaa8ccb6ea2408d90f14a41f,60773546921
20190324,"PAYMENT RECEIVED",1281200463,0,5a8921965d9ca6bf425eaa81e0eb83a25300a03f0871867fa684224e04314bd2,59513063822
20190324,"PAYMENT RECEIVED",1262225533,0,c3ba93facabdaabf03761515986e6791bce7a8d3fe68a62beea193f9d94aa130,58231863359
20190324,"PAYMENT RECEIVED",1296978187,0,ca80122eaf4ab5e30cb6c2975631e971dc4d7607054f191bc6faa57b56dae4fd,56969637826
20190324,"PAYMENT RECEIVED",1250996785,0,849adaaf5e8993bb957519916c2d38f9b9afcd380286f17e6e049ee986e5ed2d,55672659639
20190324,"PAYMENT RECEIVED",1254711503,0,79e99ef2c19513eee862bc0f57f6f3803082caa796826d95d8947c6de3e42a78,54421662854
20190324,"PAYMENT RECEIVED",1261401174,0,629d53c2f6809acd3a68b2c945189eaf09130f834203f227ae165e0208ff00ad,53166951351
20190324,"PAYMENT RECEIVED",1254079349,0,b0952b651fc5f141f4958e8eb0b1ab3c41b55075f0295442982e45f79f7903da,51905550177
20190324,"PAYMENT RECEIVED",1250891727,0,78b7b22af9a29ee405e87b28e9a7b96dbd0ecb029feb0767a4b9939599234539,50651470828
20190324,"PAYMENT RECEIVED",1264116049,0,b47526d514878dc4ea92fd7b2eace9bf09ff00dc44de7ed4a390250fe8e2da56,49400579101
20190324,"PAYMENT RECEIVED",1273502800,0,1e17d5c2bb9d325e947ae51996fc435957cac9f8fcd169972a903cc4ba678fc4,48136463052
20190324,"PAYMENT RECEIVED",1259086591,0,fc185eeeb2ea8d855c26de3fe7d7480d29c67d4746f4384c7ff07616a445fe17,46862960252
20190324,"PAYMENT RECEIVED",1254984837,0,75cad8f5167c237f7fd5df95e7be69fad4e66e069e532f9f90b3cc2f1ef5eecd,45603873661
20190324,"PAYMENT RECEIVED",1250380619,0,5ee0dd1f893b57cdd236e59b6365e72d1e4e37ce203dfadb88f67dea1fae614b,44348888824
20190323,"PAYMENT RECEIVED",1253957295,0,2ad8f3af83970a326d04598c71f036c52627a7b42cda3797e372da961fe8e880,43098508205
20190323,"PAYMENT RECEIVED",1260929073,0,c6f2cfe2aa8a0c966973ac9076287a9efe6595a891d8880f14b1d3c12cd9f1b4,41844550910
20190323,"PAYMENT RECEIVED",1263050434,0,b0750a5fe25f1333a6e9b6eda3bb57e0e0cfdaf5fd06f527569beee0a163fd08,40583621837
20190323,"PAYMENT RECEIVED",1251148013,0,4130a07880fa904c242f92bbc8cce69de1ca3dce9a6eababd91ebaa96787a43c,39320571403
20190323,"PAYMENT RECEIVED",1276105919,0,0240413dea142a77c44c7ed1eb672ee5a10da1bf9e7366a669a63cd1975269cb,38069423390
20190323,"PAYMENT RECEIVED",1269609660,0,ca1e8e5bd8742eb2d4aadc175098ee298869751da773f5ca3daad695d3966d19,36793317471
20190323,"PAYMENT RECEIVED",1266103202,0,49f4af1724b2a6febd956283ba74c511b4a0de99b330dc02e44b024c3666fcbf,35523707811
20190323,"PAYMENT RECEIVED",1280206593,0,436954991e28650d9be458817590dafd1fdd595dfb7ce32a81c3856a12243547,34257604609
20190323,"PAYMENT RECEIVED",1261865255,0,efc36e33333b6e574dbea668d442f14deaf6fe94b8015e717afa52986117ca6a,32977398016
20190323,"PAYMENT RECEIVED",1260098494,0,7e88533284ca345c55838e5d2ef753c50e7aab2b6e4728188845bbb59e58d526,31715532761
20190323,"PAYMENT RECEIVED",1271264433,0,c15115874719ffa90fe42de4abff27e80dec470f814e3bff8abed6bd08cd971c,30455434267
20190323,"PAYMENT RECEIVED",1257599073,0,55e26fe74f7eefc0f6e24fdf1015dd07df2eefc73c27a4cb55f7e4a9edf6e001,29184169834
20190323,"PAYMENT RECEIVED",1270132250,0,034b3371f94cd43289c28979ad077358c76e91bfc1c29f37cc4f169549ea0498,27926570761
20190323,"PAYMENT RECEIVED",1250845816,0,45801180997355346d8d6daf92aa8c36728515ba26a2dbc6ea569b1fcbbcc56d,26656438511
20190323,"PAYMENT RECEIVED",1257202556,0,3c29654fbdc5af0b87cefffd990bf92bc544a4963c9980929b2f3d3b6cb1d7bf,25405592695
20190323,"PAYMENT RECEIVED",1267252880,0,aa5f77e57cb3a7f647ecc9e86fc2b523b143e9af969db0382934e3ee7ae5edb5,24148390139
20190323,"PAYMENT RECEIVED",1260578217,0,c8ffacc8044f012e9c008f60735da93c37f2967d0244d5de42c38aa97da30d7e,22881137259
20190323,"PAYMENT RECEIVED",1254777474,0,9b55724e235e8b95c8a2490f8425afa420d781c6d9cf6a830421533eef74c0c3,21620559042
20190323,"PAYMENT SENT",0,-32959996548,2c6688d1496badaa5ed504336c4aadd1cd83705ed418c15c3833515a6ea9d532,20365781568
20190323,"PAYMENT RECEIVED",1256465932,0,efe32df060485d814ab70dd1e9194a95519f2134e65118d5d1996f86e2a45e04,53325778116
20190323,"PAYMENT RECEIVED",1283900597,0,5d6f238b3103cf04eebd17da8640bd953680ad1898217ca5c54b12039fd1ca3a,52069312184
20190322,"PAYMENT RECEIVED",1258394973,0,fc285d942f765b8961b6c3d22818f60f02c8aec8fc85b95680a7584d22ae3433,50785411587
20190322,"PAYMENT RECEIVED",1270495147,0,7388c324975981500f4cd8774e10c9e0ecf4ec244e05fc5a56a6b925264d125a,49527016614
20190322,"PAYMENT RECEIVED",1265462777,0,f96201200b2246316822f7d1d1c8aa98c7b243696629ce12c011f843d7d0f9a5,48256521467
20190322,"PAYMENT RECEIVED",1267850007,0,d8cb858a991a180553c623d6066270bd2fe3111570472820db74ab417f631c39,46991058690
20190322,"PAYMENT RECEIVED",1265756021,0,fb19411f7eea8bb722c357bcd4161aac29ac59f295b31023183af6b366005ff0,45723208683
20190322,"PAYMENT RECEIVED",1271684634,0,e6b5201d823de048cea7c04566ab82f1239e9e05d2e3bf0b162a48437c616190,44457452662
20190322,"PAYMENT RECEIVED",1268641892,0,7bb31d951408ff7ee1d558b727382387886c1cf578384d7b38168dcaf498e68a,43185768028
20190322,"PAYMENT RECEIVED",1257842844,0,598579e0388e0e4d3af64b33b53c4c2716f4c640536d07421645dcd83726aff6,41917126136
20190322,"PAYMENT RECEIVED",1263363300,0,0509c15805baea74e34cbd2acea4831cfb958936b802f59fecd30b889963826c,40659283292
20190322,"PAYMENT RECEIVED",1299063392,0,36f1faa983ca1a61888362383492d951f1aa0e820b6523d6016c48505efea364,39395919992
20190322,"PAYMENT RECEIVED",1272707179,0,4bcf19a977d04400ab615e8c4ea3874907422ae5cb5847a5c2ecfc846a47736c,38096856600
20190322,"PAYMENT RECEIVED",1330939773,0,29219cfc5d0dbf99be7fe7e35ca317640ef0bdbc889f713c5ed9476dee19a31e,36824149421
20190322,"PAYMENT RECEIVED",1259316059,0,06b5dcbb4f420eed917613f5140be2bc076b90109ea16f8766eb27089b8262e1,35493209648
20190322,"PAYMENT RECEIVED",1273896495,0,37967dec01cf704dcad4c2630794eac168505881ac4fcc6e1cb72c2c449bcd74,34233893589
20190322,"PAYMENT RECEIVED",1271864289,0,11a86d822c5da8f6bb561916e64ba57af96eb4ce481d887de8874bb0fe05e586,32959997094
20190322,"PAYMENT RECEIVED",1256767045,0,17bf31b06d13100a93b31899d2c7707c40c9b92141d8b7cdc1f603fe851a7cb9,31688132805
20190322,"PAYMENT RECEIVED",1251010329,0,5997a880d02f7625da138f124ac45d4cf7d410013d8cfc6dbe4629efee66d2c1,30431365760
20190322,"PAYMENT RECEIVED",1257150089,0,8997dd33e2b7a6d0f07469d93ecbdb705537552c8259fd8b98a641df0214f0b3,29180355431
20190322,"PAYMENT RECEIVED",1258438361,0,17cbaa9e4823214f0165d0c52483865e77494bb4a0c6966de3e521b1c1904902,27923205342
20190322,"PAYMENT RECEIVED",1250270770,0,bfba322d229759188ea3e1a1d55ad7fa7b152f2df1219fe8b6ccd49727ef9de5,26664766981
20190322,"PAYMENT RECEIVED",1252433693,0,9f61c43a092ca7d5b0db2aa142c5233a719b89467727342ba2f78392e844e02c,25414496211
20190322,"PAYMENT RECEIVED",1253398284,0,da290957feba5b8436b86c0e22b6c23307b9bbc9302aeceb4ea99f898e520456,24162062518
20190322,"PAYMENT SENT",0,-21516335485,07e18869fce1eba075b90da5a3a2bd90f3fce4367f2ac42f933f64a4a18229b2,22908664234
20190321,"PAYMENT RECEIVED",1257194480,0,db4c7832c4128e72730a12dee11d077ed1a362feb0888c99604524855ac9227d,44424999719
20190321,"PAYMENT RECEIVED",1265964775,0,2929ddb2fa938c38f0c5c3376e9ca462d68b5d689011c19e5f36dc473b8cd42d,43167805239
20190321,"PAYMENT RECEIVED",1251839781,0,28302607bc7cedd891a96db42b4cffec05f85c18d0dbc96fe616b34ac1666333,41901840464
20190321,"PAYMENT RECEIVED",1261502463,0,a792fc2f6d308ea07debc3b09e2fb5ef6fc90d614632bd41f392b8efcd15bbe1,40650000683
20190321,"PAYMENT RECEIVED",1289484858,0,679c3b0b7cecf075cd10f6e053e4829eddfec4133c76c86644634b9423863f43,39388498220
20190321,"PAYMENT RECEIVED",1316657382,0,898cf028b78074651789f41dc1b19d094e813e2288dc03a54f522f37ff9d8882,38099013362
20190321,"PAYMENT RECEIVED",1290699360,0,2852ad01b478b44f5cfda7dfdc3afd6e72cca251fa30d62bce9e06d573f662d1,36782355980
20190321,"PAYMENT RECEIVED",1258839517,0,18cd40d53ec0dab79b71e2fd099bc51eb7e823a2c1513bf0e737700efe346704,35491656620
20190321,"PAYMENT RECEIVED",1266978203,0,d4247de53deaf445ce9c5f3d566b7517762f69beea1eee6e0f2376699c5b883f,34232817103
20190321,"PAYMENT RECEIVED",1284430137,0,632b79a745639f3cf6098e0a7128b9271fa349518d32061dc6eefb8347f2b8f1,32965838900
20190321,"PAYMENT RECEIVED",1277958152,0,d212432930b860fe7ee65e199d5937c4ba8ac9375f470cc30abd229b4af59e01,31681408763
20190321,"PAYMENT RECEIVED",1273014636,0,92e9942da70db243aca19ea677ee5b317ddaf66300a3e3b7a512fb613d075ffa,30403450611
20190321,"PAYMENT RECEIVED",1279910948,0,b6edfec97a2784e62183fcf9910304cfea21d3d0e9e14150b709ca970ef9ed89,29130435975
20190321,"PAYMENT RECEIVED",1285212933,0,23bac46970bacbfc418f94d9fc55458af26423e0ac886005eef3c2071bfee40c,27850525027
20190321,"PAYMENT RECEIVED",1279577921,0,d4ba3e4297958045eebd9bc4dd2c64ea8116a1a3507cec19cfb4e97d8dd5c38a,26565312094
20190321,"PAYMENT RECEIVED",1253822675,0,0c251ec03223508f8d0adf9a60e780be853d4c438718e1c37dde58c6522239e6,25285734173
20190321,"PAYMENT RECEIVED",1251785512,0,b89cbda0cddde2295228a1deef71ced7eb151981e638e3dd1579dd0db9a52b6d,24031911498
20190321,"PAYMENT RECEIVED",1263789955,0,664f53ffa3ee766ae1cee81275780515df6965583524117b9676791aba479b93,22780125986
20190321,"PAYMENT SENT",0,-21517919784,9af1ce0dbc89f2022c3d0dd86285d399e2fa19a5c40e958bdf313b7ff1dec7d3,21516336031
20190321,"PAYMENT RECEIVED",1283375381,0,e3030219e1b8d86ef6fa83e7efcaacc5cc7ad30271cf9446353a31e73d33573e,43034255815
20190321,"PAYMENT RECEIVED",1253177170,0,97d78bec7329b9a83fb286117ee702cfc794552cccc89acd47d4c4428b006c6a,41750880434
20190321,"PAYMENT RECEIVED",1265308231,0,eeb3fe9002a102ef37f3714adb0c06634c495654c0d55f8541582584b91cba8a,40497703264
20190321,"PAYMENT RECEIVED",1261278500,0,ce1222ae0882d3c78642a56fe6a1f55fe272b7ca4e1e15d173aa9e8eb14cca41,39232395033
20190321,"PAYMENT RECEIVED",1268096564,0,7f163cf37fe002b5138f82744f4d29088cb18b18d9d179d9632b9c431bff0149,37971116533
20190321,"PAYMENT RECEIVED",1252035979,0,b336acb35d2266a146199f245dccb1a7f30b5494074861a461e31613c5df04ba,36703019969
20190321,"PAYMENT RECEIVED",1260693063,0,a9b00e6cd660eb93b4c1e9c4853c1c2b7578982ce4cab68b45a9ff261cc73c3d,35450983990
20190321,"PAYMENT RECEIVED",1278492240,0,9b1aa3f4245eb2a0ef175764aff57d8d9d0d08dcdcd5409e207cf14d4fe985a8,34190290927
20190320,"PAYMENT RECEIVED",1255157023,0,876f47f98d95e50b9f90c73632f1e373eecb1fdeed7fef2873b76c90b1548a65,32911798687
20190320,"PAYMENT RECEIVED",1277403084,0,24ae7a9e45d07d7a05854757cb2c6c391d2a015f15e91266e8d060c62e945a55,31656641664
20190320,"PAYMENT RECEIVED",1261123639,0,1636fa40adab752b83c052c8b3566af033e89f3f72a060b29a1f3afdf98725e4,30379238580
20190320,"PAYMENT RECEIVED",1268353119,0,35e32052bc10d53f9f17ff0abc4441f4f23f49afb2d660b3a25ab478cdb20e07,29118114941
20190320,"PAYMENT RECEIVED",1276674141,0,09f833821901a373935e5f02c5ef64db53da0cfd6a9df265fded6aeab1e5f951,27849761822
20190320,"PAYMENT RECEIVED",1255334514,0,572771b50f8f9b5f0b6cd0ae9099807eca1b4a458b33d10de7adc2e71a5ffc76,26573087681
20190320,"PAYMENT RECEIVED",1262995126,0,239ad155bac3ec20401bf160e9873b1a398e0c3b8269c8fe2e36b461a1b5fad0,25317753167
20190320,"PAYMENT RECEIVED",1276754596,0,7d6e7e0f8f422ba15b84fedc794de33b4047d02d96448823179239c655982dc9,24054758041
20190320,"PAYMENT RECEIVED",1260083115,0,68660c03af2662338846f91514f21ac8bfb66420401cb5777ce20c7c7f919116,22778003445
20190320,"PAYMENT RECEIVED",1262221158,0,c64c027fa2318acb3e67025c477fbf26a45e0419e5f90667b8bba2a3d0726ea6,21517920330
20190320,"PAYMENT RECEIVED",1291846560,0,b33c4b9af33307b92a259f82a18a9fbeca186e67c60b5469ff8be46d2d8fb460,20255699172
20190320,"PAYMENT RECEIVED",1274412635,0,71894cc95417a56c1947b3bcfd02e4f550cf96e573c45ba7fc6c4de9d3883ff7,18963852612
20190320,"PAYMENT RECEIVED",1256117662,0,a161e2c577fc25e48b773bb2edeeaaafbf1515779e48bf91c68de7a1c0f52d5e,17689439977
20190320,"PAYMENT RECEIVED",1268297405,0,d669ee37a3d77a97db31f4a0133ddd60c43b9b38d7f958688906f51caf2e2d45,16433322315
20190320,"PAYMENT RECEIVED",1264105803,0,45ec0734b0d7f3dc8d3058f570a402a8fe06fc2351056c9a85faec288e356c22,15165024910
20190320,"PAYMENT SENT",0,-7577533537,7d3a915d766e679cfba7ba861393c93dd8e6bb558c1c006fe72a5d52a02d1374,13900919107
20190320,"PAYMENT RECEIVED",1278948540,0,453126888a003d71abe21bf320ec5e8f4bd881b4b289db7587acb7532872a6c3,21478452644
20190320,"PAYMENT RECEIVED",1251854297,0,48f9cb3b14038966f8449c544e121391cef1019ab3ba5ff5c008886716ae3b2a,20199504104
20190319,"PAYMENT RECEIVED",1252787743,0,a39a20f15d632e2536039ed1bbf0e9864e4dc678fa49036f405d8edee7d8ab77,18947649807
20190319,"PAYMENT RECEIVED",1257854594,0,c61e8a40a0b2cc2ab4fe4b9ce7737cb32dc3d76b3e2527ee04b7e4bcb87c38ab,17694862064
20190319,"PAYMENT RECEIVED",1258057479,0,3b79d90a53fae93f31b6a79c45bea1e81e99e4bbfd66135b16a4a5c3d8e39e51,16437007470
20190319,"PAYMENT RECEIVED",1269948740,0,c8484840ed1b3520c8b775628912f6a4900df40a85cf60adaaa64aba28f734a4,15178949991
20190319,"PAYMENT RECEIVED",1265382720,0,25d08329ea372af8b0e8350c0f0e82e72842aab601b3cd81bc42dc0cd8395d72,13909001251
20190319,"PAYMENT RECEIVED",1278540976,0,9d2fd12b28a7f6e47291745119d83b43297715afb89f8df1bc353c6981c29b66,12643618531
20190319,"PAYMENT SENT",0,-8859651469,ce9f3e2da4e24edb0a24bcd063ffcde3b27f12ef3f4d8303b0f14ce80dfa3810,11365077555
20190319,"PAYMENT RECEIVED",1256426952,0,c3e0389b2ae7c0fe20d4a43232a87d216c747e69d53e9c6d3a6a65c357522548,20224729024
20190319,"PAYMENT RECEIVED",1253725921,0,945e030a1d0599249c3730e96053ee93ac130eb68f77b9d192edb00d785cb09d,18968302072
20190319,"PAYMENT RECEIVED",1277390599,0,6306a22ec6b9c6f714f5167c2e043e1de260a422afe37c8e0f6bb326af117e32,17714576151
20190319,"PAYMENT RECEIVED",1272130125,0,955139b0612eb9e2077ecfd701af2330bc9ddab8645231bd82f55ffa735f6015,16437185552
20190319,"PAYMENT SENT",0,-20293177825,6d06726bbb4d30a83c2a175f0adb34882e8f3e6ff1b7b1f7e1d7f8fd2ee3f43e,15165055427
20190319,"PAYMENT RECEIVED",1268175798,0,d1e101ec5719fdeff69bcc63264b215b237510cf86f17daf85e4c3155c7c6650,35458233252
20190319,"PAYMENT RECEIVED",1252164315,0,a451e7018b7a40adc925575357c563be5912bc1beef55b2d80aea24633899dc1,34190057454
20190319,"PAYMENT RECEIVED",1256416909,0,119e583021e0126cc5c0c15d9458845103c525e3a8bfc7d5358a207559d8fdd2,32937893139
20190319,"PAYMENT RECEIVED",1274817713,0,9e8f9281fa2eafc603b06a0a3ce8b621c8c68bb409e361fbd5e88300ce82b1c6,31681476230
20190319,"PAYMENT RECEIVED",1253828677,0,d9d3544962cfabcd9428a38a157838b7cb7a8f06d0c3fabbd9fed3a743473c41,30406658517
20190318,"PAYMENT RECEIVED",1250000000,0,41771761b844e33c815dac75d23d9c2d786618deacdfddb86ef1066adeb8cfee,29152829840
20190318,"PAYMENT RECEIVED",1255446486,0,76caff57e6b5eabf79aeaab4944aa212dd6217650e3a59f20d5d656f5d91b154,27902829840
20190318,"PAYMENT RECEIVED",1256477959,0,b9ef9147a07b56099b105161dec7a6e7cd1e41da8817c2cecb8115cb2ae50ca3,26647383354
20190318,"PAYMENT RECEIVED",1282956545,0,734bcce7640783e3a150b1203ac2f92c8ca72f266407d8c95a1e242cef3bf522,25390905395
20190318,"PAYMENT RECEIVED",1273350980,0,6f7bca5e464d7bbf749f57cde5c09c7dd7c9b81195c1c4efcd6d1b30590e147a,24107948850
20190318,"PAYMENT RECEIVED",1282265722,0,0f70a66528950eef7e54b6bf280e2963e8882be17b87887ab48e6d19f64a1674,22834597870
20190318,"PAYMENT RECEIVED",546,0,e4e17ddfaa113d2d3376656cf1fe8c2f0263bf965f40d681009ae805b9ac66f9,21552332148
20190318,"PAYMENT RECEIVED",1259153777,0,726a68c8a984ed786a5884d91e154a73c2d059798a89d064859e5f0b1612b236,21552331602
20190318,"PAYMENT RECEIVED",1255402331,0,2d420c436d1340419052fa288576d9bae04a43ea8b380d7b9a6680adaa43a591,20293177825
20190318,"PAYMENT RECEIVED",1270292948,0,7ab1c7aa359548cb3db4802879f8316a20517b5058fcb400c4522f046a342b37,19037775494
20190318,"PAYMENT RECEIVED",1299433379,0,8445cd3a05722400e9ad1e46735143cd24e836591df73c8023589ef74033d1ee,17767482546
20190318,"PAYMENT RECEIVED",1260513149,0,bc8c80859edea19e89a5b0c98b4f4a74bdb849ec424c67dd64a5efa400af0e64,16468049167
20190318,"PAYMENT RECEIVED",1259946938,0,1fbec5d726cda816ff9a2a0670fc71b6a1863afe26ec719ee742affa75a02075,15207536018
20190318,"PAYMENT RECEIVED",1260484170,0,8ee0d1ac9ad3ead667a0f6434ec0fa5488fc1193c257549750719bbcb72624e0,13947589080
20190318,"PAYMENT RECEIVED",1271722733,0,00cca0bfc93a8e04bce0c920e6e17707c5f6439cae604e1d5de48ec4f07b9594,12687104910
20190318,"PAYMENT SENT",0,-6316865704,a6c0ce602e73239c3a7643d47c6a2748fdca0f7286f0a70f75bbc506f4f2906c,11415382177
20190318,"PAYMENT RECEIVED",1265154045,0,c36d8e56afccce7fc8dbb08bb141aad2d7b0c4be47ee595e707d9cbd1f9601ac,17732247881
20190318,"PAYMENT RECEIVED",1265179694,0,fb489f9fd2a0cfcce0e2e0f5fa198d4cd2beb2b0568264d927fa83055d9a8805,16467093836
20190318,"PAYMENT RECEIVED",1271154103,0,bc44ecafa342fc710c2edc3f64156a86f1dec38098029c91c891d71c74c5214b,15201914142
20190318,"PAYMENT RECEIVED",1284248569,0,c5c04102bdb166295559bb7ccb26bfb698598417cc2303c87ea5a248a9de919c,13930760039
20190318,"PAYMENT SENT",0,-18895408445,d5f097c2f619543777b8c009f82e6692d19dea94fce86970aa99fe1a6ae9b1b6,12646511470
20190318,"PAYMENT RECEIVED",1269265779,0,341410a665dfbddfbed594c5b9c73a2770e018be38f0d0a4d9b8c6a6a9892f69,31541919915
20190317,"PAYMENT RECEIVED",1274538640,0,6ad8a3fda778e9ccaaf70a9ea8804c21e1c7425fa19ffff1842c73091d49eff3,30272654136
20190317,"PAYMENT RECEIVED",1267431616,0,0279216856325621ebae80e3969ccfd27086943eace4590986265f9f3d39d30c,28998115496
20190317,"PAYMENT RECEIVED",1268020338,0,e91c54b9c0c971cf237215507f2909e59aa0d1563f8c1131bede1a95c946fd57,27730683880
20190317,"PAYMENT RECEIVED",1250389393,0,9fe718f6e11b82d5c070b820b8ea2710ba57b4f3c089f2ed86548e77d0941148,26462663542
20190317,"PAYMENT RECEIVED",1268686139,0,fcf01afd0aace1a333b7dac79bdcad4d1854c4165f387fc4d53c38dca0e66c80,25212274149
20190317,"PAYMENT RECEIVED",1276801835,0,a25b2d151c18832d1a724bbc17d77896d8b268aefa12b3aa4458b720569d32c6,23943588010
20190317,"PAYMENT RECEIVED",1250745924,0,2df9d7c84ab7228baee5d14b89af7c64be0ec0793b715f6f1d782812d8a4fba0,22666786175
20190317,"PAYMENT RECEIVED",1270294001,0,48f78e208f8e59518cf72e208a63ba259304260d68874964c2053baf3809f8b0,21416040251
20190317,"PAYMENT RECEIVED",1257385695,0,2e21a338b549828cff6a747d8730ba11aaf8b7cfa0ceecfdf82b22d43948b4e5,20145746250
20190317,"PAYMENT RECEIVED",1250188298,0,856e3645c889e0956e1e8ed0bdfc79430ef7a11656c5a7e0bb8284005e4359af,18888360555
20190317,"PAYMENT RECEIVED",1258803089,0,62c8501fe9ef52b7bf0183ea42e4ca6ce8bca11b56332f9a9b75c13ae936d599,17638172257
20190317,"PAYMENT RECEIVED",1255323804,0,8ba6d13da5c600dc22604730fbdf447c258019bf00d70797df9545ae6dd48bc3,16379369168
20190317,"PAYMENT SENT",0,-25385982145,ba97074666cdb327f27b444117475f121b5f51c4041f3cb69981884d411a2bd4,15124045364
20190317,"PAYMENT RECEIVED",1270159981,0,f67582ada842373470020634cea83f09e8041db805b5de0fc127a1fa5fac81be,40510027509
20190317,"PAYMENT RECEIVED",1260905932,0,5430241a0c603b8333bdd3a47eac191d7ff2a7114c65f0e918ad250da064eef9,39239867528
20190317,"PAYMENT RECEIVED",1260697247,0,5cdb1e4b499142fa9665c4495c2becb10cdc50268b196fd40d88b598928a0f00,37978961596
20190317,"PAYMENT RECEIVED",1255038267,0,603b3bffff02498f4e1413fb7bbce8a1a410f5e7c506c8e095ae6b422e0a0fd7,36718264349
20190316,"PAYMENT RECEIVED",1251019181,0,264ad210514b9598bf2737d2493b5f1149461c242c5b6af3d49f4f813aaf91d9,35463226082
20190316,"PAYMENT RECEIVED",1252662162,0,302f89bc489a01b677ceb0f931f369b4c16d293b2a3b34bc784f5e4e7759f3e3,34212206901
20190316,"PAYMENT RECEIVED",1259934559,0,e37874e4f676519ca4ca141d9e9c848992bb2033a369c1a274a06c04be4045c4,32959544739
20190316,"PAYMENT RECEIVED",1259649979,0,67176a54830738f347cd4b1ed59c980bcf6382a38566086952a509a4cdbcd962,31699610180
20190316,"PAYMENT RECEIVED",1260258832,0,4dd7efe5c190f2bfb5b2e45a07837e3f94f0b81a9bacd931e238631453aa31a6,30439960201
20190316,"PAYMENT RECEIVED",1254676090,0,d5849c0c1f1ac74377a53ca5838922b398b1aae9e4e468edcfec38dcdcca67cb,29179701369
20190316,"PAYMENT RECEIVED",1273626777,0,200cd7fe65216e0c091a7104926d676764ed58a05d385ee7fe2fe19164c5b1a4,27925025279
20190316,"PAYMENT RECEIVED",1259711845,0,5e261e104432afebe14631bb661a68bc6ae32798a9458d0ed3f7632c25ddeb1c,26651398502
20190316,"PAYMENT RECEIVED",1259332339,0,4b638583e870c698be275915396ec9beceaf02ad3702b46ed19c1c0c79cd2184,25391686657
20190316,"PAYMENT RECEIVED",1276248412,0,a1539d2ecea7e07e29d7c30ecf8e18a046d7e65517a441039aea3188de3b4bf9,24132354318
20190316,"PAYMENT RECEIVED",1264017305,0,97a91333238c4e6fbda3b3f4c9f6f762fc8f82e24c6a4f6e21b88227d5320c8e,22856105906
20190316,"PAYMENT RECEIVED",1257360851,0,6d268be65001f997d853cc527ea2e25657cf22c651618824a8ad435807ba6c1e,21592088601
20190316,"PAYMENT RECEIVED",1251238592,0,8035ad51048d8d3a50f6db4d9e17271190b37171b1f7d0c55827826373d577bf,20334727750
20190316,"PAYMENT RECEIVED",1250106936,0,e699187b3a9336be40dff31e3708c43de5ff7468a36909d30f3cda68703be6a9,19083489158
20190316,"PAYMENT SENT",0,-20339198203,7f204353145ab6e30b1d90bf87cc040bb4a0241a7452bef8f2b2642cec79e477,17833382222
20190316,"PAYMENT RECEIVED",1289849375,0,a0d2534987eb4fa3c5a9e2a0f837e7df5b10f32ae58c48eecb99c0e798bb1031,38172580425
20190316,"PAYMENT RECEIVED",1250497905,0,db90cd4a3beeae46d9624a585143651245a02eeb7644826d5a999412824a1294,36882731050
20190315,"PAYMENT RECEIVED",1259262797,0,b18d0e8bd48c62124f5db85e2d5b3d288e23f72937f513bb009299607f253089,35632233145
20190315,"PAYMENT RECEIVED",1265416357,0,caa382ab66c91b32e28743fe3e2c5ef81b75c4297199b7b1452947f1a2ec12b0,34372970348
20190315,"PAYMENT RECEIVED",1252496679,0,966b265124dca7bd2b85386377961a9e67c730a74a32b47ca8d99bce396c87db,33107553991
20190315,"PAYMENT RECEIVED",1262588280,0,b75b0363e5dd4cdbcbf5b12f45f72e6d00278d9cfc75ba940f0ef860990c76ca,31855057312
20190315,"PAYMENT RECEIVED",1291922683,0,e7499cadd41c644297f2b2290144af449cfbe71c25d98ac54adf5a568a84fb6f,30592469032
20190315,"PAYMENT RECEIVED",1271704418,0,50e852e8e196f7afd9229aa0c68334993758faa7ef613b778b027c1f9ef73fbe,29300546349
20190315,"PAYMENT RECEIVED",1272952594,0,e88a8279b0a47dc3b19a8059e4008bbdbc0783e307854c39782a563368fb5365,28028841931
20190315,"PAYMENT RECEIVED",1279471113,0,d846657bb9b28d23fe26f2714b386498c5afd755d57dee01b799f72f658f75f5,26755889337
20190315,"PAYMENT RECEIVED",1295310313,0,851ec3e658da213977d80a0980e20b651602be69fb09ad27d5d3b32a801dfa84,25476418224
20190315,"PAYMENT RECEIVED",1265972820,0,8c31f5b4412807f59556d1d9faee4714a3a5940aff821ceb7228ece74a811e45,24181107911
20190315,"PAYMENT RECEIVED",1261308077,0,8335ead5ae7ecb8f933d4a28aef8a9aa98679a6652c709a09fe23e81042602f2,22915135091
20190315,"PAYMENT RECEIVED",1250477918,0,2eadfadec3160f4728b0913488f342cb697feebac3009623553420c66bd7d3c1,21653827014
20190315,"PAYMENT RECEIVED",1282869098,0,664f730ed36a84ee4893f250a6a74eaa10995233422ad024a84cbb3b02e08b9c,20403349096
20190315,"PAYMENT RECEIVED",1269498228,0,b1ff221fdecfd94bbc0e0bd2b1d10c12e4b564894255aac8e56b12d0eedb4a1f,19120479998
20190315,"PAYMENT SENT",0,-24369036102,65780451a3e30b2c4188acbd8f439721b0e0b6d14ba3bb507847359ad222ecbf,17850981770
20190315,"PAYMENT RECEIVED",1260658027,0,c569bd8882e18647f92cff56942a943f48852e4cb730dc3efe04b9e56b67f013,42220017872
20190315,"PAYMENT RECEIVED",1263580334,0,2c0b406aceda4cc277e56e1b0d6632dc048d03e6167b7826924e9af453e4cbb8,40959359845
20190315,"PAYMENT RECEIVED",1270038722,0,ca9f4f44d532007be1a42c63bb711bac71a06c3a4ed1ed1783218bed6bf26555,39695779511
20190314,"PAYMENT RECEIVED",1270800496,0,db8596e30a47c59a08ebc8d2b672ab00d9b862d2d57816d848d2a515254d740c,38425740789
20190314,"PAYMENT RECEIVED",1290080822,0,795e3cdbe7870fd2ea748604766069f9357c2574bbcd9be0223619c85a7eefc1,37154940293
20190314,"PAYMENT RECEIVED",1268866023,0,5ab00c64d787abfe6185527cda79abf3f18299c10a89ba71ac2be457e71bc827,35864859471
20190314,"PAYMENT RECEIVED",1271302273,0,9ce2b25b640be167ca2e215cc2b418b28aa8ca2cf70db4a610fdca3cc3d73dd1,34595993448
20190314,"PAYMENT RECEIVED",1291356251,0,d72f07a5bad6f170a11bb61494b728bf1521e833cb9d7782fc54f585753b4884,33324691175
20190314,"PAYMENT RECEIVED",1269138756,0,9b951c69f44b5f47d9b8f63e28be44a2a6e7869a3f429a43a4800e1a43f3cb5f,32033334924
20190314,"PAYMENT RECEIVED",1297098372,0,7603b3acdee5237c6198a27f2074fce5ff4602f0a2733935f4708eaca4950e54,30764196168
20190314,"PAYMENT RECEIVED",1284186048,0,88aed12e4555f1ada1a2db38d7233c2c4214e375fea93d991ae3fce4397c6c28,29467097796
20190314,"PAYMENT RECEIVED",1296225181,0,c9d8b01c0d038eb4b78ee2eca5071ed55e756d80caa8605e159cacdf29b22e1d,28182911748
20190314,"PAYMENT RECEIVED",1270297349,0,f444441af2317e7d55cbb43267c808a7e7a27f7282e3aa9e2c00df8a1f236ebe,26886686567
20190314,"PAYMENT RECEIVED",1275538137,0,35f20c4c8a9275408f271e047f231958c58d61396f4301dab60b4af34ed8a3ef,25616389218
20190314,"PAYMENT RECEIVED",1275242614,0,399120097abb3d89b688e2d5072c29cbd7756e67329888ea44eae9dbb2d1c889,24340851081
20190314,"PAYMENT RECEIVED",1259486937,0,89eefdf1ec4ed1e8bdeb2a5f3d4eb3e4330645744fce576799b7facd09dfe74c,23065608467
20190314,"PAYMENT RECEIVED",1279546533,0,e22ec50cb215f87199950229a613415b3571e9995464a0b4137ef8c8639572bf,21806121530
20190314,"PAYMENT RECEIVED",1259657618,0,14ff2c47e20bde7320b060007bbfdf3cfbf00d8bc001891d2d733197ceaa88f3,20526574997
20190314,"PAYMENT RECEIVED",1266686275,0,2f0269f9d22d1b2251b9957c65676e95dc9bb6b3864e90516a555da95c6cac44,19266917379
20190314,"PAYMENT RECEIVED",1279960413,0,3f64d8de03df90cf9a6a3a5625b2ab39e884d2ec856020f5b85e796b8c4cdcdc,18000231104
20190314,"PAYMENT RECEIVED",1292895274,0,83d9c4a4bb7544a3573a05b232c400aed89869353fff3fcf83ea12df31596ebb,16720270691
20190314,"PAYMENT RECEIVED",1320994476,0,68745134477eb320b5733f010ab306924f48378aa7e2f2341aac20c72ca7044f,15427375417
20190314,"PAYMENT SENT",0,-20512925188,bb45154384576d0c64e069dc13fddee6c6060b440b1e5dd51e3f938d1d205de7,14106380941
20190314,"PAYMENT RECEIVED",1257144515,0,9a6e895c8d88e6ce2a403bd1b6846af8dc2e6320d05b2d46483c10238794025a,34619306129
20190313,"PAYMENT RECEIVED",1273640425,0,11ebe72ed24c4c5f337797b12e29e6e6ebffe70d799d2e16039ba127e63cfe6f,33362161614
20190313,"PAYMENT RECEIVED",1290217479,0,57f36bfcc884c49d2cb33d1cab22086a25c7e15c0a9c73307c20ab30910d9491,32088521189
20190313,"PAYMENT RECEIVED",1284649537,0,a37ed7a07d85f07da6af4a0fe33baf45889d69dd996a974cae8c5fa630333a08,30798303710
20190313,"PAYMENT RECEIVED",1278676595,0,737eea4bf372d5636a671c8ae8fa4a063a71f5873265f52c777c772294258012,29513654173
20190313,"PAYMENT RECEIVED",1287324257,0,5c84bd9e07f6af2b41d3b37e0439721314e438541d31295b4996534eb8ca457c,28234977578
20190313,"PAYMENT RECEIVED",1276290749,0,ab99bd9e800e82319a9e8ff42d904b8570d1d9fa5cdf2d9bd72c5e9eabd1faeb,26947653321
20190313,"PAYMENT RECEIVED",1310926266,0,b73e2553a33867aec32302400a56b4a6eb403d7f1ce1f596ed5dbedc194f1301,25671362572
20190313,"PAYMENT RECEIVED",1280680437,0,fc7bd3f3f8ccef57f14aee23a81e5c1615f16903a322a28f3e91683ff0890214,24360436306
20190313,"PAYMENT RECEIVED",1278233127,0,ef3107db9c03fb1ad735fcdb250467badbdb0d775a25bef87dc182d6dde49325,23079755869
20190313,"PAYMENT RECEIVED",1267294528,0,16ebd85837050ff06fd96f51d4b4b8e9786ad915fe11f9a696b523474bbd4b2f,21801522742
20190313,"PAYMENT RECEIVED",1270823170,0,ddb28d11b6bc8365f29d450c02e272e94185de48e6b23b933acede01719c124c,20534228214
20190313,"PAYMENT RECEIVED",1250191565,0,caf4b1f25ba1fda999cc20f4674285060447e7caa469760e7d1ed8fe28c311ae,19263405044
20190313,"PAYMENT SENT",0,-25383194883,ff6d16e5988f76770ff1725087556892cbaa5b6650f427a7f752ac69acfefbe2,18013213479
20190313,"PAYMENT RECEIVED",1261259186,0,3cb6a7cc7e063c4f724a1a91d68ada484e4a3aa371e99ed91947ac770db7df76,43396408362
20190312,"PAYMENT RECEIVED",1289459791,0,3307dd393fb9fbaeb894878fef397304077d4bc090c9d75b05ad5f7b52501e74,42135149176
20190312,"PAYMENT RECEIVED",1279712106,0,a8a797c199feec5acb856aa1e543c1223fbcf3b24149b67d8f00222192a91853,40845689385
20190312,"PAYMENT RECEIVED",1250419193,0,52747aed5283694fe2fe519127160603eb7c3bdb0abe02268ba7b06016decbae,39565977279
20190312,"PAYMENT RECEIVED",1292593449,0,6999316d5d6a83c2ab508092a2f29dbf81e616a7df97db42c4df436215b02e63,38315558086
20190312,"PAYMENT RECEIVED",1252615794,0,4134540f4d2980399c21a66ed8762a0393a41827830cbccf4053d1fe531a1d2a,37022964637
20190312,"PAYMENT RECEIVED",1257358761,0,ee524ab9a55f72eea5ecac6b814eecad7912e76beb0af713cb7598abe5d16497,35770348843
20190312,"PAYMENT RECEIVED",1278068732,0,5f5c7e1c211584c91acca3905fd4ca37110169ef95cb95f8da63523e25d83a76,34512990082
20190312,"PAYMENT RECEIVED",1252891375,0,d322332a54b34f00051b2ef9b0f97576169f2eed42de70e3e4bec15a7f557d71,33234921350
20190312,"PAYMENT RECEIVED",1285464530,0,43401afcfe8055b6928038ef6317ce3d5bde4270cefa65349f8e0dcf2f4bb134,31982029975
20190312,"PAYMENT SENT",0,-24288432033,e5ed7cbb285641ef403704bc1d9c09a7cbfcd98a323c70ce650067c5bb8d02dc,30696565445
20190312,"PAYMENT RECEIVED",1277671397,0,2ff8a08228033ff8f989f673eafbf9ab5e9ea2f9806be5039ff93ce1ae1b6276,54984997478
20190312,"PAYMENT RECEIVED",1285883197,0,e951b4c967ce37bb2b7ed7d17e10e0ce42650d5d581ac034ebdee5d18768c23d,53707326081
20190312,"PAYMENT RECEIVED",1282191362,0,2b19722061b18663d237cef5b43d3b05508931b7088e6ec54b8aa09fb50fd0fd,52421442884
20190312,"PAYMENT RECEIVED",1274443389,0,84286b07252387a8106b181e48b3e829ef04b93758bc89ac978773a61f7dd19a,51139251522
20190312,"PAYMENT RECEIVED",1266230678,0,a97cd775264bad2f410a9cb421879d6f6128e5fcf140bcc6cea8bb71461e230e,49864808133
20190312,"PAYMENT RECEIVED",1279055725,0,448ba3ac05ad98c672792835988193dd245f384de82cab7eebfe690d6dcfc6cc,48598577455
20190311,"PAYMENT RECEIVED",1266207957,0,b849401bf1913468fff03ebf06e3a15baffe436942dc5f5030d44899f6e1e645,47319521730
20190311,"PAYMENT RECEIVED",1259495306,0,944b57a213a0aabd2c4499ded116c4ef2bc61e927262fe41e2618080c2a6b8b5,46053313773
20190311,"PAYMENT RECEIVED",1260403317,0,5c9a687eca856d5eebc0f33b88ce775564b10715b099a73df68798a76c7b5630,44793818467
20190311,"PAYMENT RECEIVED",1261656857,0,448c1f2f752ab9c3033d270c7d00b8f0c2b14ae57fff5543a10cfac9e6822865,43533415150
20190311,"PAYMENT RECEIVED",1264645379,0,9437ba88f1b8c0f03778fb06500f84448d9b9f03c5d7f88ec4f1691bd77a18fa,42271758293
20190311,"PAYMENT RECEIVED",1286539914,0,9a01420bdb199beb006626b2f93549d5811d98f2b8c90e78b6a1469646812132,41007112914
20190311,"PAYMENT RECEIVED",1483338532,0,dda56ecd358317d6fdd1388f1e2a63b73960da50035332c0d30118ede77c6220,39720573000
20190311,"PAYMENT RECEIVED",1275298094,0,b5169c4d6951a6eab2f082f05e6ff9b6dc89c865037f61c56722c15781cd964a,38237234468
20190311,"PAYMENT RECEIVED",1288597554,0,21e9ef4192de3f15cdb1be5f75105ad984058cee5abf7184033a24c318cd4208,36961936374
20190311,"PAYMENT SENT",0,-25296966814,e938ac3710587e1f8c9417e7f5e8d6c676e6069a56b13a33b78440bf7d14baa8,35673338820
20190311,"PAYMENT RECEIVED",1264109434,0,891552a818a3973b364b7646b6a1c08e7248fd408dedb0c78d872cec68ffa48e,60970305634
20190311,"PAYMENT RECEIVED",1254354792,0,f2b0ed14718159fab18bc4b88aab55427159662da6387a1df813d572f3cc7cde,59706196200
20190311,"PAYMENT RECEIVED",1269339827,0,efe2736730e533e29442b1c5c2be76662f12616c0d1f00de8e171032ce7f1474,58451841408
20190311,"PAYMENT RECEIVED",1256018509,0,348752d7f71bcd8375710c39076aac7ac7554636e572ba3786cb2e3fabc538e1,57182501581
20190310,"PAYMENT RECEIVED",1285612468,0,d6c8e01a412f9449ebf90472e8959b21d5bf0b2e96ef4794a4d4b90736565dcf,55926483072
20190310,"PAYMENT RECEIVED",1262586348,0,2bb89068fef6bad9f2155cee632752e5203b1535a7ef070d8bf822745d818490,54640870604
20190310,"PAYMENT RECEIVED",1275310304,0,7267796df41f6bb69876b956b50dd475dd7d2049ce4427b8581517895a942bdc,53378284256
20190310,"PAYMENT RECEIVED",1260571784,0,159fb989a066afd9a01ee9bffb9c801bf34b4b8b1b38d5465410620764a244fc,52102973952
20190310,"PAYMENT RECEIVED",1263044033,0,0860b8b27b64dde45f78ac5cb293baa2245e6efd911f1f8ae48f70a948aebf17,50842402168
20190310,"PAYMENT RECEIVED",1289956819,0,f27d1ca45b69b6fd00b5711f7f7de84968d85adff2d690980dce54e9bfd4b3e6,49579358135
20190310,"PAYMENT RECEIVED",1276944200,0,4adc07a220794b451bec53059cbdb229ccd4f58b4389ead768766e5a085b8017,48289401316
20190310,"PAYMENT RECEIVED",1268132665,0,4f1a2cb6a34f54f65c81940d2ed26f33259f2f9dd2fd7025b2494ca2124711a8,47012457116
20190310,"PAYMENT RECEIVED",1250301757,0,361b22522aa227e9f55fea18c4f4c25c7eee55e99aff806c87a021bd8765fde5,45744324451
20190310,"PAYMENT RECEIVED",1257566736,0,278b075f6809b7eb675015f64b319c3f02e0be3aee442fb61b752c6af0b90f7d,44494022694
20190310,"PAYMENT RECEIVED",1257966089,0,e11992aefa9810b74f9d1d77d2ad1321cb97bba67f5c9471e113ec16fa6167ee,43236455958
20190310,"PAYMENT RECEIVED",1250574087,0,422a1fc601b776a8708ae1afe7aef559830785f6647cd5d55bed4468dc92a674,41978489869
20190310,"PAYMENT RECEIVED",1253764191,0,91d909fa31a0a41a6d53ab9c926a0a2ee374b493baae0aa27353ec9a0dd4fc54,40727915782
20190310,"PAYMENT RECEIVED",1253934198,0,8ee797c50e03c863923f0553ca5328a3f79f7c1332841061945f32d223fe65c4,39474151591
20190310,"PAYMENT RECEIVED",1256516126,0,f6c4d98939ea3a15b37bbcb769930cbc75d8429f0db1f1ba697111f376d98d0a,38220217393
20190310,"PAYMENT RECEIVED",1276760648,0,89b2039111689de8c1078f270533f45ea6a62127b7f5b6143958cba152199afd,36963701267
20190310,"PAYMENT RECEIVED",1250377879,0,5296561aa70f763e2a626d4ae6f209f6a65faa4014e69d518f06a961949a7333,35686940619
20190310,"PAYMENT RECEIVED",1251589489,0,80fc3eff153114c3a876759c2ec7670c5c335d5f61514f5d926ffa60237848e8,34436562740
20190310,"PAYMENT RECEIVED",1250134542,0,59427387246c975b2b791b8c5c2e9a7b23943a03188349867104a72664987344,33184973251
20190310,"PAYMENT RECEIVED",1259290480,0,4b07567ae143b4098e5bb05d0a0b94c6e062fca07ff6a7080d71b66c4e74c408,31934838709
20190310,"PAYMENT RECEIVED",1250221306,0,7d70638cab28f1e65690b7f0a41c83a0c1d2aa8744f9dfc77557d3dcef01e215,30675548229
20190310,"PAYMENT SENT",0,-25398416409,608a7bdbf3f43e54254cc6ad89c2a96f6ddf69328ca24090bbedff3b297c2508,29425326923
20190310,"PAYMENT RECEIVED",1261907166,0,7ba61e69262dcd4d7cddce10ecf5158fe6ae6543e86a6d60b3789a472555031a,54823743332
20190309,"PAYMENT RECEIVED",1263489489,0,61ac9d11c7d8ca04ed678e2050c2f0d81b073d4e64bdae76eaaa7f62d372e3d6,53561836166
20190309,"PAYMENT RECEIVED",1266356303,0,247d653717420bacaa883949074a86ae709c14abb662acd01ca04c77683e4d16,52298346677
20190309,"PAYMENT RECEIVED",1284404313,0,6ded9e9fc39c629279577274b95d861b7a738e48fca57c785b2123b6ee499ccc,51031990374
20190309,"PAYMENT RECEIVED",1259311091,0,ce8508bad4fc708bcfbf5e7d5eb618892e1cf0f3c7fb8a99a0b9e09f4c227e70,49747586061
20190309,"PAYMENT RECEIVED",1268418781,0,12168258bff502f71bd02d169e6ad213f8cddef942c96c550aea30c5a250f8b3,48488274970
20190309,"PAYMENT RECEIVED",1260262252,0,7aa334e4e14d8d47b276a26294e70f58bcd658c200252e371341a072889b2a8a,47219856189
20190309,"PAYMENT RECEIVED",1284686925,0,f5f546b9cea18538c3e760cfc11999a0547f1b6769d1cd550bb5bbf2a874d23e,45959593937
20190309,"PAYMENT RECEIVED",1251490899,0,6e89752d79ddb7e655303390d7296803a915dac8caa09c459105c917fcb114dd,44674907012
20190309,"PAYMENT RECEIVED",1283440003,0,f5b6d8a3b07f7a476bd5df03d3446ab15ce05cda204058397fcfad6a82dea3b6,43423416113
20190308,"PAYMENT RECEIVED",1271412948,0,6598e1190ef12a00774c13a49808584e652c7ceffc5d3b761fea07b662e2e921,42139976110
20190308,"PAYMENT RECEIVED",1272533746,0,648f5f50f37c750088fa7cd404023edc3c4d244b908ef11c5a6bdebd4fd1a83b,40868563162
20190308,"PAYMENT RECEIVED",1294173019,0,e7e3c40ce228c85e58378946b8a95273ff0b129abe4f3984877934162f08e01b,39596029416
20190308,"PAYMENT RECEIVED",1260193415,0,96edf9f7a409cdb7390564cca7abe6a9b079cdbc3376a16a978ac65e18c678c1,38301856397
20190308,"PAYMENT RECEIVED",1253703542,0,6e45322820f9427c586ab68683fae048b2e752bb5a6f9f9ff1e05f3c2b970c2c,37041662982
20190308,"PAYMENT RECEIVED",1280995593,0,0ef8e6ef2ce6e8f21e8e2d3e0ebc49e84e124a844f84331d42dee94f500f5137,35787959440
20190308,"PAYMENT RECEIVED",1292251179,0,e29c0ef57a045f19fd5c79c502aa6215023ec3012a3c13efe2aca8eb8bc097fc,34506963847
20190308,"PAYMENT RECEIVED",1271993116,0,4560403b2d70e149f9cda138faa4b7829b3ea6ca231874115e39889836e732dc,33214712668
20190308,"PAYMENT RECEIVED",1283094987,0,49c861c0afff52f032a243e59fddc467c177109f9c853a2874e4a9b54024a261,31942719552
20190308,"PAYMENT RECEIVED",1258980576,0,a25d42772a6fddc3f9c124402247773818373e7ce9775092c975a5b6a19de817,30659624565
20190308,"PAYMENT RECEIVED",1273201650,0,365c8b479a96a55994576f3132d3bf23bb67d466c2aab2bfdb1e076b7a48fd0a,29400643989
20190308,"PAYMENT RECEIVED",1278826438,0,cd5cc257f93c7616355359601531f3b17cf4e909c182b737236975ba55a7ad2f,28127442339
20190308,"PAYMENT RECEIVED",1306733591,0,e3d337ba2703b44374c420fff0ba9f3e267b15c8580aa6594a8b8de8b98a366a,26848615901
20190308,"PAYMENT RECEIVED",1273562942,0,7c5aff22b2e1c12007efdfceca515425e6c9bf463e8f2386c68b92af36281a7a,25541882310
20190308,"PAYMENT RECEIVED",1269011171,0,3b3893ffe01381e646470956e1e7994165ace30ee05271b0a264da2114d15445,24268319368
20190308,"PAYMENT RECEIVED",1281001057,0,bbf13edb46f470ce2a2a191105445ffebb894b6bc8cc6b37655af3b15e17b29f,22999308197
20190308,"PAYMENT RECEIVED",1269701178,0,be419bd25ad733b3877905daeebee93a44d603121a61b033ae975d0b522009c8,21718307140
20190308,"PAYMENT RECEIVED",1269421234,0,1f611922c5c3f2194aa22014f5f3420e492028281197e757f377b3331234180b,20448605962
20190308,"PAYMENT SENT",0,-19189830811,05d78bac620dc5d45b05ef7c188a51aff5d4f4b05d19e0833085e5167ef02c76,19179184728
20190308,"PAYMENT RECEIVED",1268098031,0,872e4e42ef5d3f9abbf3af20321f9d4cc26bb4c0028c01191a070c6d0369c7c1,38369015539
20190308,"PAYMENT RECEIVED",1280075599,0,6c9ebe85c956a5fc50e10a72a58237124d5848bbc1e3da07f6e1620de35c8def,37100917508
20190307,"PAYMENT RECEIVED",1279032683,0,980cd776f708cbb76f2f9afeda6ad8cfeb228ede748798837e0e99ac272d733b,35820841909
20190307,"PAYMENT RECEIVED",1264918716,0,89dc64a3697cd4284f88945b4dfecac20914c8ff3a477e91010655a0729ea5df,34541809226
20190307,"PAYMENT RECEIVED",1297959273,0,7d59f701d8c9a9aff26597aaf0d117b05f6badad90fb7d92113665bd9c075782,33276890510
20190307,"PAYMENT RECEIVED",1252973674,0,a92778029ac9fb1fe73f0f5fba441868129c4b954960fd42fde0dda3fb463b97,31978931237
20190307,"PAYMENT RECEIVED",1280793914,0,461b0ba51b10609f9e67bdc43bb55d4ed45d40a4aa55bcf3b5909c65cc3fd35a,30725957563
20190307,"PAYMENT RECEIVED",1271087810,0,65e9469342a37906e14dbdd483fe332f5eed5ef14cccf1eeda5712424a4ad1a1,29445163649
20190307,"PAYMENT RECEIVED",1305240794,0,16c73e3a3d17517bdce9af28e7506098d26555f3e99b42f8c6f75512942b1522,28174075839
20190307,"PAYMENT RECEIVED",1289185771,0,f0c2c5b306dfefb30d4c660e70c715dda1a3651484a16aca0fcbc1430c5890b8,26868835045
20190307,"PAYMENT RECEIVED",1286302799,0,4d503f44d61b7c82376e9321ee48d0ce84d824091360270dc108515e897bfb08,25579649274
20190307,"PAYMENT RECEIVED",1253744782,0,3107e7cdfc0b4c6a5b7295baaa7ea8ec465095ce996964941863f8552f74b642,24293346475
20190307,"PAYMENT SENT",0,-25471385787,8d46ffa736751e7b48cd0cb076d009a530519128748661f8d4cef40dbc5957e1,23039601693
20190307,"PAYMENT RECEIVED",1271899377,0,014b1f5b9221edf8c0fa52da13b850ad56f7fd11421ee7a52060cfae08fe49ed,48510987480
20190307,"PAYMENT RECEIVED",1269611557,0,11546aec53a311dde18b9c1bda0d0245fcd0cecb30ad6be5c4a0fb8797afbfcd,47239088103
20190307,"PAYMENT RECEIVED",1290323437,0,f66b86e20e0cd77f56b528790bb56a856c63ac2546c5de8795455ee6c504c10f,45969476546
20190307,"PAYMENT RECEIVED",1300964532,0,f18d9af7f8587d6ee4790e1e877af9131283f29c78e3da77ccb6c5509a27ab84,44679153109
20190307,"PAYMENT RECEIVED",1268253484,0,06939e13f2dee79e8f2b6f7e0ac83da9727b55e9c830db59e2deb053af21cd27,43378188577
20190307,"PAYMENT RECEIVED",1270085617,0,4afd399db8025475f6b944f08bb755b6faa242ea44dfd691cdd93704954cb789,42109935093
20190306,"PAYMENT RECEIVED",1262872704,0,0df41c3a28851c2fc601f9966baf52f05ed0d72dc7af59e8e962c14beda2ed14,40839849476
20190306,"PAYMENT RECEIVED",1258576426,0,ec30a570be3c2210c94445ba1fc09ba754726c58ab7b0ce8d65e70a766f853e4,39576976772
20190306,"PAYMENT RECEIVED",1260077549,0,02dbd6d4eb01cbf9da8113084f158f2c5e5cad6f120e48725582545b509d531b,38318400346
20190306,"PAYMENT RECEIVED",1311091844,0,7007eebe9250b1ca9306af00da3150b2e7e8d6b89bc4cfbba439ae3052a04171,37058322797
20190306,"PAYMENT RECEIVED",1289141674,0,e7b82a06d54aba141b62f80c6e758f09cc8b4251f8d6388b07011cccd1284f02,35747230953
20190306,"PAYMENT RECEIVED",1298452808,0,fa7af848ae1f7bb631d85924192d1c532b8467dd7ce8105b20d64055a72d74a4,34458089279
20190306,"PAYMENT RECEIVED",1316865818,0,9591402ed19ca7f3474b1b735cf8d3df6a2b864abd15e23cfcff6ef44266400a,33159636471
20190306,"PAYMENT RECEIVED",1346983384,0,0c03f77a99b760f0269c78221aa9500f7ed4ad71448e4835974d261186f96c49,31842770653
20190306,"PAYMENT RECEIVED",1265159628,0,6ef786d7182286cdb0ef275cda4708018274042e5256a7ad4afb6d42fd186cdc,30495787269
20190306,"PAYMENT RECEIVED",1273280203,0,3e35a26963376ca67bff4f6a1ec742b2ad0fe2179d6cc594feed6d95d4b46948,29230627641
20190306,"PAYMENT RECEIVED",1282640585,0,3bed0f1d05039afad594aca53bb20b07820d9d380260dbca69d61357a60ac6b5,27957347438
20190306,"PAYMENT RECEIVED",1273228965,0,84c7c9d6bd290376b90f75aec48883567378a3ba4a943d8b8f357f7290de69dd,26674706853
20190306,"PAYMENT SENT",0,-25449672032,ec481d99bcac02c5a7826b791e2e1b3ae1caf69ed9de7885958ea3e06411846f,25401477888
20190306,"PAYMENT RECEIVED",1253719284,0,f76a82aa98aaddd54664c28f3fa39a38f8f61c0b33aeecdaa060a671fa11f6a7,50851149920
20190306,"PAYMENT RECEIVED",1256266427,0,e5fbc36cf579734d4b3afac7d156f7f24227999edd533b63bd3ff2c84c14b5a1,49597430636
20190306,"PAYMENT RECEIVED",1258695252,0,5cfc00fbea5f965652a3b060ed9539550266ccb836b3def29660bdc7446ea2fe,48341164209
20190306,"PAYMENT RECEIVED",1291008641,0,bed38ca970a73420c3310836d9c46fbf2b4ae137ec34ba54d48b8d0f644c7b02,47082468957
20190306,"PAYMENT RECEIVED",1266423765,0,ebc652a16e0a1c7baa3b9b29d82ac91c5ed0c13f81894b3df90591d22d2b567e,45791460316
20190306,"PAYMENT RECEIVED",1281160429,0,f825d840895ae18213565778e7227941fd2a7819871cf6dd71eafa35078c622b,44525036551
20190305,"PAYMENT RECEIVED",1259614794,0,09798f726eeecee13280615ec7c6a6208541280f8b3425989ca99628da10041b,43243876122
20190305,"PAYMENT RECEIVED",1279177512,0,c2c7d0af4bb465c38845652b6b010a2bbf6494d37b2a83e88b5b123610615229,41984261328
20190305,"PAYMENT RECEIVED",1280327493,0,963f44f1ef2fd08563626f2d43ae73ed76fb95cb8d244fcf605efa13aa7d4cf7,40705083816
20190305,"PAYMENT RECEIVED",1261159864,0,2b0e9e9bc560743471aa679a569c7acff8a6f4b33b52595cec5290969530026c,39424756323
20190305,"PAYMENT RECEIVED",1270305771,0,2e74db9655373b2a7dc4be401502ba0811e704639266b82be1f38860174f0767,38163596459
20190305,"PAYMENT RECEIVED",1267775067,0,16e23cd5c2012d02c188f009430e14a774a5d4bac7ec1a2e9f7819c2179b9627,36893290688
20190305,"PAYMENT RECEIVED",1274844753,0,bc2e0a6bac4312b68fdc695990d6c46564163e25a102847bcf3f345df0c1ded3,35625515621
20190305,"PAYMENT RECEIVED",1271503765,0,d596a486e84d80292bb8affe88a0b7a26be1f38f09f2198dc2a40fd9b2b193dd,34350670868
20190305,"PAYMENT RECEIVED",1272580008,0,8ea19560f49434d4943e9d39d5efc62736b914714d8adc54c763eed889bcb7ad,33079167103
20190305,"PAYMENT RECEIVED",1260655733,0,39d581ad5278294be4fd66c8fd552ee344aabdf2c69c2a0907838ace22ee52e3,31806587095
20190305,"PAYMENT RECEIVED",1295790846,0,e4f8b39f48e2f831bee0235f969dec09b358dee50a38c81c315613c9ec7029b8,30545931362
20190305,"PAYMENT RECEIVED",1264118007,0,687406dd8797404c3ca34f050ebf7c706fd8f28d335a607fe4439fc4d576732f,29250140516
20190305,"PAYMENT RECEIVED",1275862996,0,3eb50171f4ceb06c97f9a209e050f14843967e5496c82b9edf336320288f0110,27986022509
20190305,"PAYMENT RECEIVED",1259072877,0,875a629af6185c5bfbaedce2de107a189971e6e0100acb90da5750d35b34e9f7,26710159513
20190305,"PAYMENT RECEIVED",1264581444,0,c5fe6830cd6436e09aae9d3f8d77c79ca351e63946ca1f28a193ad1c65572d65,25451086636
20190305,"PAYMENT RECEIVED",1263501420,0,9798467f64a9ee01ec8fc8bfac824d50dbb7633fa464f150585060bcd8b1ef50,24186505192
20190305,"PAYMENT RECEIVED",1257636872,0,d17f7f843ae2e520b067fb5e735adb761ff953048121184ba6d8f04f70970ca3,22923003772
20190305,"PAYMENT RECEIVED",1250000000,0,48cc84fd15dc53867f5235872e7f6a369694cf0a4dde9f63ee0327dce3c065b5,21665366900
20190305,"PAYMENT RECEIVED",1250725997,0,09f5ec833e96245d699136d1c9af3d612662f206b71cc82b44e930982400921c,20415366900
20190305,"PAYMENT RECEIVED",1250524008,0,1c8cb32de175da4d62064da48d42bf705c90de717329e9c3a8826818886f2a33,19164640903
20190305,"PAYMENT SENT",0,-27784377911,b6bd0db70c2429a8cf4c5ff60a849b89410b6feb02471ba284d0ecde858a1a69,17914116895
20190305,"PAYMENT RECEIVED",1277571396,0,cf9e9665c4554d5f4361d7afe25a45695515f0ae20a6ebfc8aeb4428fe0d41e9,45698494806
20190304,"PAYMENT RECEIVED",1278706385,0,b7eb0a529f82e37fc8a407028cb43558f030d794766bfdd16ee1660b44d8084b,44420923410
20190304,"PAYMENT RECEIVED",1278470468,0,d3a33040c69c8ce943f4d99e60ee575455f6864d53ae324645acff9b67fcf075,43142217025
20190304,"PAYMENT RECEIVED",1259464804,0,55b42485c0ac9849e10dfc919bcda9edc0122786a594b853881a971de837938e,41863746557
20190304,"PAYMENT RECEIVED",1269930692,0,b5f5056edec213744383422373b7b4ce64240a67c8a0b8f81ade49c65c8cdade,40604281753
20190304,"PAYMENT RECEIVED",1259828102,0,6edfbab0a256cddeffdfd610c636e6e39759a18e5897507d9dfba62843de6204,39334351061
20190304,"PAYMENT RECEIVED",1281507346,0,8b679c1f50130624638ffe18cfeb466499a5c6ea1c4db6b13817e70ba5efab50,38074522959
20190304,"PAYMENT RECEIVED",1291766659,0,3198d10b080af36cb03ca50cc7a4497b1be9351910df6ca198c1c74359a69cf1,36793015613
20190304,"PAYMENT RECEIVED",1281686532,0,ab1841d0be9fd1653dc656f6c069f7b1b89959e35ec93bb438de61b84640cccf,35501248954
20190304,"PAYMENT RECEIVED",1335786086,0,e7a48792e8b305fd6d5a56fef868ea75c5115b6cdda4c6826dfd5739b278835b,34219562422
20190304,"PAYMENT RECEIVED",1278785488,0,1b2baf7563b86df7c3b4148f60e2b5b8907158978f641995c67675652646b566,32883776336
20190304,"PAYMENT RECEIVED",1280592479,0,a1e40197c40bcc29cda758b8898f47a797a19958d4110e3e813d142ccbb81654,31604990848
20190304,"PAYMENT RECEIVED",1256422924,0,adb69d607d165eac44b4a09ee27499e0ef841e7b32b2e20e31335a9358f9cbe1,30324398369
20190304,"PAYMENT RECEIVED",1283596988,0,ceb58cd21ab5cc59e679cb98de68117c24399a64823e4f4c913e9cb05c5d452a,29067975445
20190304,"PAYMENT RECEIVED",1268432274,0,9471c48fd7a94dc65af51d20b29d0f0c9079c6ed5066c9133ba4971bae36f58b,27784378457
20190304,"PAYMENT RECEIVED",1276531540,0,311f7fa5183859d814b8f0e4f4aa29cd08151898f5c39bbb3dde8ef843fc68b6,26515946183
20190304,"PAYMENT RECEIVED",1250158889,0,e89a9fed8be8923ee071eb303eb0871378d184966debe8595d5a92416fd586bd,25239414643
20190304,"PAYMENT RECEIVED",1253652605,0,e2b291b84ce7d5cacab81ec07a18a2549a115e4c5f49260b8ed659269153586d,23989255754
20190304,"PAYMENT SENT",0,-24233569087,41e478935aa4fbd531edb61d772f1e8cb770a6a5a47ad4d205a3f9e1e1ac63ea,22735603149
20190304,"PAYMENT RECEIVED",1251971927,0,7b595268b43ca31bf37bf3b0f3784c36e2a763daf88deeb75fcadfc8ae85b4be,46969172236
20190303,"PAYMENT RECEIVED",1262083805,0,33d14661bb11cd6e165d13b47cb8478e7b0f2fe71ec839855f7dd6f5d28d87fa,45717200309
20190303,"PAYMENT RECEIVED",1252412264,0,d01b13ffdd7d41f27e9f3c0df93d7a965032d8369515477351f0959e095c82de,44455116504
20190303,"PAYMENT RECEIVED",1279221757,0,8d788932d4763ba3be3f974709d17dab68e8142c51e2d7bea16e968d622eef99,43202704240
20190303,"PAYMENT RECEIVED",1268307150,0,36071ecbcc099934f8a30ec8fbd489a5e4843c2965c2a06127e37ac9545c9f29,41923482483
20190303,"PAYMENT RECEIVED",1267288257,0,80e3720e2b4711e2e2988faaca07bbb63d4e0a2871ba1d52f187a2e115f167b4,40655175333
20190303,"PAYMENT RECEIVED",1269791526,0,9b866deb2faf5effd4e09b37e8e678bdd44c302f47ef942cc496e7c08eb79796,39387887076
20190303,"PAYMENT RECEIVED",1265640592,0,64f028cfad76e945837681171b127e0f9dc91a58fb823836dbdca25c43799f06,38118095550
20190303,"PAYMENT RECEIVED",1264967909,0,bd63e8f235aa30e2c998f76ebf012f39b9d4276f4079cf3efc4d667f92a43e51,36852454958
20190303,"PAYMENT RECEIVED",1265089160,0,cfc231827159d64ebed3294f6e5a063bc4d2d76838a3dfececbbad685b71c7e3,35587487049
20190303,"PAYMENT RECEIVED",1284440471,0,792ee38b34f3d5633cc4d9fcd252d5068f24d9924f61192d071bc35708fffbff,34322397889
20190303,"PAYMENT RECEIVED",1260553484,0,c12c2571bca27efc27becfe224a7843ec2d52ecef117fc22d1345bbcc0a10e65,33037957418
20190303,"PAYMENT RECEIVED",1280029503,0,5e6e637aec4619fea4fcbeecde5fa84e6228d64fff03ba062fdb49371a118e3d,31777403934
20190303,"PAYMENT RECEIVED",1292175610,0,460955c54974c35a48f40b3865ed4b5cbb5662609179cbcdcc5b981f234f71d4,30497374431
20190303,"PAYMENT SENT",0,-25379510455,5bbb1239de492996e19afc1a7301cb1be645f99bf29efc3d919374119e2e75ef,29205198821
20190303,"PAYMENT RECEIVED",1251718254,0,d71456cb249e93264c1b6af7dd3326d0b7e518b5577a218847cecbe2fde272d7,54584709276
20190303,"PAYMENT RECEIVED",1261416585,0,8641404912a7104c5e8575f3273dc6d0c524cf62e8b4ef6c9222d6cc00bef780,53332991022
20190303,"PAYMENT RECEIVED",1258937672,0,7d30799a3d462997332255c1e3e6fc995f3d8903644951ab0307a4411062a5c8,52071574437
20190303,"PAYMENT RECEIVED",1251892738,0,a68d1ff62cdb8828645149ecd4698b4d0197a36e6ba247c70a186a318c67385b,50812636765
20190303,"PAYMENT RECEIVED",1270638842,0,e0151a08f516b231646237ed56c3f62d313e1cd1afcf8b5f781f96883a65d7c2,49560744027
20190303,"PAYMENT RECEIVED",1251545701,0,7b98b29a60d7d3e5ff92abd8deb5917341f635f5151d5cb664620255476558b9,48290105185
20190303,"PAYMENT RECEIVED",1272732065,0,7e45b6dab032f8dab12a1f98ea19ea3d6427dca0c940fcae31cb88a2cdab4d40,47038559484
20190303,"PAYMENT RECEIVED",1260735578,0,0943d4afebffd5baf2731e4d396ee18ab5557e7a8722dcaed6774adc1456e492,45765827419
20190303,"PAYMENT RECEIVED",1263530759,0,bb60b51b9b343355541051f105383d04138486f2f58146d7aac0128f3288d8de,44505091841
20190302,"PAYMENT RECEIVED",1274368531,0,07af84bd50ff25164458a739105c3dc0dfa59218828e87fd3b1372e960e01914,43241561082
20190302,"PAYMENT RECEIVED",1274362673,0,167756b7b0b8cc32b48725c1472b86bc5aebf4a012913331aee0a7d7cc05b63f,41967192551
20190302,"PAYMENT RECEIVED",1282917104,0,44270bf6017fc8e4ca118749ad140b157ae1a0b63fa7eb46d0199560611a758c,40692829878
20190302,"PAYMENT RECEIVED",1271508759,0,5d14fe49fab2f6f4f6bcb2dc2cf5be07bb8024dc3e07f390467b5e2e1207e5cd,39409912774
20190302,"PAYMENT RECEIVED",1277164675,0,e6bece56cf89e4b77e0f462d45f569f2e9a6204a3a9d9a3942dc5cc83164d52c,38138404015
20190302,"PAYMENT RECEIVED",1293776241,0,2ce331f56f7872c904e093e810f402488ce117dd5d85c3ede35cff5e4d699a77,36861239340
20190302,"PAYMENT RECEIVED",1271244140,0,8900b87275166ace277db7d7b3a9a20f0bf4d35cf9a76a6dfa2056bf9fd3f737,35567463099
20190302,"PAYMENT RECEIVED",1277839460,0,0058b937ddd82a1af8111115ec5752a5c948f4763e4f0f6a2ec135dbb0dfdce7,34296218959
20190302,"PAYMENT RECEIVED",1273685317,0,b19b0d4e3fbdec8b263907d34b6dcd51c0f0e9f3cedf67c582287c18377f331d,33018379499
20190302,"PAYMENT RECEIVED",1271473755,0,ac13121393773968632938ccd01e78389e3d28bceea29d15a231b1f6824a8701,31744694182
20190302,"PAYMENT RECEIVED",1261014028,0,0f9638560aaab4e3f2b8730dc7ba8dca2bc57d9cd369b75828bc62dab5ad3d56,30473220427
20190302,"PAYMENT RECEIVED",1270852851,0,1e50b9ebfa47d3e69dcebd819afcd14700917cf5e1f3c2d218ee80de086fa718,29212206399
20190302,"PAYMENT RECEIVED",1262203471,0,e6f0bf879639118f12bdfdc000cd5a6777760c69d7eb84eea7da7900fe2d05a0,27941353548
20190302,"PAYMENT RECEIVED",1257990692,0,fe1a2c195b7f43a210ed1aa101070258053bc686a9cec4ebbc0c8fdde7e268e1,26679150077
20190302,"PAYMENT RECEIVED",1255001883,0,75bb336d2257817fcb875d65a071ec549a53626d74ff39ae13e82dafc862492f,25421159385
20190302,"PAYMENT SENT",0,-20177786368,af72920ee8489299020c48e65d17615b5a6fb043e424e83b41791a04729d3d5e,24166157502
20190302,"PAYMENT RECEIVED",1254187194,0,0e596e0df3237cef15643a0bb1e02a8fcf5ac5a61367ff81cacfba392d56f7dc,44343943870
20190302,"PAYMENT RECEIVED",1258724004,0,4000349a1ab706eba113ea8ddcb70e73663f87616fc4ccd2bd157eb434df0cb1,43089756676
20190302,"PAYMENT RECEIVED",1278494146,0,5417fab1868e278b3adc0416bece659a604c433436e519beec85d090b1eadb80,41831032672
20190301,"PAYMENT RECEIVED",1270049192,0,19aeaba7913c5f31c0912160dc5b15bf11f9a4fc66ad34cc58cd8aa79926fae6,40552538526
20190301,"PAYMENT RECEIVED",1273642966,0,ed8047302db6a2db4505946fc2479db7453d0c9d7a6f6a6c7a38a3c7414a386d,39282489334
20190301,"PAYMENT RECEIVED",1263180374,0,59706e14e4870b60bce343958e56c8b69e545f2b99a170e3ce4a63172a5ddf81,38008846368
20190301,"PAYMENT RECEIVED",1280101307,0,67a9bb74ba4746da75cfba631dcc4a2a631fdf4ac8399e30ff9164f65c14d942,36745665994
20190301,"PAYMENT RECEIVED",1270091444,0,d26369a71062d72c062484bd29a7bd9e6290d06a8acad11949af7117426c3814,35465564687
20190301,"PAYMENT RECEIVED",1280717041,0,2ea4cc18c59ee6e9d08d31c1ed7ee9ef9a86db574eef015437722c8427d4cd9a,34195473243
20190301,"PAYMENT RECEIVED",1276263169,0,f926911bfecd5107b2cdcd4e98cb6a795fe4d337107d4c14b9b47af24cb054fb,32914756202
20190301,"PAYMENT RECEIVED",1287299544,0,543d5dccd4ecc8c146b1ee0e3cf158c49af03ea25631d44db47a006088cdd1f8,31638493033
20190301,"PAYMENT RECEIVED",1259500326,0,c0210a1e1df7fdb77adf21b998fedd71eb6a6c1435b83595a4ef6c77c29b2173,30351193489
20190301,"PAYMENT RECEIVED",1266495005,0,d766e43ffa23e34685b3690e078733535fb78a951f53d35e613289800aa12a90,29091693163
20190301,"PAYMENT RECEIVED",1258675325,0,11167a0d96d44e2244bced6b93dc42e4bc090a275d256c8ae0c6359aced3fb04,27825198158
20190301,"PAYMENT RECEIVED",1257163673,0,b1e9fca3c0b80cabdce3e8c4b202931cc7d4c514999af60fa19e5faf98f8981b,26566522833
20190301,"PAYMENT RECEIVED",1252622130,0,ebb3b1fb06d544baa99dbf8ddd75b1185df21023cbcd683032d7ea34e6981a3f,25309359160
20190301,"PAYMENT RECEIVED",1255639335,0,b6152bca1b5532396abbe36bb7b31efffdd78603fbeb5e8c0b548c9cefdde2ff,24056737030
20190301,"PAYMENT RECEIVED",1251202794,0,5b8b60523b101a1e6d6cd0ec751ba8ae521dfa2f1f1c7e8337d06a144231e719,22801097695
20190301,"PAYMENT RECEIVED",1252946743,0,4dbcdc556f8efb51d12294496542ada9fd8fd88bf48cf449a8c7156ae3467562,21549894901
20190301,"PAYMENT SENT",0,-29205095699,c4414285c6c42f142e565f4f955cdef169e46532fd7753a8cfdf2f4579b722cb,20296948158
20190301,"PAYMENT RECEIVED",1259397644,0,51aafe80b577749ff3c14a50decdb7b9c85900c6a417232040b808fdad90b132,49502043857
20190301,"PAYMENT RECEIVED",1256060521,0,d07825c5a3f3384db1af94bdd1e1dfb6a5d63fa49f5b3aefa71705a6e2ab5795,48242646213
20190301,"PAYMENT RECEIVED",1254786186,0,6e0cad59d4ffc745c480ff7782b815acce0c7cd35aa865c9290888d23b8c0ff3,46986585692
20190301,"PAYMENT RECEIVED",1259362590,0,61dca7ba1a875998e2edad6b03a8e88899d786af5bada02b1145b8ee50894b0d,45731799506
20190228,"PAYMENT RECEIVED",1264211225,0,b60cfe715e7ebc17c2698045cbf5f2008e9e4d4ef6ef26a5336a039d1590bd59,44472436916
20190228,"PAYMENT RECEIVED",1255409123,0,2f2c110c8288e4c037f6663f061b984450bfb076ba305cc5cca62025b2fdb2d5,43208225691
20190228,"PAYMENT RECEIVED",1282604865,0,020d02b864f5dc6c0cc3735438cc405255de6aa4aa7aca0894be443c47c311ea,41952816568
20190228,"PAYMENT RECEIVED",1253982887,0,bc77ed91f04a994c700b0781686ce94eb3b4144b764e0e6ca76095171e0cb27f,40670211703
20190228,"PAYMENT RECEIVED",1268818153,0,3f5733a39fabd4ab85fbb9aa28988cdbbbafbd3010f78a08bd407a057ef8fc99,39416228816
20190228,"PAYMENT RECEIVED",1270363115,0,13be98c536937f8d183b34292ce9c9761b1104515b2c8e8618cc4af9c41ff535,38147410663
20190228,"PAYMENT RECEIVED",1265360479,0,fb882dd315d18b66b5c5c141151fe9b70ebd39a6c0be35858dab33e6abb02414,36877047548
20190228,"PAYMENT RECEIVED",1277524803,0,76b660b2f7c28ba908812336a6303e52ef1df7a216076c170bc60cd0ed30e7dc,35611687069
20190228,"PAYMENT RECEIVED",1270658513,0,371368362e19a65bdc9c7e5e117689486bf780ad4a544b4103a9f66ac87a9b64,34334162266
20190228,"PAYMENT RECEIVED",1268407597,0,f4ae5e50a21452c47fad7dc5e59d30800c90c6bfbfe84611dfaa7f6cd5d689b9,33063503753
20190228,"PAYMENT RECEIVED",1285747268,0,1fb636dc3d41acda3911cd959d319b69f04f6f445d45677937025c8002e8bdfd,31795096156
20190228,"PAYMENT RECEIVED",1304252643,0,f812b3866b656bc6347787e91d82f63fdbc58e1ad3ea2f3f763b9c359c5dc964,30509348888
20190228,"PAYMENT RECEIVED",1261557483,0,dc8d1710813174ba2693bf9b54abc425c7cecf010be569e2697da81aa178c47c,29205096245
20190228,"PAYMENT RECEIVED",1266513006,0,5bab4040a430b80ea00c5a32a2864fb187e48a9844194f9cd2af8b54ffbd6d0d,27943538762
20190228,"PAYMENT RECEIVED",1262860288,0,a00db78ad022386ac3ed24127fe4a2f435cac79ef635d3a7a542e260ec90b8b0,26677025756
20190228,"PAYMENT RECEIVED",1294586456,0,72f94b40c310b19b9968c1841291e0585143069ece33efd510ad29263b670c1f,25414165468
20190228,"PAYMENT RECEIVED",1305629098,0,85e245a572be0211194bf2a85952482a4b6cae6ed727546db0252140e0fc9d5a,24119579012
20190228,"PAYMENT RECEIVED",1250320026,0,767f1326a893c7bb7acfae27abcdeb1f7f1d8604200a395df02cba2937a2cc5c,22813949914
20190228,"PAYMENT RECEIVED",1252640403,0,cba2e9d56e95d7b28d3fa6f3acc309a1803ddfd995efda35fadbbcebed6b47fa,21563629888
20190228,"PAYMENT SENT",0,-25405756501,5948c29345c560096acbdb20212923e609f9fadd6d0de606dcf622c2fded623b,20310989485
20190228,"PAYMENT RECEIVED",1263855530,0,1c33c4a1b6c341ef97d3d8ed9ed2d8eb7dcb0fef7e5d4d17ac5ecf9cf22c3131,45716745986
20190228,"PAYMENT RECEIVED",1250571216,0,e84925249a3927cae8d3e88c8a21b533e07387e93ffedbc4bf1384700c793c24,44452890456
20190228,"PAYMENT RECEIVED",1267263172,0,f5e69a8ec50daaa19fe9892cb89f0b71b3ee167f00152e236f2bab58d073473e,43202319240
20190228,"PAYMENT RECEIVED",1276501899,0,928bcc052f37eda3a5eba1b3edad8e4b517f9f1695f73e6365f5d524d3398a4d,41935056068
20190228,"PAYMENT RECEIVED",1261560891,0,fcccfbc3d70c2a9fb7992f7b14491c35fe41f2b079ddb86821b94e60eba9af53,40658554169
20190228,"PAYMENT RECEIVED",1288857999,0,89d387594f487dc75047da1754efa906d1e3d17642bebd93a2a1f25ea13a1938,39396993278
20190228,"PAYMENT RECEIVED",1270692254,0,c6e55f669c2335ea91e82c1515cf97b8d5fe21b56ce2b8361eab0d7cf13ce4b9,38108135279
20190227,"PAYMENT RECEIVED",1266398619,0,3f8ddaa3171f87b9070e733dcdab3c23d0f9ccdede8f4cf7596ef3bfed22c8eb,36837443025
20190227,"PAYMENT RECEIVED",1254395477,0,06751293bdd51b194b9c5ca4206d0dd251e27ed9bae369ff0543cd02a72133f2,35571044406
20190227,"PAYMENT RECEIVED",1252747163,0,51b83a15dc2c96ab0af62595b3f98ab65dfbebf48b08b99a7cb2c7dc7dd22901,34316648929
20190227,"PAYMENT RECEIVED",1267433480,0,80e5c8d7d66d6a73ff16ec78dd7303895d452c5116346af52ca3b6d246832c82,33063901766
20190227,"PAYMENT RECEIVED",1286287701,0,c84526c0ad124fe99292e8fbdb14992b1807833f0992af45699812dce3ae2bfc,31796468286
20190227,"PAYMENT RECEIVED",1286135003,0,f2d91209c64098f868be077e95b4c101acf3c7f20a97ff4f0e132c1c028c4ec0,30510180585
20190227,"PAYMENT RECEIVED",1278497475,0,f842c41e53d43c601c9a7538c7674b1322055e275c0a55fb050d2e542d00eff6,29224045582
20190227,"PAYMENT RECEIVED",1259022718,0,a185a0f7365268b816d199264d8d110fbc10023705a1a281a44c93aeca29fb29,27945548107
20190227,"PAYMENT RECEIVED",1280768342,0,99750c7ca3e7b1c81d07130ba5a7f1531a867ea2a8291140fb05ef133e8bab43,26686525389
20190227,"PAYMENT RECEIVED",1261436019,0,270406fc690561d6116483f4c5e5567cc7202f16ba7de75a6e7458be1e40a6fa,25405757047
20190227,"PAYMENT RECEIVED",1278900515,0,5a211580ec8e6b535c5793d2b0fdb2a74a13925e4ba0e22f713f6351a0e832c9,24144321028
20190227,"PAYMENT RECEIVED",1260771241,0,0ea665bda21604347742cb278ad64de3f386fdb0996876fd6d7d2f3ec800a0f5,22865420513
20190227,"PAYMENT RECEIVED",1262092541,0,445121e5e9588d9047eb5c1a4ce53890028a8b0162e37a9a4105f729fdccad87,21604649272
20190227,"PAYMENT RECEIVED",1274852882,0,e32bd0ccab4ea2b82526128c9ad28128476a3118ea8e02ee6fbb6535e52349b8,20342556731
20190227,"PAYMENT RECEIVED",1269665868,0,4d168ab8c8017f8be53ab16694c91e8b9b6a2d7647accf59481a4c8a2292536f,19067703849
20190227,"PAYMENT SENT",0,-24302196056,a049afc74c236cc6853f6baf9f14a3c08e692530516cf3d6db16b302e1e98be8,17798037981
20190226,"PAYMENT RECEIVED",1266394558,0,e5e0aa7bc879189552c9cbe44223f336c528f24affcec219e3576709c1014db4,42100234037
20190226,"PAYMENT RECEIVED",1264450994,0,f92546a6c53b8c8f3a8571b65bb287670a7f5f23bb8944a23e1fd5fc52bb2046,40833839479
20190226,"PAYMENT RECEIVED",1265016444,0,c919963a88487e0942c0675fe83d56103966a8218173fbe58ed898f9859bb5b9,39569388485
20190226,"PAYMENT RECEIVED",1260845106,0,609325e1c9e0136b4a1cd36cd8fbccb4be3e501cb0f99b6fc16cc091522ba4a6,38304372041
20190226,"PAYMENT RECEIVED",1253746185,0,35c1b66ff5971bef02972019e3fdd168f3eb3737825aa4afa676b875cd2b4c6d,37043526935
20190226,"PAYMENT RECEIVED",1255499333,0,0312c85c0d729981b407cc9d77519fb1a6161035dcdfd8507e5a333424895c85,35789780750
20190226,"PAYMENT RECEIVED",1273654534,0,2f7bb763470d1ee3c3cd7bb329c1601dcf2fb8a215079c80660f60df53c14fe5,34534281417
20190226,"PAYMENT RECEIVED",1287481986,0,781e7b86decbd8405e2dd87e33429824b0eb9666eae07d414f0b86efec6bb0d5,33260626883
20190226,"PAYMENT RECEIVED",1272498879,0,4705bf23edac6297325f46d601d3288964301d9fc63d33f9a9e444719343c54f,31973144897
20190226,"PAYMENT RECEIVED",1288478095,0,70bff32ac95f59e865d63a009de1bedc80e3543e5ecda57ec4dd9724420f494f,30700646018
20190226,"PAYMENT RECEIVED",1291514126,0,f7817f75c6dc4443b426910e42d3081bdbf17e49572fe489bbbc8d45cb97de74,29412167923
20190226,"PAYMENT RECEIVED",1281430489,0,cd8860fa7b88a17b9a659d8a42e04d62d161b14a0ba3e7a0f1064cedfebdda59,28120653797
20190226,"PAYMENT RECEIVED",1265788738,0,0364b2b3aec7604070c388de262ba13d8b0938591ae83ad87347920d9329ce4f,26839223308
20190226,"PAYMENT RECEIVED",1271237968,0,9d0bf35ad9e66925ec0232f4ca9ce17458c627acf306d9603a4adb0ad30ed6e0,25573434570
20190226,"PAYMENT RECEIVED",1266646848,0,6c0ebb9d10c39c8700ed0c1fda424b1c273a9e003632d8d7caede0507f5d65dd,24302196602
20190226,"PAYMENT RECEIVED",1301502563,0,cb179c34d6d3b16a59ab49813324fc3aef104251cbf051acc276f3b2854af888,23035549754
20190226,"PAYMENT RECEIVED",1272814939,0,933dc8bb65119f82271cc11a195c751ac21dca0732a06573cc0a903c0b4e1e06,21734047191
20190226,"PAYMENT RECEIVED",1264109680,0,b139cf2e2a2a97c79b74d8af2120c62fbb62978709c9df5ec2499d826074f42b,20461232252
20190226,"PAYMENT RECEIVED",1259371585,0,97c8fa7f5e6c3768d2fd9b95cd714e574d9ae4d7bb6c1d9cfba260e496e13c4b,19197122572
20190226,"PAYMENT SENT",0,-17731794715,c3b15d79b468133c7285658918c882a59d510e4a1b3f7a7290eff90a89921788,17937750987
20190226,"PAYMENT RECEIVED",1257187192,0,450397ddf6fb020e467b1165210b7353c290f5c31f2feb3a34a24beb03e64a14,35669545702
20190226,"PAYMENT RECEIVED",1281371615,0,8de0f83f5874001ffff51edb4ecf64ce02be20074fc49a3266161624cd8c78e7,34412358510
20190226,"PAYMENT RECEIVED",1256660237,0,2c757dc6071c27c083f621ab11fd9b1e1827fedbd3afaead2a67a4b7c938602c,33130986895
20190226,"PAYMENT RECEIVED",1257784461,0,c5d9fe662c065718d7a39499b81472b2cc067faafc17811ca1663f2d8cc89d2e,31874326658
20190225,"PAYMENT RECEIVED",1294234278,0,cced10bef2248951c07bf517789094b1c6dc0c3f80a522bdf88c1057c3ab1c2d,30616542197
20190225,"PAYMENT RECEIVED",1271980567,0,47aa9554003e94680bbe4262c39bfb811585a9ed65a0cdb86979f0206f23637e,29322307919
20190225,"PAYMENT RECEIVED",1298232671,0,ee1b258475b4daa1223f5882fe90b7185ab255b0d039e0c96383744a63b9c505,28050327352
20190225,"PAYMENT RECEIVED",1301007517,0,bf94a1c37e93c8ea6a044e59a67eafef00df7a5b067dd10026d5a9c41cfe1d44,26752094681
20190225,"PAYMENT RECEIVED",1307627722,0,808d83568e8c23ceb7621f3b749a519fd4f76b753a45c3ba0f66abe3a6b59159,25451087164
20190225,"PAYMENT RECEIVED",1288776520,0,f72f85a72e9744f1783b2327ee1aa63511e7ed615ad654323732d871e95dd969,24143459442
20190225,"PAYMENT RECEIVED",1313280435,0,9154e4ef04bcf97d934d18ccf3f47347969dba91e82aead86cf6a14adbbc4533,22854682922
20190225,"PAYMENT RECEIVED",1263207404,0,5ef7f58f8e6819edd4a8f2e3ae4c74baaa28f22c932d40c93082921927122ed6,21541402487
20190225,"PAYMENT RECEIVED",1267149715,0,07eea88541edddf8e656cbc034ce7bec966623a3022a2fe675e8f584b038a5e9,20278195083
20190225,"PAYMENT RECEIVED",1279250107,0,ef95ab7904b212b5e20104c9574319e21b26dd41e7d61f4d27cd8433e28206ac,19011045368
20190225,"PAYMENT RECEIVED",1252392505,0,62820138729ab1dc99092a4ec5af61335aa6471687c3702a18e7335d0ecf9c67,17731795261
20190225,"PAYMENT RECEIVED",1259508197,0,8a1e7c08293f5faa5e8b61ecabe199c3f7c63d55476c1dbcc563740fd9d9634d,16479402756
20190225,"PAYMENT RECEIVED",1255180728,0,b94fd863fbc2050c4b23498af132b3d44b2773ab52e084c0df6461a8b0aad069,15219894559
20190225,"PAYMENT SENT",0,-31656299501,2c8916c54d8c75fa650a8b71996aa2d867a6f633361432722920c957b824aa88,13964713831
20190225,"PAYMENT RECEIVED",1250902000,0,14614b8cbe96d6fb28dfc68bca1545cdebe18cbf693d6b37a3628ad717ce2e74,45621013332
20190225,"PAYMENT RECEIVED",1266690866,0,e4843fa766714c49e052ca5423960f0fd3b61e30bb2df89f46a436b5966f773b,44370111332
20190225,"PAYMENT RECEIVED",1271721763,0,cd409a88b8b513b8c832075fbc492ec2b1c14ab7f4f2369f9c8ef91c71688b1b,43103420466
20190225,"PAYMENT RECEIVED",1273175757,0,afcea2fd156cbd8695cf83b0a414f883eef1b353dcf166eaa7a4ceabfef2a32b,41831698703
20190225,"PAYMENT RECEIVED",1261588832,0,97744d2adcb72f1cc5abe5d392d636b959dbee5c232133b97bc03408e72d3807,40558522946
20190225,"PAYMENT RECEIVED",1269434854,0,edf9233fc722ec3d9175ab4362753a62ebbfa7defd3fb7db024edd42db779751,39296934114
20190224,"PAYMENT RECEIVED",1268252904,0,e5fdb38742205a1a1e43a22f4bc8edd261505273491f918885c546e77a6dd455,38027499260
20190224,"PAYMENT RECEIVED",1256416603,0,610254b4ccb9662e7e47644bf38f56c1a767e0659cd38ad595222837faf7f739,36759246356
20190224,"PAYMENT RECEIVED",1298577500,0,b136595f16595f02906b64004a977ab1da040356a85935ba25e863cabaabdeb8,35502829753
20190224,"PAYMENT RECEIVED",1278322426,0,076884c7270cb562cedd58a1d405cf8ad0a7a243a475f2e807077b49bea52b3a,34204252253
20190224,"PAYMENT RECEIVED",1269629780,0,caddf924d797108876bb9a16acd249610bc421ef0fcd8a6ff3cecf40f7c05123,32925929827
20190224,"PAYMENT RECEIVED",1288536488,0,0975b28a75cfaf28eaccfe99e0b407a79765f3e5c4309199c7bedc1792cf7648,31656300047
20190224,"PAYMENT RECEIVED",1315265991,0,767351895cf50642442f0c0489376734019ec14af68c66ee5187bb367b7eee23,30367763559
20190224,"PAYMENT RECEIVED",1250000000,0,9e7b7d485f4a59625a6d32308f1ee056d621bebda4838a665cd2cc6e78eb5420,29052497568
20190224,"PAYMENT RECEIVED",1254212737,0,f4288d2d78ebb6089013702f0463d4eb7d9a41f3f55b69c7e703daa845a3e6da,27802497568
20190224,"PAYMENT RECEIVED",1256503319,0,421412311aae7363284e67a1986e40986f224002378d58e5ec97ad2301bc4f77,26548284831
20190224,"PAYMENT RECEIVED",1260480192,0,6dcd6f4a58e3a926bb0abf1aa74b410339d5358d11f9209de1a5a8cdfb8e6ecc,25291781512
20190224,"PAYMENT RECEIVED",1264994808,0,d2a50bf3ec5db9959f1c91dea6fc4d30e959d3aecabc8060ddd3eb6a76f51178,24031301320
20190224,"PAYMENT RECEIVED",1254883871,0,68acf93932d4f66c4e17a70166702d607c35726af3854b89dc913dd8a50bc23e,22766306512
20190224,"PAYMENT RECEIVED",1288812129,0,87796e5ea843b0fa8c1f5dd2a8a2ec836044d8ca4f1aa2d6f4ab30da7d33b2d6,21511422641
20190224,"PAYMENT RECEIVED",1265160879,0,d4a819ee3d146cba9fffcc0deb72f2925e2464610b95e0b9e05e815d86845666,20222610512
20190224,"PAYMENT SENT",0,-16440988443,8af94adb6477134c3200be4a386dfc1f5653b99daa5aea841aeb33421413ec54,18957449633
20190224,"PAYMENT RECEIVED",1250000000,0,57a43a47c671a305d156052e8a5929b9c116c7ec7d0bcfaebec85b9733f72309,35398438076
20190224,"PAYMENT RECEIVED",1261644810,0,c0542b28c918a1b208eb2ad62dfcd69e69787d43f5479b69ce8395a49e511978,34148438076
20190224,"PAYMENT RECEIVED",1255735281,0,5d2a517c33164c11048edd3e713b6e9f10e43ed2a977aedc270141d053d62092,32886793266
20190223,"PAYMENT RECEIVED",1258349442,0,1fe226229cb44959772d42443ab41a7eab2fb82f64a3886d0a871adb9c15d617,31631057985
20190223,"PAYMENT RECEIVED",1250000000,0,5a2f8a626b8560a40afc8dc823dbbb991b5ae7c6108358a58ca0704572d530f4,30372708543
20190223,"PAYMENT RECEIVED",1285782939,0,88dc09ee433358afb16ac8c9cbe27b8ed0a1b8585ad796285c0db744795e83d6,29122708543
20190223,"PAYMENT RECEIVED",1250000000,0,3c2f6f115744cbc269842b4b7aa13dc685da4bc7989813508112e1216d477154,27836925604
20190223,"PAYMENT RECEIVED",1250000000,0,b92a02807e7a665444bb75718efd87f1926b6e166fc66bdf277bd0287ecb2554,26586925604
20190223,"PAYMENT RECEIVED",1275026722,0,f9179c393da75916cad9d9c83ae2e2a1f2d5c016f7a10c3d94700f4897d88cda,25336925604
20190223,"PAYMENT RECEIVED",1250000000,0,00923dd1854f460f919f434476981678384626a6180b71ba0118ebcc83e0d16c,24061898882
20190223,"PAYMENT RECEIVED",1276934064,0,25a430acc3ad19b2c8bc2cbed166801fc4def766563a42800488032fc1881130,22811898882
20190223,"PAYMENT RECEIVED",1270055878,0,4df413bc94c0655c17c464888de578ec28d63319318dcc17fd997e0f2bc4722c,21534964818
20190223,"PAYMENT RECEIVED",1286909654,0,088c3a50a510d87270a0779b9432e2c2e1f74a0ada9b7cd0245feaea37a186e8,20264908940
20190223,"PAYMENT RECEIVED",1260351018,0,70bbc9fbc03e03447409ee67f2c916e10e74ef6b36d04a14618906d2ff78d958,18977999286
20190223,"PAYMENT RECEIVED",1276659279,0,67218a5b101e3438e85b5765c21ee9971d4a7e6e5ee3c0ab3cdf5afa47853016,17717648268
20190223,"PAYMENT RECEIVED",1250000000,0,4c4a4b5b74bd19c537f0cb828b7a569a6b85fda62f94ffffd552d2dd6e948e20,16440988989
20190223,"PAYMENT RECEIVED",1261366260,0,07918652bed4d5f16ce8e3e3c478869cae0d4d65fe00c0bb8522dca22335e50f,15190988989
20190223,"PAYMENT SENT",0,-30581643028,eff318651027618b1a879fa91a071e1aaf4e98a8c3abd66f97d8892c29433d28,13929622729
20190223,"PAYMENT RECEIVED",1257929650,0,98c2fc22497a2c1c108093a131379743350f43d8d9971d5e3685a811ea6daacc,44511265757
20190223,"PAYMENT RECEIVED",1259814846,0,b369797f2691fe516881c4e328e3d881e57cc355f8d91d57e69a88815586d47d,43253336107
20190223,"PAYMENT RECEIVED",1250000000,0,8a5b80534eada7f0e39d2206e2d186ab1c7cc4b3608aaeee62b57745fa8417f5,41993521261
20190222,"PAYMENT RECEIVED",1280496495,0,6d20d62c544786c68e5db05cae84759322e280a7c1ab05d8ae824b19ec6a71aa,40743521261
20190222,"PAYMENT RECEIVED",1297081327,0,ff64d322813b72f005a9269515e27f2df6834b56725277b32e2f89c1365ec6cf,39463024766
20190222,"PAYMENT RECEIVED",1253547267,0,a0aceecea0d75842a6c420857687150a8725d416f977f81fb0298b2a1db3c363,38165943439
20190222,"PAYMENT RECEIVED",1297921993,0,a80e3d29c7304e5d5089ac4d1b27381725634efa7f7c52de950b922b0229aa4a,36912396172
20190222,"PAYMENT RECEIVED",1266878024,0,c79b126b99ce1c6d6b3ff6ea07297e09d5eee7d41a8620d75040681e6d3fd9f0,35614474179
20190222,"PAYMENT RECEIVED",1250000000,0,ca31ad00d56a3fb0232a1b3236bcb05b865e6d48a5a614e6db380f8bab2e3c7a,34347596155
20190222,"PAYMENT RECEIVED",1250000000,0,5deecec3a902d7e5080861d3af161eb8c43392ceb4c4705f621b2200277f0960,33097596155
20190222,"PAYMENT RECEIVED",1293602130,0,716240d3aadba3727bfd223b977e27df376c2549e31e5664521cdb4ee02c1ce3,31847596155
20190222,"PAYMENT RECEIVED",1268502102,0,af3fad0a1a560b8291139dd6f783aac38d52b9eff249e5d85b93832e525c63f5,30553994025
20190222,"PAYMENT RECEIVED",1280128017,0,d864e62cc169ee5e5600cdc41aef9b562391a7aedee40318c1de3251d26224bb,29285491923
20190222,"PAYMENT RECEIVED",1288360196,0,41ad5a27e2726688614a5e3670bee805353dc4e19d524f0c5469e34d283792e1,28005363906
20190222,"PAYMENT RECEIVED",1277352337,0,506f356570f3633b0a481b7d506c17eddab8658aab4c32e29d1c8ce9da6a7684,26717003710
20190222,"PAYMENT RECEIVED",1250000000,0,f1d46c0c6a2ff6f7be0c46b4425de343cbbc8329c282f92c7cea24a3a4414fd4,25439651373
20190222,"PAYMENT RECEIVED",1263130627,0,d75dd8f3bbc276fe892db9e2bd81480eb3767175314a3c4013171b41dad6af6a,24189651373
20190222,"PAYMENT RECEIVED",1254325964,0,faab8559cc5b80fe7637cadadb677251d6cfbaf523589d48b30df53ee329b8c1,22926520746
20190222,"PAYMENT RECEIVED",1254277322,0,c499a617ccf391a365e0a516738dc3e2d71ff6111fb70a7a876c3fd609deabf3,21672194782
20190222,"PAYMENT RECEIVED",1261278832,0,9c2919812ca2bbc6caeff2d529dc448d5ff7eee2fe2c78451e93f1a2397e3176,20417917460
20190222,"PAYMENT RECEIVED",1265952581,0,c800f7d56b01983dbaa2d694e9d81128150bdb79a9ae223bb81d39bfc104f417,19156638628
20190222,"PAYMENT RECEIVED",1269205177,0,d790b9575ae55658163993644de31831f9ce9548b820768936959c35312579cc,17890686047
20190222,"PAYMENT SENT",0,-22954994845,be6f44ade797422be6f5942f48a5c3e7c1f5c15d568fa0601a22bf3292268507,16621480870
20190222,"PAYMENT RECEIVED",1250000000,0,96e7b4f6c9e522cb6d7e7a629121df7050b95f304073d217169e055006234f80,39576475715
20190221,"PAYMENT RECEIVED",1271316215,0,ddc35345ceb3e8cb980ca51915ccb21047d10bcdeb1595e541a0003f2a68917f,38326475715
20190221,"PAYMENT RECEIVED",1293248310,0,12201a6733d817924dc90bda390d4280bf19ecb1a3e17d799921ed9c2d3d45d8,37055159500
20190221,"PAYMENT RECEIVED",1275219016,0,4074850527fb574d6ba8d992531f6e0dbb111a8bf657e3b547b2874e9299f237,35761911190
20190221,"PAYMENT RECEIVED",1250000000,0,e6c031107294cc2c12a4e32152ef7f00e55c5729f575b45c2261eb75b6417719,34486692174
20190221,"PAYMENT RECEIVED",1281771975,0,f4635cdacb50e20d9537af533adeb5f4e310bdeb27df51c9aa85b051c2ad4593,33236692174
20190221,"PAYMENT RECEIVED",1299431693,0,f8a9a3783b03edc0d335d495912fa278c2ed8d3c0feeb3c998757bbf74b7277e,31954920199
20190221,"PAYMENT RECEIVED",1278081006,0,1d1f53370f9354e3b32e0a1d87942ce5a85e34814e71923cb88208470457bafe,30655488506
20190221,"PAYMENT RECEIVED",1278754094,0,1cf1f2ce5d5f88d6463943adaf8efcfed500936cf8297af8f644de46dac7f7a9,29377407500
20190221,"PAYMENT RECEIVED",1300121411,0,525d09a4d8ef6d73d0dea93f55aebebe592d9ba5b23fab19c4d982462a8afc59,28098653406
20190221,"PAYMENT RECEIVED",1308706562,0,aecdc2f6d0562a74713a2457d2dddea791f27cb12714e152913f34c105a2a62c,26798531995
20190221,"PAYMENT RECEIVED",1250196568,0,bf633454d5266afea5f720740843fde52bd90d65788153a40d1df910490274f5,25489825433
20190221,"PAYMENT RECEIVED",1284633474,0,9fc16d23b1738b39d571593394f7c1d0b847de7ef968a6844f72d3b37e3e06c4,24239628865
20190221,"PAYMENT RECEIVED",1269455644,0,13eddbbb790ad51ee175a2d8511ee1da456bfd86273256970d246d74fa3ca4e6,22954995391
20190221,"PAYMENT RECEIVED",1291887769,0,88f0fd55c37adb777fa254e5b85bf33d30a43a0879ebb5c6ed9473329d3fea77,21685539747
20190221,"PAYMENT RECEIVED",1280570103,0,c919d3c50ffa24399018e4ff5e8dfb517888616e107231f2604094fb335284c3,20393651978
20190221,"PAYMENT SENT",0,-22982070739,25a0f379478dae2f66db9c3a28af4382905facb1246997f001e1a07e82644b10,19113081875
20190221,"PAYMENT RECEIVED",1281546364,0,707466084daa8f1862f2826ae6bfd00e5d3ca28305c1479e50fd04493cb896f4,42095152614
20190221,"PAYMENT RECEIVED",1256244384,0,c13777a11f8abc64c437e044faa7dd5b19b13ff8ad371d5617762d42215090e1,40813606250
20190221,"PAYMENT RECEIVED",1289072927,0,8c1805ddf463a5d21775277ad2312e5c5450ba7da6ecb5852e7be65b3653c224,39557361866
20190220,"PAYMENT RECEIVED",1289331606,0,2fa9f73b1c44b85de5db83f18a49330601a32aa7577f79fec316760f88a4cc52,38268288939
20190220,"PAYMENT RECEIVED",1285176640,0,d213081925655b10a5238a73b9adcb88b429e972aa7a367d1965e3f7f5998e9b,36978957333
20190220,"PAYMENT RECEIVED",1258636398,0,c19ee6e8a5de882ec36beb696b4bb004237bb1cdfd852e260bb0dfa66ce75b8d,35693780693
20190220,"PAYMENT RECEIVED",1280382718,0,292d8620e54df8f285c761939b4b9b13fdc209bb2b5f7f3873ed93b71a88f751,34435144295
20190220,"PAYMENT RECEIVED",1250000000,0,3490102006aed357f833976066d6b89b7a760b59e6f60c5109e2861c48fe5b21,33154761577
20190220,"PAYMENT RECEIVED",1253103677,0,bc4649b65262e62ddcc911ccf364a678471b9c79c063f28d91009ef8de3429c4,31904761577
20190220,"PAYMENT RECEIVED",1300919356,0,6c260151f3ca140e5d94e796f7a043d87e39086dacd6309f0ec942a4fc6d085d,30651657900
20190220,"PAYMENT RECEIVED",1275804536,0,4ffe2f791d4573417714f7a1133a64983e51eead84bcb2cc002df39339170324,29350738544
20190220,"PAYMENT RECEIVED",1287584031,0,07cb5c57245786a0a25e5a5deaf957a8277d412d5a5c3f917a5471f4008a0484,28074934008
20190220,"PAYMENT RECEIVED",1293567846,0,aea3663d3ec4b10f774b5f25f991479f2a72d405b22fc2eda623e19fea0e04bf,26787349977
20190220,"PAYMENT RECEIVED",1261710846,0,c69f10da5430865c57a88ac2a5e363a6a7a7b7098ac3b40b2fe526ae098658ce,25493782131
20190220,"PAYMENT RECEIVED",1250000000,0,2b0831c0d1ba8518c49a74e08d62d7597e67faec9b36ad5a4de86beafc8cfa18,24232071285
20190220,"PAYMENT RECEIVED",1272720323,0,ce4d55c1f5a2573e309ab049befaa1d7435dc70790f5d809083c8a25ae41b933,22982071285
20190220,"PAYMENT RECEIVED",1281767457,0,802046aa122a6f6f3ac43914d23bd3c42c8590856de93242548c8c938822514b,21709350962
20190220,"PAYMENT RECEIVED",1281023510,0,9d6535e9ad3fa7cc87f24b4e7e18f76cbce4d9cc0aa46418aada5338196630cb,20427583505
20190220,"PAYMENT SENT",0,-20175348218,69071f2bf7b0d0e474c7061ac4d18a428efee4d92b3aa6ff016e107a93a19a0b,19146559995
20190220,"PAYMENT RECEIVED",1272357709,0,c3867c89ba321cc4f5002beb5e1fd1700dba1f3de80b62a77cfe6024ac9b9cf4,39321908213
20190220,"PAYMENT RECEIVED",1282613076,0,bad6716e9d8d1fd200d3cbb5180a9652cbcc2e1d3f9aa0c5082d61f39a38e7fd,38049550504
20190220,"PAYMENT RECEIVED",1274080380,0,e3463bed59778baca56d889c682b963172ae362b4066041345fac61f4b48bd04,36766937428
20190220,"PAYMENT RECEIVED",1294351997,0,fa2312dcfb0bff56efb34d70b439fb214fb730d6f85fc6af6885310d85a931fd,35492857048
20190219,"PAYMENT RECEIVED",1254642434,0,00fc7a269f61171421b6390de683c3f0237a8fbfc1116fbc48f248ece65ca05a,34198505051
20190219,"PAYMENT RECEIVED",1263264894,0,68b8149cd2b9b5b7bcc434e7082742fd71e7a1c7b43f3065fce5f0c0d800df97,32943862617
20190219,"PAYMENT RECEIVED",1250000000,0,2b839c0d31c4c393c0533ef3fa75ac895da8bb2431cbc4f4d8aa6fdfaea44b86,31680597723
20190219,"PAYMENT RECEIVED",1271607487,0,1d03e87ea9e7b6395e2c8036fba2de17d0503104a5f5470a2114ca77eadc8843,30430597723
20190219,"PAYMENT RECEIVED",1305111354,0,cde60fe1aa32d1c382452a065e303b3e2ef43e7f2f08a6399adce09ea4b81e31,29158990236
20190219,"PAYMENT RECEIVED",1293521490,0,5a83997acea80e33b03c220fdb6092d7475668e060ff2b8fae3d25aad1490ed0,27853878882
20190219,"PAYMENT RECEIVED",1305103715,0,977c47d768f634adc393bc0bc9016324313818ca3d8a2218813eb269958c8da0,26560357392
20190219,"PAYMENT RECEIVED",1281230483,0,b1229ca1a0318577d143b4edf878aa2ace585a5ee270e81ad5647c1d4842e3ee,25255253677
20190219,"PAYMENT RECEIVED",1294006431,0,82f9361aff4f5992cb5ec7ad0f363b75e753264d684cb06e4a8acc3f1834b57b,23974023194
20190219,"PAYMENT RECEIVED",1250000000,0,f886c312ff7289a8aa3f1105586f17ec3ed221d54960732db6cde4912db9ec7d,22680016763
20190219,"PAYMENT RECEIVED",1254667999,0,095b8b828e893645698c66aff4428c0045ba9de7fa147f33c36e00140835537c,21430016763
20190219,"PAYMENT RECEIVED",1250000000,0,7788e11b3c35c817ac8910d87a02c6198cbb9d4e1bff8d8e514ea91644164452,20175348764
20190219,"PAYMENT SENT",0,-10178265304,6ec4399741fd09fe96fb9eda2e34bff94c5f17bd50450383549337b91ce5fe29,18925348764
20190219,"PAYMENT RECEIVED",1266443564,0,67e0f5567ef9be2d37e72f2c32591cec986570a8337ef2e1a2cb69a7db0c8f12,29103614068
20190219,"PAYMENT RECEIVED",1250833180,0,e49a91a4d471daba40c8d8fe1fc646808f0e9ac0537ed9469ceb085a1bbee1d5,27837170504
20190219,"PAYMENT RECEIVED",1257987938,0,d9b114331159a33cb834cf7e988df721a27ad7de6fd2c05b67d05be136047223,26586337324
20190219,"PAYMENT RECEIVED",1250347488,0,94fc42c1310a1efd8becac89b6ade26eb6912198b97d8b2837774ba8a16cc6c4,25328349386
20190219,"PAYMENT RECEIVED",1274732881,0,612b41daca8c6b0b1f06f4014210bdb842524032dabd7ba9a0404237b83f769d,24078001898
20190219,"PAYMENT RECEIVED",1253591392,0,46908757e1676152a5c14de7b01e0fc32b1679502fa7b5e9cd19975935c276bb,22803269017
20190219,"PAYMENT RECEIVED",1255353690,0,6efa3a7fd419de06027b66af2489de6f77725cf75276dabf26fdf23dd8277159,21549677625
20190219,"PAYMENT SENT",0,-11367899871,cf854b379bdfcfe750ba452a25df9ffc8bae48bc4419fec196fb359fcd7d7942,20294323935
20190219,"PAYMENT RECEIVED",1255013785,0,fcc930e1f3f7b0974448f59fedab42726fc2aefe692caf2b755fa09e31abd4fb,31662223806
20190219,"PAYMENT RECEIVED",1270149021,0,980b02e91e0192116bdb893925f51261f2097b1f11569cf680e3c802ac997f38,30407210021
20190219,"PAYMENT RECEIVED",1250000000,0,e397b0a07826cd94bd63a85a67e7048ddbfa86714a2b1fdd9186caaf86d51c11,29137061000
20190218,"PAYMENT RECEIVED",1283084942,0,9661952b413228ff028b7783f308b1e91b9d7551306238b79731999b46549d27,27887061000
20190218,"PAYMENT RECEIVED",1270625757,0,40c13d65dcbde3d31ff12ff93681d90c860b97a2f0532719953484942b64c483,26603976058
20190218,"PAYMENT RECEIVED",1261374739,0,e942ffbd81602d765c75ab33fa248bc12e880b191330ee45695449b62ab99059,25333350301
20190218,"PAYMENT RECEIVED",1259594660,0,4d366f5a0a1e7edc8446528d0eee1ee87fe309af68299825041fa99f9673c8b5,24071975562
20190218,"PAYMENT RECEIVED",1266215181,0,290dfab31d0445ad7b7c97a9acfcfb9c72209e0f731d8c76d7af894f8988cbc2,22812380902
20190218,"PAYMENT RECEIVED",1250000000,0,901cf5d462255b8a6d9941a7090fccff97545024c1c2aafd5d61ff56a7695a70,21546165721
20190218,"PAYMENT RECEIVED",1272514895,0,62f754fae80e3895b3e42fcae8ccb45947423f0d8ba60f9ff95df9d82a217c05,20296165721
20190218,"PAYMENT RECEIVED",1267758691,0,77fe3cd67df7581ff151f0df2ca0247ec06bc76e2042a1e9029ddd6fa21a69bd,19023650826
20190218,"PAYMENT RECEIVED",1271087652,0,24c54cd3dd8fe6b26c28a73f9f26eb756935860c15dd82fce93f361b8823a569,17755892135
20190218,"PAYMENT RECEIVED",1292520445,0,78639905cbc71f48adefcbf8b2540742754a5ecc28947271e7377b0dd75e5170,16484804483
20190218,"PAYMENT RECEIVED",1313891220,0,3f88064112ca7859bdaea5034520a380a84d7fb805fb03b8fb1bce5679974108,15192284038
20190218,"PAYMENT RECEIVED",1253629018,0,79a3fa977d860531907f2dce17e50286205e980c72cef3c617fc166326b7d3ae,13878392818
20190218,"PAYMENT RECEIVED",1256863383,0,0d7e7587967465834e0254385d24bd15cd9bb506e3b4f86b75f14d39b42b2f2c,12624763800
20190218,"PAYMENT RECEIVED",1271366517,0,7e3ea5440da36643e955dffd22ef6e78bc95964b7160dc4f975857984ae5b88f,11367900417
20190218,"PAYMENT RECEIVED",1265472979,0,84282f3b4b01eba9b619c952a0e46f3f3ee4d038490749753256d6eca1482603,10096533900
20190218,"PAYMENT RECEIVED",1272410791,0,dfe4b91403562c6d99362e6c40f9f67d7ec10b5277f1aadb803365442656b3f7,8831060921
20190218,"PAYMENT RECEIVED",1267689641,0,ca744e698fd3c1f2454669068f14ebaa14688eb423b1a59b62d736cb02f9cb88,7558650130
20190218,"PAYMENT RECEIVED",1258817329,0,29ef74fabf9b20fe6e0fc1a253a97a87251aa0f680f87bac143ec4668070c6d8,6290960489
20190218,"PAYMENT SENT",0,-22688954326,66d164f5e7ba5ffed55cc19a90260be96f31fe2778787b40488789bad11981f9,5032143160
20190218,"PAYMENT RECEIVED",1263260157,0,7c4980e68aec582a368fbeffa3b02e13b099016bbef8e1f76746b93302dc7e4a,27721097486
20190218,"PAYMENT RECEIVED",1261984193,0,0a5dfb731f6bd65b720654b617896e2e6327765ca69d52533fdf616045e48467,26457837329
20190217,"PAYMENT RECEIVED",1253133922,0,82ec1f79d0b823ed4d52accf3ee00ba8b864abf96066af2fa794e17b6ab279d6,25195853136
20190217,"PAYMENT RECEIVED",1253764342,0,1928ac78919808a920eec6e4ae8b3f6ea373b25eaa21c640f481bcc0651d7557,23942719214
20190217,"PAYMENT RECEIVED",1279565958,0,138fe8af430f9fc8d6c3df8e81023ee624efd18ea911ca86f48080ed029e7877,22688954872
20190217,"PAYMENT RECEIVED",1287949310,0,c3af12b48f70d353c1136f670f757e44e26da42ec2dbdf4f73d3dc88f21c587c,21409388914
20190217,"PAYMENT RECEIVED",1273114392,0,d3d7088d7421ecd571f9682ae1ce7a5aca199f5af22cad8f35e242243a96ddb2,20121439604
20190217,"PAYMENT RECEIVED",1251141979,0,13fcde1750796f33cc623199f4c203303c83758211ee8f65afba743cb71cdfc4,18848325212
20190217,"PAYMENT RECEIVED",1254074827,0,de02c2f0b557822789b656ce9aca153f0821f29dec36df3964464cacd6841dfc,17597183233
20190217,"PAYMENT RECEIVED",1262678489,0,3591882bd1c8cb43508612de0ff5792adf2b52849498e19a5c29ca95acbf27e6,16343108406
20190217,"PAYMENT RECEIVED",1253874816,0,b02728d4b724120b413edf3e997e1121da9fd0d1d6a889232ba747d2dfa57006,15080429917
20190217,"PAYMENT RECEIVED",1250669468,0,684238c9cf9726658d131c301e14343939335ddf5471a2b24c0fccb0f93d99ce,13826555101
20190217,"PAYMENT RECEIVED",1251879364,0,014a7f003fade4a5cc16d6de5e704ce09aa388c84bffec4c2b95797106e416f6,12575885633
20190217,"PAYMENT SENT",0,-24114231546,f75bfc045578b9f8efd8ce5868051cf0216e92211a625fa9dc799da9f52fb2c5,11324006269
20190217,"PAYMENT RECEIVED",1254604099,0,8c9444a6638c7d95b4b7997dcbd5c187fa7008cc13b430a273f5985b4838fff1,35438237815
20190217,"PAYMENT RECEIVED",1258609967,0,c7c7fb55b7e685d4969221c4b24cac8d923dfcfd119d1c6b1f8efbdde5aeea38,34183633716
20190217,"PAYMENT RECEIVED",1250076708,0,195b00b315545b587844442840c2fd8c4e3826bf559cbbc2d34e5fe1f493eac4,32925023749
20190216,"PAYMENT RECEIVED",1260149164,0,ea4b212490162539006f112e43aedcd725b7fa55579c15dd515572b48b04c989,31674947041
20190216,"PAYMENT RECEIVED",1250458452,0,1a22c71f750d48ec7b58dbbf5cc27c725f0b4dbe4b0507977190ebb5ccd865f5,30414797877
20190216,"PAYMENT RECEIVED",1258923341,0,d05ca65b0c7fa9078723b26ecb0d38a8bff24428e8bd54165f9c833565ba6a96,29164339425
20190216,"PAYMENT RECEIVED",1257743747,0,fa7767c8614651e6d284d9dcf3ce7cf3ca295e9f85e7fd286a7491ed4e94fbc4,27905416084
20190216,"PAYMENT RECEIVED",1263453409,0,0a284da9ce8e89f91a44ac4d2c9bf90612519d49637735263068b3d936fe7cc1,26647672337
20190216,"PAYMENT RECEIVED",1269986836,0,4d8e0d57234beaf1f8d57fbe1c6b32ef084ff25f2f16ab2d2485d271f209c66d,25384218928
20190216,"PAYMENT RECEIVED",1266214304,0,83fe6a67b36ef1f3523ee977591e61b859d3c7841c416bc7c83631fd1a12a448,24114232092
20190216,"PAYMENT RECEIVED",1290380357,0,6b17ed7a14e7216d23bc3357c9f60af32dfcbcae7188dd29bdcb5372790d9a9d,22848017788
20190216,"PAYMENT RECEIVED",1282812157,0,4bc5f80b632a9a42f773ebd5334fce898bfe41a531ccaed66a51cdce3c569f65,21557637431
20190216,"PAYMENT RECEIVED",1250000000,0,2949906639f41f0895af99119b6b65c53e079da7e19a213818f65bcb8d50fb28,20274825274
20190216,"PAYMENT RECEIVED",1254036390,0,ee43ef1ee305db053cc7e88040633ac8737cb19e7c78fefe49b1bfc5e746cae7,19024825274
20190216,"PAYMENT RECEIVED",1250000000,0,07bd52e4e684e7ec7064126c79bd1a4b090c88560292f1f37663777da99fb79a,17770788884
20190216,"PAYMENT RECEIVED",1256800049,0,0c5a21e6387ce1a26f25e284a71f3e7c96efcd3f013ef8e43d8c3d90d1dc7be4,16520788884
20190216,"PAYMENT RECEIVED",1254062575,0,c93c67e5df49ba6f946686e36ad47bcb427fca825d75ccac40ac02d65ce8d161,15263988835
20190216,"PAYMENT RECEIVED",1262701151,0,7dac9bffa19ef653b2485e0b2bda0c4d50719e26532021e0ee3f316d0f8cc37e,14009926260
20190216,"PAYMENT SENT",0,-20254122849,6e4513e3bb96b987518dbc9fe4dcc5f0dfaaba0fa7e992b730f9f7ab9786bc08,12747225109
20190216,"PAYMENT RECEIVED",1266995982,0,94eb1cf7e88534ed643f3ce2825481739953f51051874d9617ae0e4f2ff7b69e,33001347958
20190216,"PAYMENT RECEIVED",1259026234,0,77f2a340433823fb676f3bd7896bd26e4b87262a7d44b5c7e4789b130222bbb5,31734351976
20190215,"PAYMENT RECEIVED",1272682960,0,a6731cb875d87564cb6ed3b2f0dcce78d0c173a9684f44a4f1d6c225f1632ba2,30475325742
20190215,"PAYMENT RECEIVED",1283900875,0,8d9d893a76fe0718dee62a6b8b1c498c07eeaa971455bf552009a14186c76f93,29202642782
20190215,"PAYMENT RECEIVED",1250070850,0,d18885c1d00e368cce02ca9407d870c50a6e0919341499aaf577e225dff6ed6f,27918741907
20190215,"PAYMENT RECEIVED",1275253924,0,8bc2ca8fde0a359d8f96c7443ad9a66b9b617c90c487fde5a8987b1cd6b3451a,26668671057
20190215,"PAYMENT RECEIVED",1288554776,0,25e5055aa5ca14c9072fa88c1d0a7a132400249da6ded5f525920e7977256580,25393417133
20190215,"PAYMENT RECEIVED",1287169772,0,db9d064cddd024a1ef727642cc9bae11f0c7f72c7fed84df22fcde6038d72bb8,24104862357
20190215,"PAYMENT RECEIVED",1281345216,0,1aeb6258924cada6633a82f8625755e8e6b4fcb2973ed001cd09149338a9f549,22817692585
20190215,"PAYMENT RECEIVED",1282223974,0,beff90a435ea2af2586d1f6d1224c78274e4899591af4f76af67b3e8113d9fe0,21536347369
20190215,"PAYMENT RECEIVED",1251049395,0,247f6f28518b2a0323de022b1c50dcc8f8fd35df43785983779f5df95b1eaa2d,20254123395
20190215,"PAYMENT RECEIVED",1257916237,0,e541ba12a754cdd7240569692323c10b0f653f75aff7f271acd016e7796fd7c0,19003074000
20190215,"PAYMENT SENT",0,-21481201533,ccded71542b441572b26dc92c7393a3d6a4d7ab5616e261cb9fe83cbd2e33f4f,17745157763
20190215,"PAYMENT RECEIVED",1253954447,0,75e50e68155c9304b39f8061c709bad4e5c44fe4883e95fe5e96df3399dbbb6b,39226359296
20190215,"PAYMENT RECEIVED",1254733468,0,09b492ab17830bf9c33667c3b22f770daeeb68a8e3f8414d5eea496fcd9ee687,37972404849
20190215,"PAYMENT RECEIVED",1261009577,0,dc8529b1c7b815ed30beab313704664928bcf5e5c237f3a0a6c653805896ab7f,36717671381
20190214,"PAYMENT RECEIVED",1271979748,0,4fef6dd4b7c30e618d92f0c08e70cf749b6b669cb19d1ff249e3dc95b6e9297f,35456661804
20190214,"PAYMENT RECEIVED",1267561203,0,ab02cf72ca891fce25aeddd580559e2fdd0e9baf7d65ab1002da0a08d0612799,34184682056
20190214,"PAYMENT RECEIVED",1268497514,0,a72d23d781fa821cf6229d5a1f3fe6797647d57cbd8ca6fbc87b66306d4b9eee,32917120853
20190214,"PAYMENT RECEIVED",1256211727,0,92bc9dee70cdc48a6fd988124b9d3d647dc80c90b7438fa9db32b6013361c043,31648623339
20190214,"PAYMENT RECEIVED",1250000000,0,be9c456a68c4e8456f2f144bbc2e7b6ca93fc66c775996cb059f970a46e672fe,30392411612
20190214,"PAYMENT RECEIVED",1306291227,0,a315f0156020e3393500eb8182cbdd309450c3d8010e32f7e3f1fcca9c9015ff,29142411612
20190214,"PAYMENT RECEIVED",1285723775,0,b486687f2a0a92daec7399edfbc6740eeb84c104dd54a9a7d18dc6cfdd5e9a88,27836120385
20190214,"PAYMENT RECEIVED",1273941270,0,8c4bcc9415e935c2d0e10985e114e2a217e6a8fb03f992e5ec9e6063f730d722,26550396610
20190214,"PAYMENT RECEIVED",1250431144,0,80535bb83208e4a226bad83a1bef98f5373ce4deb890ff5406fe389678b26000,25276455340
20190214,"PAYMENT RECEIVED",1263530824,0,55cefe6873a4cd7b32d7a2618c84502d704862efaafcbec2d4caa0587d23854f,24026024196
20190214,"PAYMENT RECEIVED",1281291293,0,43b437ec0edef1cf9b43b365c67daa40c63d2c57a89bff224fa4ded0ac6e72cc,22762493372
20190214,"PAYMENT SENT",0,-29347431102,510d0ac50895aea992ad6456613eb09f26368f736b329b6097aa1940cae1ff96,21481202079
20190214,"PAYMENT RECEIVED",1252331269,0,a5146efcb7a25bd6c01d1123e5942a5f9a75e8f5591ecf13da291338cfec6718,50828633181
20190214,"PAYMENT RECEIVED",1259524466,0,82bbd744f8d29d98dcea3e85db65bf8f4e8415d73218a3a207432aa6a69c6ad4,49576301912
20190214,"PAYMENT RECEIVED",1257027101,0,248e8d1b9afea3435537467d0fd57ff9e5bdbf3d7d489ef6236600194894550c,48316777446
20190214,"PAYMENT RECEIVED",1272133316,0,1e0c30567734b4eb5f7fd6a2183c2e9853d85dc507092d2d709af5488c834f4d,47059750345
20190214,"PAYMENT RECEIVED",1270710422,0,d902ae631e7f59db9f857a83aae9c03cb74ea6daf128ea103bf288b3003ebfe6,45787617029
20190214,"PAYMENT RECEIVED",1252224389,0,90c4fcc5007ab3201bff3a232d3c22c486740d75fc430daa14c7da21a642bad1,44516906607
20190213,"PAYMENT RECEIVED",1270929009,0,cc06e69c9ea720911a81e9bd2ab38094b193e00fc6893129ccfc2fbab8785590,43264682218
20190213,"PAYMENT RECEIVED",1263802415,0,951250c5e398f0a13eb2c72a624401b30f3f852c20856327fb286abdc8dd3524,41993753209
20190213,"PAYMENT RECEIVED",1277628484,0,0f77a9f7f5ce78a630ea79534401ff335b4b2734386fb38c9ace3bd6112916b4,40729950794
20190213,"PAYMENT RECEIVED",1255881205,0,cea7c159b84c284cca8a6a6f5204da7c1550111b4b16401b662b34ae4cd58fd0,39452322310
20190213,"PAYMENT RECEIVED",1260256873,0,24cc25c3e468b0caa4dedccee04f362bd012a4882eb804f82f62ae2f5657f29c,38196441105
20190213,"PAYMENT RECEIVED",1250000000,0,05ff4aea6d9bce6795ae8f28f02f06b05160da7e70a6123ce29acd658b4529f5,36936184232
20190213,"PAYMENT RECEIVED",1269753438,0,1b967d9808d805f97c1f428167960c7cc346d66ebafbc0e33bd67749cb04aeff,35686184232
20190213,"PAYMENT RECEIVED",1252574817,0,2deebb8ea5acc281949995a60f78de3c034a865ecffb79606d1d01c44b8c0c64,34416430794
20190213,"PAYMENT RECEIVED",1281260877,0,229daf506d0372fb48762c7b5dc1a054e7e3b48c325d9da03957e5a5c3772228,33163855977
20190213,"PAYMENT RECEIVED",1273277966,0,abc0034b9963b98825367ea98445ea823bd31409df02f29363fe4f61501c9300,31882595100
20190213,"PAYMENT RECEIVED",1279196909,0,78221ae109197b249a715105d54c986d51a2ac8049d1e1a542fc7d9a10d61e00,30609317134
20190213,"PAYMENT RECEIVED",1285562486,0,e25bc28b69666996193c5c586f10339f65467db563a7ac51cb6c4312e7bf2d2b,29330120225
20190213,"PAYMENT RECEIVED",1266473559,0,18019669f37daf64f3b10e12a17206edd72711357b5fe63813a4237c1bf64d7c,28044557739
20190213,"PAYMENT RECEIVED",1274108293,0,3e0cf23d6a12b6f73782c4b952f7a65e52e585b775bbecde3d14bf45b3127c3f,26778084180
20190213,"PAYMENT RECEIVED",1288163228,0,5bb65698f5067b1e3861ddc2af10e741a571c39693eb0bf23e65045c1a3769d2,25503975887
20190213,"PAYMENT RECEIVED",1278116587,0,89846d4f309a10443e4a07d28610cca6fed7d4913e6b710dfcbcaab0adf0c42a,24215812659
20190213,"PAYMENT RECEIVED",1270532379,0,0cdb42acd3079885638005d9e0447729a9fd6652f61b5cbbf65e29aef6b261b0,22937696072
20190213,"PAYMENT RECEIVED",1281413263,0,4c16f9e7aaab84bc816b71bc12d9cbdec6e8e80e720d6e32aa8ddd0fa17215d4,21667163693
20190213,"PAYMENT RECEIVED",1268719002,0,827fce394fd15998fbf6382a5ebbce9e5ae3d3d0db19006622f4482de0c06170,20385750430
20190213,"PAYMENT RECEIVED",1276251336,0,fd9bfb7c1d0b3db57aec0735adbe5fc38ab75c5fdeaaf6944e7d25bfdb94cd48,19117031428
20190213,"PAYMENT SENT",0,-18954264089,d91704d770cb2b91a8fc6ea88c04edd57ca7f462efd6138aeb78dfdb9a4de88a,17840780092
20190213,"PAYMENT RECEIVED",1288039367,0,3b976f7acbcbd5ad72fe9014fe4570984810d20e9afdad9c906c005fc2dbc75a,36795044181
20190213,"PAYMENT RECEIVED",1293681290,0,8853816b20f4b78925bcb024b7bd1f0ceac7ec60bc0295a8da04b507d0ce5871,35507004814
20190212,"PAYMENT RECEIVED",1252573768,0,07f42ac02a4ec1e5a3bf0ccfbeedb10b4a854329c1383c0eb617eaaf4c2e7abf,34213323524
20190212,"PAYMENT RECEIVED",1282853144,0,275340a401a181b0436bc53fe31a86481a0bf16a93d38d84fa8d4660c4e7d1f0,32960749756
20190212,"PAYMENT RECEIVED",1275060890,0,4970876343dd87f8921645ad35bb95fd336c41cc811585f2fc2aeb62347871d5,31677896612
20190212,"PAYMENT RECEIVED",1272757446,0,eda2e49320fdfd95130733389124b58638bee7e7085fc007992603f61ae81518,30402835722
20190212,"PAYMENT RECEIVED",1259884846,0,5818adc64ca4da8bcdcf8b13a1270f24a7cc81a6796d76bc3a449dc8a23c8d0d,29130078276
20190212,"PAYMENT RECEIVED",1257988807,0,102d9e26ce85ffa88f606bbdca3ed7a0755a9710920b62f2c79327001011f880,27870193430
20190212,"PAYMENT RECEIVED",1286129934,0,88561acd2f2f5377d722f14c82140a432e6ea514d63248febfa88708208bf038,26612204623
20190212,"PAYMENT RECEIVED",1267559383,0,8f21120861edbaafa202e6924f00140f55ba4903c22dd96004839a9552d5ea82,25326074689
20190212,"PAYMENT RECEIVED",1267199994,0,8ed6d913b9e1d336471394fab9c262f2a3492331d2c92580691990ae21e1d3c8,24058515306
20190212,"PAYMENT RECEIVED",1275567798,0,a4e12841dd74a3f8956a1fbcf142adb4dfda58098abaeb0517edde74d959d8b2,22791315312
20190212,"PAYMENT RECEIVED",1275539282,0,ba304a45b2aa8ce94db9c494c4f2b9a2a3464b8761a525e03e01ab1fb7cfece7,21515747514
20190212,"PAYMENT RECEIVED",1285943597,0,428e9a8e3df9ea700ffe155780ad176f9995a79b79a8493b41373b21afcedb22,20240208232
20190212,"PAYMENT RECEIVED",1257485188,0,8969a1b75dde1ee2128022d3fe1dece4e1a2b07a754a24035aae2dd51c6288f4,18954264635
20190212,"PAYMENT RECEIVED",1259639244,0,1cc032704d43ad6298d05876378df6f16cf9bc70554fae7f0f9b75d1dfb84b29,17696779447
20190212,"PAYMENT SENT",0,-25216911025,a79f88678c0bca08dfc309d45676e511444d92d4daa3bae6d658a026ac818e4e,16437140203
20190212,"PAYMENT RECEIVED",1277308578,0,bc5ac98d98cf677947327ca39ecaec244987d35c198833088d4b0a74b773a623,41654051228
20190211,"PAYMENT RECEIVED",1258857286,0,8c2b00bd67b7e4356f6599b38bbfa70009b9ecab8ea7f90bbcf2a40b51c9193a,40376742650
20190211,"PAYMENT RECEIVED",1265781111,0,74c8939f34f8fab58b308ffd2c20a29f5a4261fc9a4d47bb559d63941c3431b0,39117885364
20190211,"PAYMENT RECEIVED",1260502627,0,7b8dbbaca35b5241f66b653ab96afed7637e283cee9ccfa9dd90a2364f1a90f1,37852104253
20190211,"PAYMENT RECEIVED",1277910439,0,214a138ba8ed015a47d7b1a30cf1b28c9fcff2821a27af001d1a32419dcdde29,36591601626
20190211,"PAYMENT RECEIVED",1270101627,0,9b5fa4dca46e57d9c8b99b6c2f4f4ddc2ba779592b4ed6af9ecd7b54baf063e0,35313691187
20190211,"PAYMENT RECEIVED",1257489328,0,6b6fa4dfc4a20649b223000ad4f17b7230f189bccfe0f1d25a53edee174ad30d,34043589560
20190211,"PAYMENT RECEIVED",1267146257,0,aa68906bc8496a13c9e6fdbc022debbaeea1aae8d850a431a93f76484af913e7,32786100232
20190211,"PAYMENT RECEIVED",1280479979,0,cdafe3da7dea662cb20e4866a0f85b024336c27338d007672a5bd75855387f0e,31518953975
20190211,"PAYMENT RECEIVED",1255763890,0,e3cd7b460ce35046cde5ce6af13f652140d499595db5908605bf56877b77b799,30238473996
20190211,"PAYMENT RECEIVED",1257082466,0,63dcd19187d712ff91f9af82dfe275f32e7427efb07d7ba75ebdeaf94df014ba,28982710106
20190211,"PAYMENT RECEIVED",1252467050,0,fc4f1f24c478f9f40de030a756ee6c2d4662f419bf65125ebc4531189d615a56,27725627640
20190211,"PAYMENT RECEIVED",1256249019,0,e335ad73b02b0565ce294335851ae80b04195f7e6cfdbd7cb68335f22ec5c053,26473160590
20190211,"PAYMENT RECEIVED",1250181213,0,e2a2a6b14c19906f1188907be69a8bdbd6ef362d8eba9bf8685ada45d2971a3a,25216911571
20190211,"PAYMENT RECEIVED",1261359537,0,75b32951b9e5ff00ce69fb4eab54e6a4b1627e316cd868e504e9a7c083e86a74,23966730358
20190211,"PAYMENT RECEIVED",1258059472,0,3c4f6cb5dfa2fc2fdd134b98d39c83f423130575867158caf26ec2972df252df,22705370821
20190211,"PAYMENT RECEIVED",1262653219,0,bf9442cb40adbf2a48ff5eb3d5df37032308a161fdcef5d360afe9d5d3cc5605,21447311349
20190211,"PAYMENT RECEIVED",1289741047,0,2d9789a558d2385c78c199daaa3097a6a6250619ee4aba9807ffe82bddea8a0e,20184658130
20190211,"PAYMENT RECEIVED",1259020371,0,f90d09f9aeeaa9635376f9079deb3f46f2d4fcf7b9fad19897aeca639f050f99,18894917083
20190211,"PAYMENT RECEIVED",1259866482,0,3922c71609422ccf0d00e1df71c33a7f856a5b975c0fd475b67a9080bd871599,17635896712
20190211,"PAYMENT RECEIVED",1255055513,0,42ea68bd8a5a9011c76264b32c510c1b9d0c5222fd1d72fb57f923cdf9e0efcc,16376030230
20190211,"PAYMENT SENT",0,-22686738084,b8e86cfb92df15dc1c17bce9b63aca63396abfc37413df02d6bfc7e8e4973027,15120974717
20190211,"PAYMENT RECEIVED",1260190286,0,3942b6d3070290ad6d9fe026b37b7b7619ea714d7033c9348eca3db0b70ea072,37807712801
20190211,"PAYMENT RECEIVED",1262396423,0,983fa9fa32acdccc436b0d3d3b8daf8c16fb800e934d7b1a1097206a5b95c9b5,36547522515
20190211,"PAYMENT RECEIVED",1266454111,0,2ee0a2ed8d22ecb3b138d7d289c9c046bc6618f754931252cd92eb252287070e,35285126092
20190210,"PAYMENT RECEIVED",1264485086,0,047dd4e49b2b9dac427b6e2386056d2d3fda17e8a030a4670d01e215cd6c3ed8,34018671981
20190210,"PAYMENT RECEIVED",1252831028,0,8316601054562d13811f6f055308b9023954bd977163831e056f5dea9e3f4a6a,32754186895
20190210,"PAYMENT RECEIVED",1252392915,0,e53c5e21f6cd657eb435692cf7221738ddffa76d3fcdf689a07ee77602fe494d,31501355867
20190210,"PAYMENT RECEIVED",1253337114,0,c1af3164befd9430232ff9870265596417ce9eeada09f5cfeca86680506cb6cf,30248962952
20190210,"PAYMENT RECEIVED",1253878694,0,35362e21b539be34ad66e6896f89f5c5e5c757f1f2d3c1ef61f0df7cbb291200,28995625838
20190210,"PAYMENT RECEIVED",1255658230,0,61fe6fd229055c5e55ee74be4ed48e88fa2ef27d85018781cbaf12bea0969758,27741747144
20190210,"PAYMENT RECEIVED",1257308943,0,1e4decd317879e6c0b07e8e7f704d067c3e590e31d46647bfd4a26f1c9e8159f,26486088914
20190210,"PAYMENT RECEIVED",1257765051,0,6c8398ac34ffe72786b7f0f817254a4d36045a8b98328c7f440ba4bf846bac91,25228779971
20190210,"PAYMENT RECEIVED",1284276290,0,22c0a96c34bf4bf5f4216a6bf7051c9705b682e3ce6e6dd62fb63a152e20f0dc,23971014920
20190210,"PAYMENT RECEIVED",1264839064,0,9d4b830faa89b6a6b2fb2aaa4814eabd361d4565cf4e3d05faf671cdacda29a0,22686738630
20190210,"PAYMENT RECEIVED",1261182843,0,bdc5656bde634f0a2088548b5f4490b43149942ca412d5cc1ff479f75cbefbf6,21421899566
20190210,"PAYMENT RECEIVED",1250734562,0,f46badd8696c72effb55076c6b4ad017849aca71e23329dddc84d3daa3c919be,20160716723
20190210,"PAYMENT RECEIVED",1252050308,0,6ff24b39ea33f9829e46586df35148f6220ec2634d2da3eefd9cabd13698576b,18909982161
20190210,"PAYMENT RECEIVED",1257276553,0,2b9d834333d534a33a2bf4c573ca740a9f46a1fb9008d0f13d6ad6f52680500d,17657931853
20190210,"PAYMENT RECEIVED",1261290615,0,aeb98926520c2234ff64aacff8bbc1fd6520c3665d7f17498036d45226f8f2c3,16400655300
20190210,"PAYMENT RECEIVED",1252009457,0,1e580c62475dca864e44b815dad375a9dec27eab0a632a5df4624227f0244c35,15139364685
20190210,"PAYMENT RECEIVED",1257813935,0,626d749db0787db3c6ef75d68f70e04c25e976e2c5964d8ddbb5af3981eb3a5e,13887355228
20190210,"PAYMENT SENT",0,-20310744723,f6e79b69ebe054a2fb579236128917da981b8299db469fb181031fec0bc5d3e8,12629541293
20190209,"PAYMENT RECEIVED",1258973808,0,ccf5265d7cdc7d3eda0d02a254746aa70a13ea3c0949057ac938ff1416cce2cc,32940286016
20190209,"PAYMENT RECEIVED",1260429102,0,ca689b1516ccaefd275e2f707073b4f8861cfcd49849c0cd4b7e572da5bcc4c7,31681312208
20190209,"PAYMENT RECEIVED",1264674190,0,b082eb823730dca295ac9358d48d44b0d344724d59531e45faf133f73cbeeb2d,30420883106
20190209,"PAYMENT RECEIVED",1250327589,0,f0c3aa25ca21a921dc869cb1322fd6248bbee46db1ec1b95e77475a2721985d2,29156208916
20190209,"PAYMENT RECEIVED",1273495952,0,d5136e70e18d9ee4301004af8b6c4cb29765e5eca2d9f2b99d4187da4fe572aa,27905881327
20190209,"PAYMENT RECEIVED",1255038718,0,9fe1a6b9d5c707e0d77d6360cd3fa48908973be1ea736ce2411d41ca7e121791,26632385375
20190209,"PAYMENT RECEIVED",1266901333,0,81a780c302d7a4aa3b204396b938af7e0320a96f959fe467bd7cf5cf2c673192,25377346657
20190209,"PAYMENT RECEIVED",1261854719,0,6b1ff42d70faf252f3a8f17916e3da3d3eca3b7d3185d62b86ccf65123e97202,24110445324
20190209,"PAYMENT RECEIVED",1266030810,0,2c04c48a9fa9062f14efa3d6a5a7a9c1989e1e75816372d887a484512f174f08,22848590605
20190209,"PAYMENT RECEIVED",1271814526,0,70033576fa38735c4ad00ea47f9387002cfb5a4331593408a0798cf25db209a2,21582559795
20190209,"PAYMENT RECEIVED",1251856401,0,ac4eceb8e3337814cb835eb92bcc13bb7b28319240d3b87e2e90d53a9a693e2a,20310745269
20190209,"PAYMENT RECEIVED",1264162084,0,3b5f05e48f11f658512cc8ea7231afff75edc919e70eda64536d3ec2136da0f2,19058888868
20190209,"PAYMENT SENT",0,-25161638457,ca38016334394cd20a7ba039239eac645543047f9bea715d8f0f8dc1aadd65e6,17794726784
20190209,"PAYMENT RECEIVED",1254498909,0,3399fb2246692bd42b5a15ce01c93017843a3fa7493459c369a8b23608beb43b,42956365241
20190209,"PAYMENT RECEIVED",1272907267,0,0ed321ec72034408ca1402fa76cdd76d91cb8b04d62455d346e9b948cfae4f30,41701866332
20190209,"PAYMENT RECEIVED",1270229914,0,18a47471374910334d27ab4b431eae94c836052f129bb2f7c8978f167d44081b,40428959065
20190209,"PAYMENT RECEIVED",1257750872,0,25ed5fb891e772b4abb84a5a727f8f0cf08f9f2a5fa32a3c33f3384be5528e9e,39158729151
20190208,"PAYMENT RECEIVED",1273210898,0,47e97337b8d808eda41b46ddaaba3f8a2b933bb1e7a8a77cc62c2243cce7c63f,37900978279
20190208,"PAYMENT RECEIVED",1266665532,0,a031b7e6b727ace573e37cbe8d7a4b3ab3f79209bcaa9ee5e33162198612a45a,36627767381
20190208,"PAYMENT RECEIVED",1262472164,0,2ac0ed0195bf5183452de3b3b6a9320758fd2918fdc82013b9667cbd2db5c4c4,35361101849
20190208,"PAYMENT RECEIVED",1288777527,0,df7714e005abad493fd9b5245840e96ab672519154ce18c1157a2644d29242b1,34098629685
20190208,"PAYMENT RECEIVED",1270633744,0,282d49f4376102bfd03ea0f430d5187b5d906cc1f80624df22c8f20c73d5f251,32809852158
20190208,"PAYMENT RECEIVED",1258224543,0,56239b543e083d0422cd93300e3d0d6033fc329b64d33573eafde53f3add98e5,31539218414
20190208,"PAYMENT RECEIVED",1265711186,0,d63a984189e0ffb25dc53b9bd73e16470d2b762a90df111065131b1d0c42f2a4,30280993871
20190208,"PAYMENT RECEIVED",1271524823,0,bdc12f03ab357bfc7c7ee44fe0c9d53a0b5b29101e94137bce892de6cb39155b,29015282685
20190208,"PAYMENT RECEIVED",1330078166,0,d402bacbfcab0a76592d39dd5c4a3105918e3f7231ae5d62fa1f21aeaa67d853,27743757862
20190208,"PAYMENT RECEIVED",1252040693,0,d7d2b08ebf6bfd387efa96a168db24687b7e51f56f8b9ad60d957c62e8c17fb8,26413679696
20190208,"PAYMENT RECEIVED",1250667861,0,4752a20a5d4d174bc385aac104da762c6393af05876abeda7e750d07d0922128,25161639003
20190208,"PAYMENT RECEIVED",1250922909,0,c97ad0105229896c08809829211f0e380cca923d4a37fbef836f22a011a3dfff,23910971142
20190208,"PAYMENT RECEIVED",1254771430,0,26329f20f3bcc227cd1df74e244f11d8bbb3aed6c653ff4f7ea978a6fc866a71,22660048233
20190208,"PAYMENT RECEIVED",1256790617,0,14451be5af918b788947523fdd2bcfce193042866aeb594eff890ecef7407a48,21405276803
20190208,"PAYMENT RECEIVED",1254212428,0,31c9696c95777ab77ee773ace99ecf101a7280135993162b71f1c33a03ae6250,20148486186
20190208,"PAYMENT RECEIVED",1261488207,0,f64cbdd1b1b62caebc969e15430bcb2a24b15d62a9d8993fe6a1aa29905f7071,18894273758
20190208,"PAYMENT RECEIVED",1256349315,0,950d76b02281ef9d910613f53438a4e505359803d433023f952d48674c2d3d6e,17632785551
20190208,"PAYMENT RECEIVED",1266053204,0,a6e274af0f9e2430349a5c8735c86a9d6ebe2868f5a8107598934660b65e9b82,16376436236
20190208,"PAYMENT SENT",0,-19008679861,5bccfdcb75880231efa903ca30e60371ee1f79c89081a9024f10f0063391a344,15110383032
20190208,"PAYMENT RECEIVED",1250965987,0,e8b83d3b95ca4a41897e105fedcf208279d0b724ff01174eb1eded3c58e977e7,34119062893
20190208,"PAYMENT RECEIVED",1251737811,0,0e77db70c2a936af9541577699b8c314a5d8ea671dc02c918ad0348955214ccc,32868096906
20190208,"PAYMENT RECEIVED",1257399112,0,15adce52e4e48feb5591fb8acf8005ae1179cf1dc67a0afdaabcd7f2c16666bc,31616359095
20190208,"PAYMENT RECEIVED",1269731368,0,7104746079cf422254670d4758a499e619ae0a9b85bd00269e0abaaddcf7da6c,30358959983
20190207,"PAYMENT RECEIVED",1252592848,0,ec3d49dfec34e97146828fa915954ee85899dae93e97120e69b621f1250b9e36,29089228615
20190207,"PAYMENT RECEIVED",1262497479,0,4ad7592d293915ba1dbb6b9cb3012e1c6a8e012eeb6475bafd74ab371846109b,27836635767
20190207,"PAYMENT RECEIVED",1251584938,0,09d5d3e4c2a012ebece91b2a12093a0499d9a010c5c5788d1694c659208a8cee,26574138288
20190207,"PAYMENT RECEIVED",1252667988,0,3db5d3981e0fb75c7a3d42f27e161d10f2a9316b2629536f81c4fd52e96df375,25322553350
20190207,"PAYMENT RECEIVED",1264817500,0,6015dd59a4cf498c7f8d2b776ff1a9d6d27a1fce48ab9c7b27f990dd9d7d008f,24069885362
20190207,"PAYMENT RECEIVED",1257559108,0,bd5518ea3a6150c6c2957423ce19bd739878d7cc21ca1715b561905d7a19f18d,22805067862
20190207,"PAYMENT RECEIVED",1263150691,0,280f19d0c561d7c453dd7b3d66304ee2ea160ae2132a14dc03c260cd3dbd21d4,21547508754
20190207,"PAYMENT RECEIVED",1275677656,0,fbd18150b873b5f6343cd82fe016adaab909111cc57f19ab995211fca47b0912,20284358063
20190207,"PAYMENT RECEIVED",1328201260,0,07147e3f1eeb04259d4987f0aa6cac5d1ea067bfc13164af2a777a528611b3ad,19008680407
20190207,"PAYMENT RECEIVED",1269245274,0,2ea492dce3d64e1d641cb9abc9680f02c2717bf845f92c6c56ed079c273733d1,17680479147
20190207,"PAYMENT RECEIVED",1250828666,0,5a7a6f314d01cee911280fe90e5d21e62b8d7b249addb1be760d78df79eb7253,16411233873
20190207,"PAYMENT RECEIVED",1252040141,0,e885d7d1675ca813981e9d09f80c7aec4cc22df483f01fa406271b8668bdcea3,15160405207
20190207,"PAYMENT RECEIVED",1256464676,0,5d43e541c703b2e1dae555ddfd5aed567642d9ba282a8cc42707d585a11e5d94,13908365066
20190207,"PAYMENT SENT",0,-20142629110,822f8a7870ed8c239ea5c7858c9d1b307f9002880608bb8ba1d6361c43d23d6f,12651900390
20190207,"PAYMENT RECEIVED",1269129466,0,3c62d3a54403e7e02462c44d760e679c49824b5754029f5d29bdf49e2b2686e7,32794529500
20190207,"PAYMENT RECEIVED",1252409879,0,cbf3e43274178587cb277b902b9d3d0f7aa322a0fa1a7974e3b6505097ac397d,31525400034
20190206,"PAYMENT RECEIVED",1262561571,0,2973d81c69814617b6a141cb7549a27d29f3bccd2657721a1780fa906dd67bba,30272990155
20190206,"PAYMENT RECEIVED",1276345653,0,d5d0c0344be6a4afaef04e421c07b66639802096cf9cf378aae7c8a8ddb53470,29010428584
20190206,"PAYMENT RECEIVED",1252298302,0,1d1ed500f18e50a216a631db2e80acc2d8233d001f8729d5223e9d76a35e69bd,27734082931
20190206,"PAYMENT RECEIVED",1269999692,0,431b513c7ada8f522d98321335ba955088c41dda5e8a45271c9779d0debe965f,26481784629
20190206,"PAYMENT RECEIVED",1274664010,0,29ebd8589291feb7170bbdc84a46e8c0dacc5609cb430a1a3ec9502afe059090,25211784937
20190206,"PAYMENT RECEIVED",1283746244,0,6b2408a560f69e6010b0e8f232713985be2425f9797f90166cf92045e90885a0,23937120927
20190206,"PAYMENT RECEIVED",1252217905,0,10662c16c863263a933b48ec292b490bea76a9e1e8b889830c0d97722b6d6ca4,22653374683
20190206,"PAYMENT RECEIVED",1255665232,0,df43685f097a847f47c3255004cd25cfe639de3399f2792f3c2d9d480e518ea4,21401156778
20190206,"PAYMENT RECEIVED",1263597201,0,3474726ba3fd64c227dac7a537f545ce83d486890e025af5901dd1ec61f20fb4,20145491546
20190206,"PAYMENT RECEIVED",1257740995,0,2e83a663ed6bc018e47aee4ea482645fef7fc171fa141d360c7993753f821edc,18881894345
20190206,"PAYMENT RECEIVED",1252806566,0,f475f0274e51479328f5df39d3b8d8a52d0811118098841b9439dd335f5a1356,17624153350
20190206,"PAYMENT RECEIVED",1250470047,0,9c2eeabd78b90668e9937bb5e2fed2390033b5f96546511bf9dcca769d4b0652,16371346784
20190206,"PAYMENT RECEIVED",1258527122,0,73fd3c42af3d47237847428026487ad9a2c9bbc88e5b6089765790940832639e,15120876737
20190206,"PAYMENT SENT",0,-29006932741,9681d34ed04364fd8a9c237eb50bc1f034bea48bd3389ed7b9d330a238e3bb5c,13862349615
20190206,"PAYMENT RECEIVED",1260559069,0,85420bc75481e398ec60a010187063f3fe557aeb9176a776c52cca94a36a5cc0,42869282356
20190205,"PAYMENT RECEIVED",1255155115,0,d929ee90e2fea9d03174ebf07485c410f34ffe05a6b059e1dbf2ada043ab7a2b,41608723287
20190205,"PAYMENT RECEIVED",1251729667,0,6e2ca39c0b940323a6425141dc27d478184d8395a3abddd277231b1115fbe60f,40353568172
20190205,"PAYMENT RECEIVED",1253024356,0,cbf7f982972c1cffee518555cba7109dd987715786a67a76bb67c7952a2e9aa4,39101838505
20190205,"PAYMENT RECEIVED",1256776457,0,525bda6f6c9b971b94dc79c9cce8d0f5b35a304728ebd175a2ce978e072bbdbc,37848814149
20190205,"PAYMENT RECEIVED",1252718509,0,8c21d0c1d57876313019ae09ba06931418fcde424b5a8ce2d2c6a6b5dc319114,36592037692
20190205,"PAYMENT RECEIVED",1269632827,0,c314e7b35009db4e077b830303657ef60ab5991404efd5c620e7d978b427b1f4,35339319183
20190205,"PAYMENT RECEIVED",1252590910,0,26f8c7b38c5e2a7465bcf8222e1fc4e6dea7e33db76d1516267bbbca31a28289,34069686356
20190205,"PAYMENT RECEIVED",1278190329,0,c5bb9039099e8e7e2fd4999abb815bfb1f04fa5227cb5513d0505c52af6fd9c1,32817095446
20190205,"PAYMENT RECEIVED",1259264520,0,a5733792b9b692ae1d62404e78de467c771639352350d739b6e9e8d09477954d,31538905117
20190205,"PAYMENT RECEIVED",1272707310,0,20c3e9da03d2d8183e0293bbd3b689b98722fcf3d8366d6ae318ed5d4fce3fc6,30279640597
20190205,"PAYMENT RECEIVED",1280501493,0,0fd0a0d61f9257a6147004d08bb1435593018a10ae7a1c3f4228db079c403eab,29006933287
20190205,"PAYMENT RECEIVED",1253357981,0,32d612a0ce6b40870fa74fb75d7409835dbec2e5cb7c01a7bd5ba7d9c8acddae,27726431794
20190205,"PAYMENT RECEIVED",1251293129,0,682abab1babc69884b98a5a14808e90561bbcb42d1c00fed9b6865ec3934fafd,26473073813
20190205,"PAYMENT SENT",0,-21414600197,578f32827505a76bba4744735ec4db97fe755ce255e2b30420a5be83f0189f21,25221780684
20190205,"PAYMENT RECEIVED",1261676329,0,ba34107b8fb8d1d3ef2d65549ea8eefd2097c570ed47dfa25d713273b3893e40,46636380881
20190205,"PAYMENT RECEIVED",1251145650,0,82611fe4b2c6bc2ad422187d05f4fbdf75635fd1253500dfacae0671d1e870dc,45374704552
20190205,"PAYMENT RECEIVED",1251647846,0,2816e79c576eb292d43ccde6edddeafac3e24c25e4cb23e2477cefe0f9a4bc2f,44123558902
20190205,"PAYMENT RECEIVED",1254396321,0,8e280a5f2337329ca71dad284dcb301c50853d39ab61bc661dee14fd365caa6f,42871911056
20190205,"PAYMENT RECEIVED",1252424018,0,e3b374521ebac4a6988b6829308aba939eade1d4f9d102674e78e9b671220bde,41617514735
20190205,"PAYMENT RECEIVED",1267232813,0,a0bc8ef83c3b63ec2ecdfb358ed65c7b3d207a7bd585c2b9b01844eff51ae123,40365090717
20190204,"PAYMENT RECEIVED",1259522737,0,55c44214ebe49605374f62c00241a347d0f6b6a6f83341db54ba9696fb68d947,39097857904
20190204,"PAYMENT RECEIVED",1253226629,0,51dd45284e516c86a66f1a7a89ca28ce88a47f26d190d283153ee63d3fd524c6,37838335167
20190204,"PAYMENT RECEIVED",1260480550,0,3fbe4a96c0a311fe15f2a5f016cb6cd6c77e56330fc5a02aedfc12ad568b418c,36585108538
20190204,"PAYMENT RECEIVED",1254026451,0,4b621a81fd3705375f7dbf1c60a2c104c9b4b0955a136d9dd105962bbbdb1421,35324627988
20190204,"PAYMENT RECEIVED",1289668694,0,6649fd57b35544beb232356fbb3a820909071ef429b420ab10d36166ce410214,34070601537
20190204,"PAYMENT RECEIVED",1265850846,0,8a4951cae997bce3034f9e3ebd516c0958f8fe3c30ffc70f8b209a53b767311e,32780932843
20190204,"PAYMENT RECEIVED",1252127078,0,59795f7fce617b028c70e649316ee62af2e1244208f121b719bbf13699188297,31515081997
20190204,"PAYMENT RECEIVED",1262692000,0,275526db32649f77be40fc9972c2ce581c51b3b7624be227ba3a19caa52bc0a4,30262954919
20190204,"PAYMENT RECEIVED",1271551630,0,1a917e0ca2133908b9498b141cbe8f0fa7d22fc4a29988876be1a0d68f5f1ca4,29000262919
20190204,"PAYMENT RECEIVED",1264838162,0,908041310da18dedf46c15e1339d2346ee82cebd1db3518f816b2d9bd9e3a287,27728711289
20190204,"PAYMENT RECEIVED",1261186752,0,ece3af6d13242076a0e424d3f72e7e080ae97c27645c75d0de048693870850f4,26463873127
20190204,"PAYMENT RECEIVED",1258928866,0,b8401385565ecfed8c9f23b5ecf49b6eba43e5b9212055dd01016da98a969385,25202686375
20190204,"PAYMENT RECEIVED",1264979976,0,ab72db4f16eff1f66bdc25d46b4a50efe4eb77b10b401878a8fb389617efa413,23943757509
20190204,"PAYMENT RECEIVED",1264176790,0,fff367a77c6bdbcdc4a8730a85928b4edc8ab9e1866be8a60ae39ce9123b9619,22678777533
20190204,"PAYMENT RECEIVED",1252557836,0,bcc49c51aa54892121ddc79898512140923181da22ed76e542c7dc84abeb0b72,21414600743
20190204,"PAYMENT RECEIVED",1255231880,0,13d8a1c02ac20109d471baa796fe5be7a4ee7e24c95ba6f6c12c22adc41d6b61,20162042907
20190204,"PAYMENT RECEIVED",1257556211,0,722ac7500c8c9b16383101860a18e7359ee2bda5f77f1e80e892460799865580,18906811027
20190204,"PAYMENT RECEIVED",1258719012,0,4872a957c565e10043ae63bb6d1dfcb977834f86f85b81bc07a965e28ff2bd63,17649254816
20190204,"PAYMENT RECEIVED",1253614847,0,063bf5c08c3730768fc755e48e2b16a8012a19aebdb49549baf474ddfe5b43fd,16390535804
20190204,"PAYMENT RECEIVED",1256919237,0,59cd511756e0d4544804b7149a89176db27d47d8628b2d7f191bb1c2a3798380,15136920957
20190204,"PAYMENT RECEIVED",1252501422,0,09479ea44e598f3d8328a3636fad30de4f1b3e771d3615520ab60956542ea23e,13880001720
20190204,"PAYMENT SENT",0,-15119270551,4e24fa9a604b29a52531478d2bd3fddd65e401c70afd66e34a421a486cf9a57f,12627500298
20190204,"PAYMENT RECEIVED",1260643372,0,fa486d22d66f2224ff9217e2adca3d473b4a1693ff7145affdc1380c706140d7,27746770849
20190204,"PAYMENT RECEIVED",1254576638,0,b55d6ae7bddfe3f9e9a6bc00d711bfe1fe9fa2a8ff5fbadc0ad530c617936681,26486127477
20190203,"PAYMENT RECEIVED",1283197796,0,7091bd216a29e761e16a5958dc33797f0fac94e2c6907ec5b67c43f7f9c2322b,25231550839
20190203,"PAYMENT RECEIVED",1260600056,0,2b292685884a189999fc63948bbc5e32cbff7621060f8a32f43fdb57e6ff8dd5,23948353043
20190203,"PAYMENT RECEIVED",1253750509,0,5c0af94c1895fe9060a8616e4d87580591a0fdfe18cd3dae577d904d095299ba,22687752987
20190203,"PAYMENT RECEIVED",1271508667,0,94447f812a081d29d586b5d7cced1da5276c76bb00d3cc0e2ae8c647268053a0,21434002478
20190203,"PAYMENT RECEIVED",1258134641,0,8c41be6acec12ccf0f8aafb694fb529b458becc3752d0e9041ad10b8b3f49b10,20162493811
20190203,"PAYMENT RECEIVED",1268165739,0,c996fa33740ff2f57e41ff26f90ff9968664aade78acb268b012860b05076eb6,18904359170
20190203,"PAYMENT RECEIVED",1264361104,0,6c4f87a6057a2d2fba8e29cfb2503d0ecbcd003477b5e833a27d7ba639231326,17636193431
20190203,"PAYMENT RECEIVED",1252561230,0,7f961d8b04e0838bb065bae4fdef695f462aca393988a343ad4b22320bf9e1a4,16371832327
20190203,"PAYMENT RECEIVED",1251837812,0,c9a36b139cc6f59ef83c6773424ab9e2bd2454debcfd86c6c41df0a53faab15a,15119271097
20190203,"PAYMENT RECEIVED",1251908491,0,e4a56dd46ee3a507e8b6968d630c31ee8168879f308cd3edb583e308325f4e04,13867433285
20190203,"PAYMENT RECEIVED",1255122030,0,ab4c57825025527fa1529a7659962043cc576d4a6a0de7ae88dc09c7703898f1,12615524794
20190203,"PAYMENT RECEIVED",1252324476,0,ca3d80782300e039fa7d651d4285798520289dce81bb29458bcd2e575eb9b426,11360402764
20190203,"PAYMENT RECEIVED",1251587656,0,b040d23c34e4df606866f591711dac58491752dc0d701fc8888572274d84563e,10108078288
20190203,"PAYMENT SENT",0,-27817053042,0c2bb7f39fa27ca0718fb624d3c7ef69b29f97c47e573f5b820dea9a70b6e0a3,8856490632
20190203,"PAYMENT RECEIVED",1250447980,0,58c7e76b766c7aede619622d34aa8624e4824e27f07c7e6b8a48c658ca127e8e,36673543674
20190203,"PAYMENT RECEIVED",1264368583,0,8e6d18ed688a0e7aabe0ccde7b657c07d45f4107a2508a2c28b195f8a21b5df8,35423095694
20190203,"PAYMENT RECEIVED",1255212586,0,280b4af81751b55015fd6dbb1584a69c9a21c2905b36e30a41d8b56f90846d04,34158727111
20190202,"PAYMENT RECEIVED",1253627495,0,8ba38d86d9f864cfa10f87ce18ed1ff5d54f018df25f9445d2ec324f7aea0fb4,32903514525
20190202,"PAYMENT RECEIVED",1259856048,0,01067150f58c605f04ae8b3fb0801ec8cc52f543fa5db5b55e85365197e4b8e6,31649887030
20190202,"PAYMENT RECEIVED",1322140458,0,4ab31a0848290b3b25b440c0c1120f5cd53421f18d85a00d6bcbcaf045c9f535,30390030982
20190202,"PAYMENT RECEIVED",1250836936,0,c04143477efe145e0eff573dd7d3577033221e8f209971547bd04b3364c3f090,29067890524
20190202,"PAYMENT RECEIVED",1252694798,0,4d797662805901c76c7026e7ddcebb24c413b0bd0cf7b84fb64e6b86802cd66a,27817053588
20190202,"PAYMENT RECEIVED",1271309075,0,b2fad19ba41e1b85af850e1c1400436a8677c542e51fbc7eda9127120ed0b56c,26564358790
20190202,"PAYMENT RECEIVED",1251833860,0,9950723aa070eaae6538f4a9c9c7ddddd161dd6f5e3ef46ce71c0b586a7d72d5,25293049715
20190202,"PAYMENT SENT",0,-29055824087,97da9749d0ced715285a3307bb4503631459c3340721473bd267b465cfb57eed,24041215855
20190202,"PAYMENT RECEIVED",1263502145,0,05675295db32ec4b47d068c98137fdb44967c23e3c75aeb159bb40b771836d81,53097039942
20190202,"PAYMENT RECEIVED",1290143332,0,dd7e762d12e69c779f62b4d90425d43d3aa5b35a6bed103d57fee646cd720869,51833537797
20190202,"PAYMENT RECEIVED",1259970433,0,9c49a03e8e4a96824f3d293b621a6048eebde18082969892c0e849d6ecbf757a,50543394465
20190202,"PAYMENT RECEIVED",1261319552,0,ecd96b301c799c47d17b1d33c85a15e78d2e785e0ff2723ef40741f4b8719adb,49283424032
20190202,"PAYMENT RECEIVED",1251803759,0,c425c44a9bb7ea8b44e1c5fbb99038b9617b26619d30da281b849b83dc7e2882,48022104480
20190202,"PAYMENT RECEIVED",1269567295,0,7368a2c613cbd1f0cd3e6f89a3ef089a42c90c66552a694dc8ab144053dc0b2f,46770300721
20190201,"PAYMENT RECEIVED",1262492554,0,8ae7834cdf09a50d07f0f4273375cfd8128fb4393110024cfb61d74f97f3a9fd,45500733426
20190201,"PAYMENT RECEIVED",1260728536,0,2af11821551342a5e44bc0bcbef8a70c3723009e628a9b037761df8543fe6dc4,44238240872
20190201,"PAYMENT RECEIVED",1272136090,0,c2bb069a61f6fd23a00bc5a7ed5f907008a3a0f5f40c1401d7c6e1798757c1be,42977512336
20190201,"PAYMENT RECEIVED",1253158170,0,cadb89197fc14e06dfa6d552cd22dd57b17a1c086c44866eaa7800b9681ee95b,41705376246
20190201,"PAYMENT RECEIVED",1251614465,0,122ef023b0953011ba76d5e26676400a852f70fcf4b1f61d1cc5fec3794b8af7,40452218076
20190201,"PAYMENT RECEIVED",1268304628,0,b324adc416b76cf1abee9b64e6fbd5d89a7472f3ece141e8d283905e8113d982,39200603611
20190201,"PAYMENT RECEIVED",1282147125,0,b2f1a8c532396e2654fca88eb475beb4e9911b834af83d6bf6440086520d9eea,37932298983
20190201,"PAYMENT RECEIVED",1259232785,0,7df92544148d77f657e3fbf69a1fcce1ee32fd1b40ac4ecd1947e0c849553d94,36650151858
20190201,"PAYMENT RECEIVED",1261337682,0,c5fcbc25a063d848b2ed23c944cd7af1873bc627bd32b436d4e5e4409cd73319,35390919073
20190201,"PAYMENT RECEIVED",1269143780,0,bb4624d39938d9a89a120e98be02c7b8ba818df23f7dc0b4c5dae2a5230b9ebb,34129581391
20190201,"PAYMENT RECEIVED",1274090240,0,5de50cf2222516f0d24b1fb9cb2f111bbc70acae3556cbcf6f1da1c7a1b8c479,32860437611
20190201,"PAYMENT RECEIVED",1262319849,0,7d05f55f18c549b32f6f557d3d16f59053941ae50b81c6a63d36067b8c50a18e,31586347371
20190201,"PAYMENT RECEIVED",1268202889,0,ae39408c1bf7fbdf43ccb8a52b6c2f5e6b0c97225946fb1ada751c2cae978e45,30324027522
20190201,"PAYMENT RECEIVED",1268418592,0,1fba5c2e8b10d06c0ef8327fa590c08f3d9b4fa2e4765159349ae462fc781010,29055824633
20190201,"PAYMENT RECEIVED",1263617759,0,f27301b68b2801037eba6e68a136a931efbb9884d41b0287beff71491a32d5e6,27787406041
20190201,"PAYMENT RECEIVED",1259655394,0,aeda3ad57336615bbeedee48ddfb77eb7c14df4b927e57896073c6ce61bd1dfd,26523788282
20190201,"PAYMENT RECEIVED",1281048023,0,915a651c1572f72b8a92ebf717f2337daee7001def8de21c2055c0f8c85d5ffc,25264132888
20190201,"PAYMENT RECEIVED",1261504572,0,01be26c9319b6ea79e5b9808b2089b82ae5c64a27ca0d05b4488f6f8edda472f,23983084865
20190201,"PAYMENT RECEIVED",1253929661,0,1e73856ae7ebc164e3ad3aa55e1acfeaf8413f9f179d95c3fd6e6a58f107cf16,22721580293
20190201,"PAYMENT RECEIVED",1250772856,0,55b3c8f4c99d1a9c8915e1cd8a26cde51ac67db582fc6a16360add4a6d4b83c4,21467650632
20190201,"PAYMENT RECEIVED",1250717784,0,4564085663f75dccb11ba15fa0bf6e41dc80718f2bfa29fc31cc23c288b619ed,20216877776
20190201,"PAYMENT RECEIVED",1251406296,0,200b2b4e33e841841a9fff689c242a765d241a17dcd01cd6b3cee39c825ece0f,18966159992
20190201,"PAYMENT RECEIVED",1269557695,0,95937126942df3969e29b7d5e8942c49017fa33ea7ebf9285c0497ec7b36eb96,17714753696
20190201,"PAYMENT RECEIVED",1264072066,0,04688f2456358600b6a8f592cd8e9ade9a19cce0d755fc6a07db3c16fb0f1dc6,16445196001
20190201,"PAYMENT RECEIVED",1251324241,0,ad04c8a7d544201c783a9c802a2cbc98b0d44168093fac40b93e9731e15d11d9,15181123935
20190201,"PAYMENT RECEIVED",1262713708,0,0f09ea0ccbcd1c9bbcb4f47ac08cd020ca44952e05b1bc7ab2b0717bb83e3b8d,13929799694
20190201,"PAYMENT RECEIVED",1260670408,0,50271107228c57641b6b6d9785d447a3315ba7f503236e23727ba3e9608a10c6,12667085986
20190201,"PAYMENT RECEIVED",1270477324,0,b8b54b6212054170550e9d6fec84e4362267848c63296e248eaedd6f87df46cd,11406415578
20190201,"PAYMENT SENT",0,-18937494753,f57cecf70f63bd4b71b9f0f593c0b12bec1c22c78f5d0d9e580df9804338903c,10135938254
20190201,"PAYMENT RECEIVED",1268331969,0,e4e42bc1f2359adccba4d8e65e1012c2fc033d6b91ec16e17ca8c8c3479ba3bd,29073433007
20190131,"PAYMENT RECEIVED",1253603227,0,c9a5d18f2df603b30a608a484b9ed7fcab27551512beda7d86187cca4f33d86a,27805101038
20190131,"PAYMENT RECEIVED",1264129280,0,b831b2d5d00595379e1d961a32df54eb5feaf919f7f5a4cf7d2a140e802bf63f,26551497811
20190131,"PAYMENT RECEIVED",1250384106,0,11034e6e0be7964e005b74ccf14906a0626a7a9bbae68aa19ccbd004f9157d20,25287368531
20190131,"PAYMENT RECEIVED",1271070581,0,63e3eac4bcfb9a1188c190f8dacb3738c766bebfa2f35f637f69f0b3c8b36fd6,24036984425
20190131,"PAYMENT RECEIVED",1301698432,0,a0b44e13fbd7d8f30f59b60702c441c805a5430b001dce9ea87a86c665f83974,22765913844
20190131,"PAYMENT RECEIVED",1250000000,0,599ffcb8940f4fc5191ab5396b2a1a6c3bbb05d3bf3b36081883e940a5df8a5e,21464215412
20190131,"PAYMENT RECEIVED",1276720113,0,e33e1a4aaf60037bd60196fb30249ac05802be78fb893c0fec004d9130195ad7,20214215412
20190131,"PAYMENT RECEIVED",1258522113,0,a714e29a877e568775b862021180a3557172ef47e2d238db315f42c7a4cbe71b,18937495299
20190131,"PAYMENT RECEIVED",1266017332,0,5660a30c542fd8dd1efaf7ead72e6dfd7a912ecbeb181de2713a671b0be90439,17678973186
20190131,"PAYMENT RECEIVED",1255157934,0,0b95ad1fe1e47c2282adf7a546a1e77618e60a35c075b3779eadbcdbc04155e0,16412955854
20190131,"PAYMENT RECEIVED",1266600715,0,fc468a3f0245d0c9966ffed0fbd8471e22e70eaaee41f33af090ce2e3829df26,15157797920
20190131,"PAYMENT RECEIVED",1267460202,0,5d30da82de01dbdbef36f7a066358d3e766c733ea7915f5ba96c53e0441e6d05,13891197205
20190131,"PAYMENT RECEIVED",1267012515,0,9efb72be9f0977ad7441e1d84d182cca92d979aa7251596faba88510bbad19fe,12623737003
20190131,"PAYMENT RECEIVED",1259872984,0,e3f32edfc9ec68a2604baedb58b3c23d340b70381135538850141cd6beb1c572,11356724488
20190131,"PAYMENT SENT",0,-23969266212,596de61be83f1cc8450c3d4f58cdcb10978a36a57f86eaf008a14e98f2492150,10096851504
20190131,"PAYMENT RECEIVED",1260865167,0,65346cf8600e127d87e8fcf330b3d3a442ef610c40affc6e0d6d314b2a241587,34066117716
20190131,"PAYMENT RECEIVED",1271630883,0,52907028cf88cad60527d909579a444ca1a9bdab4159337c2a67560f25327f1d,32805252549
20190130,"PAYMENT RECEIVED",1255421257,0,d3b6acff25705f631968238ee12499965db861f0ebfd32a296ba273295301c5e,31533621666
20190130,"PAYMENT RECEIVED",1256566623,0,95c9aadf77a2f996e7cce24b9278b1ebc3be983688d6b5df291f50d4d895d0b6,30278200409
20190130,"PAYMENT RECEIVED",1267037644,0,e73a235747cccf3339038888a9cb6f64f45e956cfee16375562476688b39e184,29021633786
20190130,"PAYMENT RECEIVED",1266508933,0,4593d157f87eeb280a683b6ee9062e4a774432549a6649a54aaf38ccd865efc1,27754596142
20190130,"PAYMENT RECEIVED",1268820451,0,7ccf531884f0cf1731b814f776962e5569288402ec0afb9b6dbe1553cb7d2fc5,26488087209
20190130,"PAYMENT RECEIVED",1250000000,0,a2f5039004074dff65a887aa8671010c6c68abdff9cca63a731f843f56fbc90b,25219266758
20190130,"PAYMENT RECEIVED",1254969969,0,d7c8db36b4e137b87c6bd154176944ba91924001cb13c540c231ed4b554f90c2,23969266758
20190130,"PAYMENT RECEIVED",1260006048,0,3f9b8cedd4259dc05530eb41b83e34844369d5f374709e3d025a9ae38139b462,22714296789
20190130,"PAYMENT RECEIVED",1253046410,0,6b80f905a941b3790ff378ac8ec421a729f3be0b666aa514ebd8428b389af129,21454290741
20190130,"PAYMENT RECEIVED",1260699029,0,0fe05f05462a84b0e776ba1aa0eb872516e3aa9fccef9a3cd075a84a183b7936,20201244331
20190130,"PAYMENT RECEIVED",1255036160,0,faa7932d583ff8a73f4f7e2dba0c40efc40ce7cd317d16efa61c30e955aba848,18940545302
20190130,"PAYMENT RECEIVED",1259843366,0,8e6668eb97b85c9ecb7d84117e75be229f8cfc2aedeed4e2b7514105f8ebfde6,17685509142
20190130,"PAYMENT SENT",0,-24138046752,534e41a735c6ff2896ccac43aa259505fc7ca58b89624e437ee2daec1699ef25,16425665776
20190130,"PAYMENT RECEIVED",1253777694,0,3e045871cc0d222be75d5bbdfa57f5ba046e52082b83d5b482ff2c0faa263e03,40563712528
20190130,"PAYMENT RECEIVED",1256044160,0,34b3df06b7cef5eae18c765ba6fa29a51cdf9e89ffb13032b94fbde1f3fc80a9,39309934834
20190129,"PAYMENT RECEIVED",1253659359,0,d1b5cacd11367b284eec5648bc78e48ea577bc831062150e549215c8f7b9121b,38053890674
20190129,"PAYMENT RECEIVED",1271669999,0,b0331db02004913c202122e936e8e8cf6fec3c17e275daa23273ac76d5d68bca,36800231315
20190129,"PAYMENT RECEIVED",1265997331,0,89d794a037db274d8e7e0133ddc46c2ddd4e02c447725061240e1d23a1108ec5,35528561316
20190129,"PAYMENT RECEIVED",1261632987,0,a44b45dfb11e896c6597f5d2a5ae2f67bd10041183161d42014262799295b66e,34262563985
20190129,"PAYMENT RECEIVED",1250000000,0,da5f911cd7390b5f42eb37a246334b13bb58c6da408980495ceb62059f9cbf83,33000930998
20190129,"PAYMENT RECEIVED",1255551924,0,c5d6d4ee8d8dae37e2a6de747b012b624857573a0f484fda9c27ea664648ee02,31750930998
20190129,"PAYMENT RECEIVED",1283597535,0,69e6af092d619ce8e4ecb5a4eb263939f8f997d25c38a842597ea4a60f33099b,30495379074
20190129,"PAYMENT RECEIVED",1279126780,0,8d8aa95a048dc5c026f2ec24022b333fdf7c5abf75bac53e79c0dbbec569f73a,29211781539
20190129,"PAYMENT RECEIVED",1251666219,0,c3e5024962c5e1f9643175d1b61fc74f4cb2294fcefd170a6e22862c06b34c71,27932654759
20190129,"PAYMENT RECEIVED",1273541220,0,4c175484d22ce0074ba167adfd15db420280debcd6e4d339d9a6f3717e8cfcf7,26680988540
20190129,"PAYMENT RECEIVED",1286436357,0,cefa2aef8443f942407eae523d4ff347e53cb1b0dba659d8b855e34005b16bb1,25407447320
20190129,"PAYMENT RECEIVED",1271227586,0,226df94eeac78d69be0385e62a32c42d37407a16e4f87454b29b9f591e6d2a6d,24121010963
20190129,"PAYMENT RECEIVED",1272236880,0,12917711cc2cdf4c2cf8f2e9214740d89cd4278532d545dbda2492d09eac268d,22849783377
20190129,"PAYMENT RECEIVED",1264762334,0,bcaaeb32dcdc4d943a32f20a56a5ed6065909eec64b6c56a3d08e52b71282acc,21577546497
20190129,"PAYMENT SENT",0,-21406719209,170b539db65f47c1e1b8d148e3342276413ababe028f9c71fe93e17616e33c6a,20312784163
20190129,"PAYMENT RECEIVED",1252647695,0,2e99c86152c46fc25fe0501cf1e1103596062f782c0a1306642c53b78f56ee06,41719503372
20190129,"PAYMENT RECEIVED",1251660963,0,5fc73ca603de4784879a95313809d15e23819edd92224c611b14c665014d08cd,40466855677
20190129,"PAYMENT RECEIVED",1262632814,0,7a7c1f740d28da52ac6712c13dd0d823d5a77ef2fcbef706f0bf99f3883b2a94,39215194714
20190129,"PAYMENT RECEIVED",1260551337,0,f236cf3188982b6112609002a95670da88e592b3e416f191c89398888331ea59,37952561900
20190128,"PAYMENT RECEIVED",1271713656,0,e63041a6d0cc99e859897ad2937068d5b437decd5ec6e50641895f5b0f616113,36692010563
20190128,"PAYMENT RECEIVED",1259419228,0,5e5a5f82d140db36a14140e98fcffc00fbc2bf79eb7936677eefb3bb3c746e1d,35420296907
20190128,"PAYMENT RECEIVED",1257784649,0,f87ef45fb5a5fcd08f316f90f4108ebf6b4aada3be47138544ad469c9c4d726e,34160877679
20190128,"PAYMENT RECEIVED",1267073471,0,c18c601eed1e2468ed5b248872c89c55c13b224cfc1fd51db976aced859e2624,32903093030
20190128,"PAYMENT RECEIVED",1261729122,0,f0dddc0accaddcdca4c059fc05d2bf78f3bcbc4202c0c5482b863ea6122c35a5,31636019559
20190128,"PAYMENT RECEIVED",1261429452,0,8c31a68d2a025a764c5f6a9969a6568c3548dc6045f45e059e59e3c992045aec,30374290437
20190128,"PAYMENT RECEIVED",1287472477,0,675c657fd124ed4f35a1bf48306928edcde6dc2b948060da35b1d3a4086f5ec4,29112860985
20190128,"PAYMENT RECEIVED",1286066263,0,598df6ba2b71e5d5567bbd9f5d94459d85824d7813c383c90f20729308328e47,27825388508
20190128,"PAYMENT RECEIVED",1282515750,0,d4f4098373c4ed065497f6de2cc75bc4ee33a2bbd69fc5a29f688e834d2fcea4,26539322245
20190128,"PAYMENT RECEIVED",1291756314,0,87f6cf0a7f2069acb0ab7531119cbb269f81aed342f73cca78dc9e215c15d07e,25256806495
20190128,"PAYMENT RECEIVED",1264539103,0,72b9bf48a6f3e265bf002bf7fe0283dfb3447328e6298ad8a3a2f3a414f14ea4,23965050181
20190128,"PAYMENT RECEIVED",1293791323,0,eab4e723b48033938cf96f39b371dad3ca0d69d825f3a90e57c3cbb60a92aaf4,22700511078
20190128,"PAYMENT RECEIVED",1270757753,0,3e2a8e0d32874ad21ffb08f28137882b7219028c7546719366bb7bcdc75e14ad,21406719755
20190128,"PAYMENT RECEIVED",1254493074,0,9b4d690faf8d287aa8b5e56ccc826b988e1b759621294a665e75dfd71bd6c125,20135962002
20190128,"PAYMENT RECEIVED",1253386655,0,362f11f0ddd9ec51abafcacf8961f7a0b688d953e75371b722bb216fdad6c6df,18881468928
20190128,"PAYMENT RECEIVED",1261531217,0,1aace09e0be8e80f915ab383ae881ebb460b054e1e9cd0ea19eff23652f79cc3,17628082273
20190128,"PAYMENT RECEIVED",1254186660,0,8e91e732a36990935c8c5a040b200cc42454f94dc9449edcffb4898bebbce792,16366551056
20190128,"PAYMENT SENT",0,-15114524178,86f0aa34098cf16e37781baba986d94865dd08898ae13f5450a5a00445b83bec,15112364396
20190128,"PAYMENT RECEIVED",1262158333,0,60254a05cd6c94aa55fec5621d2e2bae058e06c5d86280ebfcd5b51daa628467,30226888574
20190128,"PAYMENT RECEIVED",1250746240,0,85cfe4acd2e03186a5ee18462a8da05fb77c4883d55f28e172a19166ed77c6ea,28964730241
20190127,"PAYMENT RECEIVED",1251363110,0,7ef085747f0af4862448c6eed8fe9a4ae8a2eb83c2a2f681319a45e0abce5625,27713984001
20190127,"PAYMENT RECEIVED",1262400104,0,71a0b0fe6ccf53e35221beea1b1bee31f928a387878cf1c3e22298d73f63ed60,26462620891
20190127,"PAYMENT RECEIVED",1253138880,0,408e920708bc4878b74175445637c836b709cba05a2a627ff41f98dd33d5e281,25200220787
20190127,"PAYMENT RECEIVED",1263070139,0,b4a57b305f1e7d2e9e3f0fd16066e9cdbd5be1a37e09466efe44f411dc4cf18a,23947081907
20190127,"PAYMENT RECEIVED",1250258942,0,0870e80dfcd5715dad7833de0f3a61282aa0d37f492097c975b39bd35d5bb4dc,22684011768
20190127,"PAYMENT RECEIVED",1257682767,0,e7522dcf9d53bb9136c5638a7657a10b08817b934490bdffaec19ec26521b42d,21433752826
20190127,"PAYMENT RECEIVED",1272608259,0,25367ea56418af466444f90635bc5279adb5d7b095d3b1fe870955a81409dd00,20176070059
20190127,"PAYMENT RECEIVED",1271640194,0,e213766c0f12161ef6a3d2d5d6909092eb61f1a44eba46bbf23c200a8b518bd5,18903461800
20190127,"PAYMENT RECEIVED",1251533327,0,fff0043db18fefe3a5f89dc290d36d2eb8c8ba2304f1cc3f66e636b43e2580cb,17631821606
20190127,"PAYMENT RECEIVED",1265763555,0,3c2f9bf2c7d3de85db6b1705c93e41b9818899919d753e0ef3dfed21edbfda9c,16380288279
20190127,"PAYMENT RECEIVED",1255297894,0,7bb162bec175e357411be14beca4c55ef7dedf1564a25c665a7e69a991689001,15114524724
20190127,"PAYMENT SENT",0,-22855682101,08a29f186d67f2f1a6eecabce6c02d63c28ff1ce8b6cf74fad32b62638ce0a78,13859226830
20190126,"PAYMENT RECEIVED",1250899689,0,9605cf7a04c825f539b3fa647f7565878d4ed187c7e5053e414a9b93b2424b27,36714908931
20190126,"PAYMENT RECEIVED",1253380836,0,61e3f43a9320e9ad8aeec2bb7ee31c20e2f4f9232622e9d1332a4c86b3ade818,35464009242
20190126,"PAYMENT RECEIVED",1258495240,0,6e21127b6fd6667c2f78e80adc0406b0fffa38ab46cf9e9b03ef0b04bed79608,34210628406
20190126,"PAYMENT RECEIVED",1255084909,0,f3f9de0a1e9c9e8bdc8eee6eae4fb01976ac7476d6d818b1fe770adf39aee315,32952133166
20190126,"PAYMENT RECEIVED",1260689098,0,d9f321e3b2bac02f5e444953bbee0eaaadbfd747e139743b29c39489b7f1fe5c,31697048257
20190126,"PAYMENT RECEIVED",1252398176,0,d52fa9a3fd10c5034eecf29d782fa49a0d924d9d6a6be6625052a163830ad762,30436359159
20190126,"PAYMENT RECEIVED",1263137278,0,7b4bd287d2b04fdceb53f97c0fc670315a9efdae894dd2309f71402aadb9f3d5,29183960983
20190126,"PAYMENT RECEIVED",1258459676,0,39f922e3e6e250cca3166d512519916a7a2b704aac95c2c69ef648adf85f1ae5,27920823705
20190126,"PAYMENT RECEIVED",1268042224,0,c4f8df2438d940a8441304eab62278c84085b84dbebe1b400d017b43d152b1c7,26662364029
20190126,"PAYMENT RECEIVED",1286024679,0,12bb8654fb2944b6e42accae5b715a9e77411f1ffdae28d7478657719abc52ef,25394321805
20190126,"PAYMENT RECEIVED",1252614479,0,9b068bad32588a47fa955e46badfc74232528cbd2811a0eeb1dc1cb92cf484fb,24108297126
20190126,"PAYMENT RECEIVED",1259329111,0,2054cfed59303f104444ea3cbbc258c826860cf56f5a6c256bbc596ff31c6dce,22855682647
20190126,"PAYMENT RECEIVED",1270860831,0,087f28c929ca26c9cf2d92266e95afe14f9cdaf59cadabf69593175815a995e7,21596353536
20190126,"PAYMENT RECEIVED",1265666887,0,74e243e5425edfce9486e26aa6449e56c68351210e8edc1fe81ddcdc8d478085,20325492705
20190126,"PAYMENT RECEIVED",1266896186,0,2938ffab6f4d2758e694e273e78ce2cd8e9b76334941d2d5af5d895ed563ffd1,19059825818
20190126,"PAYMENT RECEIVED",1255198965,0,adcdf3f76b52d2a67951e21f60478d4afb0184d2bbb8930ed4a32f1b339e9e09,17792929632
20190126,"PAYMENT RECEIVED",1258490302,0,dec47d9c9a1967c887493cedaf80d83ae64ac04b811637de3a43da20b6fef1a3,16537730667
20190126,"PAYMENT RECEIVED",1258295421,0,0ac4817b7aeb153289f5eaac9b43de519ff5c36c91f1c6608c7c0510aeb793ff,15279240365
20190126,"PAYMENT SENT",0,-25285862086,eff21eb7d1706cf178bb393c70e16b8df1e12579e8e2cf8153e52e16f79d4527,14020944944
20190125,"PAYMENT RECEIVED",1250973267,0,9fde219b11f033de8dfa26c243a5578a8670796c7cacb46eedb853ad26ee12f6,39306807030
20190125,"PAYMENT RECEIVED",1297597271,0,8ab34886d25adaa3284028307c0ce3a0dbbd4bd0703d68ad5acc435e08707017,38055833763
20190125,"PAYMENT RECEIVED",1264292598,0,6ad267afd35581e1093fd814a54ed9052769fefb84f03768f02b7f2794e2f534,36758236492
20190125,"PAYMENT RECEIVED",1275824070,0,6c37a5985caf8bc44df82cb25dbbd92262c5d403f1a38a1f04ddedceb592a0b8,35493943894
20190125,"PAYMENT RECEIVED",1272171828,0,be5d9f514d39778090305935a02bf368690ed913d8ce79e0c2f0167be65790f6,34218119824
20190125,"PAYMENT RECEIVED",1349154116,0,20b2b8e670a64776dac7b9efd7be4bdfbc8277b8e80d0622209722b70811e130,32945947996
20190125,"PAYMENT RECEIVED",1250959506,0,1cefe011a7285203e478263ea26451d25c7c1253714373514e422be4e28a486d,31596793880
20190125,"PAYMENT RECEIVED",1253816703,0,f51efb6108071650699d5376e406f3f3c2c2adc4ab9af5d12001a7b4693831a0,30345834374
20190125,"PAYMENT RECEIVED",1254253383,0,ae1ff40fb725a43645343acee498352bf83a299ff686dba34d5ef23a386cd332,29092017671
20190125,"PAYMENT RECEIVED",1252271961,0,be01ed4b09aae94d41113de2fa02be82c0490d56b6b9d1ae9860a34e5fe56462,27837764288
20190125,"PAYMENT RECEIVED",1261558041,0,0360924857a5c4bfb8c5c184b543861488cce18e10493b9590211111d647f3bf,26585492327
20190125,"PAYMENT RECEIVED",1259610609,0,daaf7a95fa73bcc1ccd00f7cc80b22d56642a54f6ded4b2a801051c92e067f1f,25323934286
20190125,"PAYMENT RECEIVED",1282953485,0,64dde50108d3902a3d7eb81d7b70d5817a67a203047cc65b2dff95a9d4735c58,24064323677
20190125,"PAYMENT RECEIVED",1283203728,0,b3d9acc4c8a8b00b0228f14fc3e9404993ada26900ca60798c1d7c2c0ffa4006,22781370192
20190125,"PAYMENT RECEIVED",1257236434,0,7d026652f04399f2649605f1c1637c1b20d39c090226a5309e2b70f875573a44,21498166464
20190125,"PAYMENT RECEIVED",1253484243,0,a4275e18e34603d660b365dbaf06ba9108c4aebadcb320e3ff6afd047a9ff3bd,20240930030
20190125,"PAYMENT RECEIVED",1261120341,0,a5bb1388b0bf14783313b19046eaec10b2e617534647326de9651ad57317f007,18987445787
20190125,"PAYMENT SENT",0,-15221019002,d4540a9aefb06172e0fa681afcc0e05c492a98c26395aa5353b9230570e7fce8,17726325446
20190125,"PAYMENT RECEIVED",1262906000,0,679af80a01da66f40053686568e1f4bd467cd1fa11684c55d584883014a9e42a,32947344448
20190125,"PAYMENT RECEIVED",1257500127,0,6430634f2465daf8498f1e40e8791fa63489455db3659bb728dcd1ac5340f103,31684438448
20190124,"PAYMENT RECEIVED",1252081062,0,f0742628ff495d09c58b2e7a990a53a2f11e5ceef0fe8e87736e1d2065685dfe,30426938321
20190124,"PAYMENT RECEIVED",1259327886,0,0b871c14f86592a445911b20b21ffb27384f7df2879ddd9550b95e64543598c3,29174857259
20190124,"PAYMENT RECEIVED",1255413327,0,c27575c1d501bd08a16c08ceefccb87a41d647341487b67f6a4ef08fd6bc6f0a,27915529373
20190124,"PAYMENT RECEIVED",1286294298,0,ff0db475b7236b1154cac0e0b54d9f4c95027d25660f7b0da8b5583c60417e34,26660116046
20190124,"PAYMENT RECEIVED",1257605341,0,d8229c541e744086c51837d8fbd1e7eefbcaaf34611a91f81af867d1c8055e5d,25373821748
20190124,"PAYMENT RECEIVED",1276749186,0,fb1b400649aa673d3aac1d006229cd1e548eee272ad25f1dc4276e8954b4c97e,24116216407
20190124,"PAYMENT RECEIVED",1267847812,0,00c5ccdbd3f100d0cb0e2ed91f682337204db1b4349fe15bba934e61ef88dc32,22839467221
20190124,"PAYMENT RECEIVED",1300151806,0,374615cbe8cf0a5ee905f229c05043f4cfdb858a32c37702a84458109f852419,21571619409
20190124,"PAYMENT RECEIVED",1251276860,0,2c2eb29717e8efe162ad9072d27a18e732d81674d2a05e32a2dfdd09f1f57ed2,20271467603
20190124,"PAYMENT RECEIVED",1262350053,0,dacecaad1fac2fce2bca117e62c5623a52f3f3059086fdc243337f18e1b688ee,19020190743
20190124,"PAYMENT RECEIVED",1269565034,0,6e92187c29660d40685e12723ff7b74cde991c360fbd44553cbaf40c739cc148,17757840690
20190124,"PAYMENT RECEIVED",1267255562,0,716b5fd844ef4c4b4aeaf3d61990a0b7133b9291b8bf7247db3232ec7721f5f2,16488275656
20190124,"PAYMENT RECEIVED",1256112995,0,60869da81c81e91f03bdb3e5d252d7e1042545ea8b8b35a531688226e37595ce,15221020094
20190124,"PAYMENT RECEIVED",1250942664,0,f5f9af92dd3e9b5bdaed5fe65328e0ae3744cf467ce30ed48b4dc2b48ece9afd,13964907099
20190124,"PAYMENT RECEIVED",1285076895,0,80e92518fe12346195ef735b0ad03c5d1edb3f828cfe09cab12ad45570f99aa4,12713964435
20190124,"PAYMENT RECEIVED",1257789787,0,21605c4d526c6706bf4f05a99faa9ff4d43ed1b3f00ab3b6cea6d0b5527586c0,11428887540
20190124,"PAYMENT RECEIVED",1265134896,0,1b20b88fe8a94bc722abd72ee872b6a4b15e1dd0de169940c0b81007dfc7ae7a,10171097753
20190124,"PAYMENT SENT",0,-25424262561,850fb143c097be79dc7a748a96448c10ad0e758b7677143ac05fb46fd96e0fbe,8905962857
20190124,"PAYMENT RECEIVED",1278474234,0,05abf394db8c08cf16ceb32163edb0879738a4053463b36b9ee684ae1ac15aa7,34330225418
20190124,"PAYMENT RECEIVED",1254467989,0,0a501bceb3151fdb148b01e62ba49064a07c2a196257398c7114b934ba5e5b68,33051751184
20190123,"PAYMENT RECEIVED",1288897224,0,41134ca869f9564e9e94a2b6579d1a000805cca726e8ca68caad833498e51a0f,31797283195
20190123,"PAYMENT RECEIVED",1274995101,0,8bd3d35e75e1caa4e2808e9888dc83f267855c7534007530a4b832a5c8590a40,30508385971
20190123,"PAYMENT RECEIVED",1278237610,0,4aedfb99216b247359a746d546b69b871ad2020e71b0c19d596dd127a5fea6da,29233390870
20190123,"PAYMENT RECEIVED",1268238582,0,4aa07f21a7c9908ad9f07c324eeed66722c02f206ad3b08591cf96aad8f200a7,27955153260
20190123,"PAYMENT RECEIVED",1262651025,0,f8b01dc60dddd8020e9ef8fe6c033a399be78ea6d2121c6bc329230161e42525,26686914678
20190123,"PAYMENT RECEIVED",1256111609,0,f705286ecd0634da49cd2233e18fa84e4114686478e2315f0e464ca909523d78,25424263653
20190123,"PAYMENT RECEIVED",1256318567,0,efcd9e4da39b24bb8852ce633f172d13aa009d34841f45062c82eac26813e000,24168152044
20190123,"PAYMENT RECEIVED",1258215083,0,8a3b40cac61a9bbddbc56683c664b428ca434f6ee3d50112a6c8f433f9c5cce5,22911833477
20190123,"PAYMENT RECEIVED",1257260723,0,19c5ba2ee51e9829ce4c55a47da5996b1421621fca21a4d36da7e63657c8c0b0,21653618394
20190123,"PAYMENT RECEIVED",1259283278,0,332ddfc0e1c7d0915e771f96d1af2e6488a4d7fad9256b655eafb85fe9c4ac5f,20396357671
20190123,"PAYMENT RECEIVED",1270124075,0,533b6611755fd720f5dfa4524c1daa9299ac5fc65551b734fb7c259063265760,19137074393
20190123,"PAYMENT SENT",0,-25222692855,5add39aa75fc3c960fae2673b1ba4731c698540283e84b1aa98bcb0d6f957ba3,17866950318
20190123,"PAYMENT RECEIVED",1282889103,0,1e1a5788dc5bc135a2e3569b61e28a811409d5fb3d10b1360f6df81c0cf8d5a4,43089643173
20190123,"PAYMENT RECEIVED",1257180802,0,d7d3c16a8b0d7f2d35c66230eaa0b3b5a5af6f7f20e1c5e9fdb7cb677e3bc78f,41806754070
20190122,"PAYMENT RECEIVED",1268021250,0,8bd86e8c098e1b4891618c9c1a62536704f1647b202c756ef971944306073399,40549573268
20190122,"PAYMENT RECEIVED",1302766938,0,9162873b8abf407047d10a5c163140e848a7387294cdf17c37e577bcba506e5f,39281552018
20190122,"PAYMENT RECEIVED",1274223666,0,d593a4feff9253e56bc9fa9da0a08ccd42d7fba2b2e11503b8584d0a28a409e5,37978785080
20190122,"PAYMENT RECEIVED",1262267279,0,704084abe5bb0176b992919fcdca79f653efca84c12a7c6a10714a59294f4820,36704561414
20190122,"PAYMENT RECEIVED",1262416359,0,e5967edf919ff54a91b2853b1accb6ce5e8299d2a5158e6605e1fc2fa2b2dea0,35442294135
20190122,"PAYMENT RECEIVED",1273435549,0,9ab6875b992f84564c371b403699817872c8ad363e32a9abab149dcdd2b399ac,34179877776
20190122,"PAYMENT RECEIVED",1263361134,0,f4a8bcb92722723578a4fdef1808cf7b9ddc9e705576d8d18b655f0168ee8bd4,32906442227
20190122,"PAYMENT RECEIVED",1266972513,0,a070b54eafd69cce7694e8ac1b71915d07b5970ef499d43a3eb50cf81e52e107,31643081093
20190122,"PAYMENT RECEIVED",1329092933,0,0c48e52f10a4d469073750ed90d50ede477311aa6352a2ec04de3204c95a0bd8,30376108580
20190122,"PAYMENT RECEIVED",1292122581,0,5b802300b02cdec43694b688579e962129d605da4c444a6cac7f14fd2b636b3e,29047015647
20190122,"PAYMENT RECEIVED",546,0,4d02b6c16023454f1addc891d7552f4826386d4c56e69c30c157fbe63270470f,27754893066
20190122,"PAYMENT RECEIVED",546,0,2f758826e684d1b4a756abd0ed144d4481ad95a53e4a10a75bfa90e5255793bb,27754892520
20190122,"PAYMENT RECEIVED",1260374493,0,3022a90ddadd6283b3534f0464cb13834f9360f68f1ccf7aed675bd8fad521e4,27754891974
20190122,"PAYMENT RECEIVED",1278116692,0,682e5eebec7825acf0fe7b0e25e1c1adba8433697a82e31b269d0294f47d6e17,26494517481
20190122,"PAYMENT RECEIVED",1267538271,0,e2aee85069302181e6e7eab161df2ae1efc3a22c17957ce15fd0961bf8c38425,25216400789
20190122,"PAYMENT RECEIVED",1251170024,0,5b935aa64e8b7cb181b82b717f3755be2ed5ce9ae74d2d260412dd6d2bbcf630,23948862518
20190122,"PAYMENT SENT",0,-20188030844,d0f8b01077b24d4005b5b65c1c38531542cedb62f389a4ba1747b547a463dd63,22697692494
20190122,"PAYMENT RECEIVED",1261543317,0,589e96e8cbb5be5ef6852f1961ab78449e396b54f19d43a7672d9ffa89df8a41,42885723338
20190122,"PAYMENT RECEIVED",1250460416,0,06c4915f180679450a8d222c8cb39d3fb6fdc7cbbb8df66a2bbe25944e6343ee,41624180021
20190122,"PAYMENT RECEIVED",1250843932,0,9a333f4270daae7c627f8fc38d1ea7f2ffba3478f3e22246d20fb33080282636,40373719605
20190122,"PAYMENT RECEIVED",1250259193,0,39c63d8bea3e7110a33cba232815c3c5ee1dceaac269a3f8af0c893da6c39226,39122875673
20190122,"PAYMENT RECEIVED",1262515395,0,c31faf871dc265d4e4f687855a6d1d904de753a57258d248edc83de81c5ed2ea,37872616480
20190121,"PAYMENT RECEIVED",1261137540,0,bf460ef081525202dbacb6fc127561043eab5735e593ff69b92e7e8d87db8be3,36610101085
20190121,"PAYMENT RECEIVED",1259290565,0,da014e6fbd594c6e782f57388362ec1efd75c1cedc32f638f30dbbf617ef7a16,35348963545
20190121,"PAYMENT RECEIVED",1257064290,0,9d1f72a4a7ec8bd2f24ec81e5cb2e65cde34fa64d43e5abd9e4c617fbf898314,34089672980
20190121,"PAYMENT RECEIVED",1277489889,0,98fc83ae2c1182955987d0de0f5a8e56babca05b8e173fe1145213de12514cea,32832608690
20190121,"PAYMENT RECEIVED",1259116287,0,28764ec8bf7842f69748432b0159d0173b207e48578b55c6b232bafdfa439910,31555118801
20190121,"PAYMENT RECEIVED",1264976508,0,6a9274619550c94d7c65411de22b7e26d1d2b10ba494465748ea89c65c98bc32,30296002514
20190121,"PAYMENT RECEIVED",1275616560,0,62adb8f4b33708200268bc0fbab43a7651aeac82a92640711a63f09195ffc829,29031026006
20190121,"PAYMENT RECEIVED",1256858538,0,9c988f3b2f00b84ccef58e5183d86a97de8b10322730680f8f721cd884310450,27755409446
20190121,"PAYMENT RECEIVED",1275181468,0,d6cf76652ec6e40817c8bc2cce24fece8ffbdd6c94046130a5b0bee97a47f4bb,26498550908
20190121,"PAYMENT RECEIVED",1252303886,0,5241a92bda0ba2b7d1e8c9757dabce9a3647905e1693636e01739e5d805d0955,25223369440
20190121,"PAYMENT RECEIVED",1252433529,0,64d6a415597465d6164ab23d9ba5506b1cf977b6bb370a47c94734c46249d9f3,23971065554
20190121,"PAYMENT RECEIVED",1272908554,0,73f2155c6f13b3d381c7c0ddf7d55bdf7a2ba52280878f43a30a6f891241496f,22718632025
20190121,"PAYMENT RECEIVED",1257692627,0,a307f493ec17c91822fb25f32bc586880a413d3774bf3c5790df3f7a09e34be9,21445723471
20190121,"PAYMENT RECEIVED",1252214399,0,a3e2fd0d02f31a1c681aeb07e053698101b4bc0aba616d780384526def932afe,20188030844
20190121,"PAYMENT RECEIVED",1264588390,0,c3db2938d255336025dc9e0a03831e39270f7bde3ff87d4d1293a22647b16c3d,18935816445
20190121,"PAYMENT RECEIVED",1259318161,0,406300c652d6b90b73a3b40d4f8dc06076529de43ef115564847d34203f0462f,17671228055
20190121,"PAYMENT SENT",0,-24036666059,6440e7e2fde65f2a555dcfcdf79de75cb512562e933c82b7f609e87160d70a55,16411909894
20190121,"PAYMENT RECEIVED",1276943243,0,5a80b56f13bd7e492672429cbd62e90f9614d62ad8453f367c176d8fb55c6a32,40448575953
20190121,"PAYMENT RECEIVED",1275579305,0,337c29d07601f07ecf696f11ad1d2e52f0c912cad49ac1b8a45d8ebbd5c0d792,39171632710
20190121,"PAYMENT RECEIVED",1255720504,0,03f36e4d708c9dfed1d58bede9f3c4cc4ac0f5bdbd57a481aec62e93f2f41c37,37896053405
20190121,"PAYMENT RECEIVED",1252059300,0,ecb7346c8bdcd91cdc53252c7d947f6b0288931feb21f4008db68923c1caccf9,36640332901
20190121,"PAYMENT RECEIVED",1263612132,0,7f928294ec167bc8a4e614b4d00939e5901a9d5ceed5bb24315f248ef7a765f2,35388273601
20190120,"PAYMENT RECEIVED",1268299645,0,01c3daf6bb4015d8b2d8f07622fe14c8520029c2cfbc157372c9c6e6313bd88c,34124661469
20190120,"PAYMENT RECEIVED",1255644467,0,609433d71d8ba0559ff5de8166f42cdab3c6c7404b86d24a045d33d62c673c3d,32856361824
20190120,"PAYMENT RECEIVED",1265422403,0,43b7cad0e4431a9d44bea24e0f6f6f36a77709020a56fd41d265b652aefd8f70,31600717357
20190120,"PAYMENT RECEIVED",1261371910,0,2502fd50d2ca3137d54e2e9c2c4b6fc48126a503afad2558163995ad3d054af6,30335294954
20190120,"PAYMENT RECEIVED",1262789876,0,259882e828d879637d2d2c36094e5ac7a739013c376a053dc416bc0fd7780f32,29073923044
20190120,"PAYMENT RECEIVED",1259071232,0,f1e1b1ebd9f5d1e7223fae4d746e583e42005b5359b7f4c72f2ce726b0f4973e,27811133168
20190120,"PAYMENT RECEIVED",1260250231,0,d931c9bf5856f8c3d52cac55d826071d7ce3953814d59f6b1270928788998655,26552061936
20190120,"PAYMENT RECEIVED",1251851588,0,5951eccab1de842396c63e95033d69489b5f783490de1ea7952e98b873ce6853,25291811705
20190120,"PAYMENT RECEIVED",1264765681,0,988b826180193b4499112d3d1d56b50884e175b107ad28f7cfc99bd23331ec03,24039960117
20190120,"PAYMENT RECEIVED",1255145646,0,2c12ffee41535322fb9a737ee12204fb4c17082c5440b31060140b66a15373ec,22775194436
20190120,"PAYMENT RECEIVED",1254628152,0,936c473d936d8ccbf8e94367d88c3ad720889db4e61582574f753f7055f93c1d,21520048790
20190120,"PAYMENT RECEIVED",1252864707,0,5549728ce6d6a3f4122835bd909804af27b2120a33f8a09598aae7cf6ddd1f39,20265420638
20190120,"PAYMENT SENT",0,-20185128675,1f4dc2952cf3de10b5c08336724bedc9ca67bb25e3c1c8f10f21d8ce00ce6ecb,19012555931
20190120,"PAYMENT RECEIVED",1253421489,0,eb631b61a0ef59ed62375223cfc6cb89956be671766438398c12b98579c8a20c,39197684606
20190120,"PAYMENT RECEIVED",1253531243,0,a30cd47239eb5b7b7798c79816977143e35c83f3f6e67e417988f1cde8e55ac2,37944263117
20190120,"PAYMENT RECEIVED",1255144852,0,559be63425d3334e56c39cf1670da2e8b36ec5a640dd76480da9a55d05b1825f,36690731874
20190119,"PAYMENT RECEIVED",1251604083,0,4563ccec9ec1bd86b069abb2319d92fa5540e3da36f68df838cbbab155c9c8a2,35435587022
20190119,"PAYMENT RECEIVED",1252589156,0,d1e8e92497ff7e76c0fac079da6816bbed882d019e10280e49815a1043f42a05,34183982939
20190119,"PAYMENT RECEIVED",1250017561,0,6e7242506eddbd62013d751decdc0cdced74f9fde7e93047694a9ab31578d19c,32931393783
20190119,"PAYMENT RECEIVED",1302007274,0,739f066218cde2fa51204c1607f09ba07402cf5b6cbe4522fa37ce1029a936f4,31681376222
20190119,"PAYMENT RECEIVED",1261252483,0,4f6ebfb8bc4ef8d50a278c3b9e9218480a751876260b7a21551be0c51d68c304,30379368948
20190119,"PAYMENT RECEIVED",1280537763,0,1ee0096921ddfe46652c8a65fe285ac87b3e390ce4528012cdda86a4f8579dcc,29118116465
20190119,"PAYMENT RECEIVED",1264457351,0,4eceda7e0fcecebbb0f0bf0d4b40ee4413587a192329dc13bd4ae00e9daacb11,27837578702
20190119,"PAYMENT RECEIVED",1261672212,0,f9f072f2f9f97ed29854424d82da1bf538b4441b51bbcc51dcc10f93b3ee145a,26573121351
20190119,"PAYMENT RECEIVED",1281003284,0,218277d729ec7ddf3d2f6d1ca3e6a6860f0cb7afe0f2bab523d80b8771bac241,25311449139
20190119,"PAYMENT RECEIVED",1261241383,0,352449de680c57bb67deaf6a4b639cbc9fe7acdcea75f55c5cc95c806b9c61a6,24030445855
20190119,"PAYMENT RECEIVED",1267074886,0,a5cd014cf3dd838fe775937b86a98d6d3026b36afb55ccd9f7551c0b55e535c4,22769204472
20190119,"PAYMENT RECEIVED",1266015643,0,eab98dcfa5cb9aa03251f34adee1896a6262a695fa16c407e56657368b15f40e,21502129586
20190119,"PAYMENT RECEIVED",1250372836,0,2037ec3d882a5cae144bbaaac058cedd850259652bdb86822c49d049c8f035b7,20236113943
20190119,"PAYMENT SENT",0,-20335352273,b8e86d95640658c9469b5088ecc4404a0b94304c926c9f9c156dc6e65e73fdc5,18985741107
20190119,"PAYMENT RECEIVED",1252640074,0,4f1e78051bbc0318f2d03fac7bf0cc44f1c96709aaa5c63301b5b16b94274203,39321093380
20190119,"PAYMENT RECEIVED",1255336455,0,f068678bb137f80a501177426f5705dc4191cb3b20a462539365e8ecc06baa21,38068453306
20190119,"PAYMENT RECEIVED",1261732832,0,adba0486b974d7213ee18b86610eb1723cb67a0a8cced7213e7beada4d08e763,36813116851
20190119,"PAYMENT RECEIVED",1251466684,0,b6ea4844f736615530eea00dc18ce57d9237208f9a55f5b6d232659f744676e9,35551384019
20190119,"PAYMENT RECEIVED",1253223845,0,b9951cdc87802520ef89b707338bfc5751fbbc20d0f7f8b7bd95dfbb2820c9cc,34299917335
20190119,"PAYMENT RECEIVED",1261365034,0,2965c362fc600b2cf0b7b34fad50131697a144df3ac8dac440427eed1746b1c5,33046693490
20190118,"PAYMENT RECEIVED",1257293477,0,00e88aaa7e30ea7a597702b17b2b3a96b8c5d0048b67d63bf1f15018aba05041,31785328456
20190118,"PAYMENT RECEIVED",1260930952,0,27d1852d328f91a3ec764c8e2d4a7ba2aaedeae8c5c5e3d447dae076b1ba8156,30528034979
20190118,"PAYMENT RECEIVED",1268680397,0,585714ce5393eb797b62cf2f8c3e27f3792aa50ce02e26ea6864ae9c2f08ccb6,29267104027
20190118,"PAYMENT RECEIVED",1269249733,0,8a4b29a2e69d435fbcd1222fab590bd813534d58623153eb0bb1c11c1ef3bacc,27998423630
20190118,"PAYMENT RECEIVED",1266645201,0,26474b2c94ab59df56c74515820bd72a8d871b9489a5b91d0deb05a709a8956d,26729173897
20190118,"PAYMENT RECEIVED",1255799197,0,44da625a3fae810062623441787021d29bdb45c5aa7988737d482108206b9c30,25462528696
20190118,"PAYMENT RECEIVED",1266172611,0,ea3c556cac07ceb89c4a61ce49f3e1fd7baa55e16d6459c7b3533be52ad25df3,24206729499
20190118,"PAYMENT RECEIVED",1281777242,0,b8ae4db7347c61ef9e702f5fc7aaa1ef7f411d777d3fc2913b9e18cf491ae3bd,22940556888
20190118,"PAYMENT RECEIVED",1323427373,0,0b26e5494f93feb6d3a1f15217a3aec9a3113250e07ba6af89698fe6a8d4b66b,21658779646
20190118,"PAYMENT RECEIVED",1265740498,0,6efd45ee9ecec7295fa9e3b5a351a9064871652c02bb5c9c01afa3c5ff89d29c,20335352273
20190118,"PAYMENT RECEIVED",1265055637,0,78412a85253a8d5b421a15f3a6172586d45cef6340a3e5bbcf13ebdd47d7d967,19069611775
20190118,"PAYMENT RECEIVED",1262094053,0,9b6cf669080365b34c32924db6da1cf8e69f9cf8dc64472a3f7eda18eb8903bb,17804556138
20190118,"PAYMENT RECEIVED",1282564710,0,9c171717f2bee8ceb631c0f3026636aef3e7a0db20c7ae4af51d2670886b1dac,16542462085
20190118,"PAYMENT SENT",0,-20303228704,2c0948bf975b7f28939bc6d682f8fb5a3417308ba0236a0106fefe83f9deb01f,15259897375
20190118,"PAYMENT RECEIVED",1286054251,0,d1a300b711f1515c84bcf42211bb36403ab8a511933cc5e676244f6e9fe30784,35563126079
20190117,"PAYMENT RECEIVED",1256557205,0,e87343f7a62828fb65ac5e226d828c0fd7977707520eb0f9cdc401999a3dd7f7,34277071828
20190117,"PAYMENT RECEIVED",1267103492,0,80b89b30591fb9d70c3f80972eb376c9188e1cba3924eaa5eb762d952c38d08c,33020514623
20190117,"PAYMENT RECEIVED",1271157630,0,5a2cd8b3994406c8ab2932a4db1eb303353816055a7be4a70fa94ca194ff2c28,31753411131
20190117,"PAYMENT RECEIVED",1252734790,0,c4113cb2818e2e8879286fca473453bc9230814d21ec4120fd3677e8794232e3,30482253501
20190117,"PAYMENT RECEIVED",1271759563,0,b57723e91c528ed9650a580ef51c7f319ee70c4ab2d1a8abd2dc2d6624af1bf5,29229518711
20190117,"PAYMENT RECEIVED",1287522867,0,04906edb237b88fc0092a0ced373fcaa53f71d8ec7d7e158f8522f6e8ed2119a,27957759148
20190117,"PAYMENT RECEIVED",1276956709,0,46b2273affc2d04c53d0f2fb9a6fb55dbe3e0166b77c86f4061a067d42cdbe8a,26670236281
20190117,"PAYMENT RECEIVED",1261601895,0,5b0cc13b7cd2406a14786cedc5ad65d4001caf7eb6e29441de8f4ab6fe2dab93,25393279572
20190117,"PAYMENT RECEIVED",1253256889,0,008e744149627059cb58c015cd6818a9e0e34f2e942b991f667b556b772dd938,24131677677
20190117,"PAYMENT SENT",0,-20171265534,022380be2e32c28607ff8f1148d13eb2626322a971db3e7a5c2687fabf7eb5ec,22878420788
20190117,"PAYMENT RECEIVED",1258833126,0,2e92bc2f85fd381be0b6c1234c1ec9f190ad8833a9eeb1e311f0a530f195b823,43049686322
20190117,"PAYMENT RECEIVED",1267298488,0,188825a61e6fafc6c64effe6304144135f544c0026c33561d33adbb386f0b796,41790853196
20190117,"PAYMENT RECEIVED",1274954088,0,4653f175e528e339a9b7c6f4df084f3f24b13e0cc6d1a6f5dd7bd147c4cae5d5,40523554708
20190117,"PAYMENT RECEIVED",1287019982,0,364b1c2b91371992ce364655378f1a6976169a4a5b6a9783bd67692e0e59e67f,39248600620
20190116,"PAYMENT RECEIVED",1260008229,0,2ca8532afee615990e77b0da228f62eec54c84902730c81725b7a4f35c9b67bc,37961580638
20190116,"PAYMENT RECEIVED",1267098913,0,5c81656df4f0723355e9a8eda2dcc0f88ac0a5f2ca096bbb18a2db8fc3ce7366,36701572409
20190116,"PAYMENT RECEIVED",1268445140,0,db04e2d1c6cd5d90de6bb8a69052e0d55db5302ef4f973d665c8d3593137b52a,35434473496
20190116,"PAYMENT RECEIVED",1260758435,0,24ba054ae9ad922af509888579f219dcbd67fcf59e69968b72f5b436f8aebc7f,34166028356
20190116,"PAYMENT RECEIVED",1258004332,0,6fdc3d27904849dc817695bd0dca821375f3b225838d53fe5760808cb45f5589,32905269921
20190116,"PAYMENT RECEIVED",1259207457,0,236ebcdc6ffb5628f7b442c444b1deb7004f83354dc47f9311b8ad7d3a9271df,31647265589
20190116,"PAYMENT RECEIVED",1259746792,0,da5c94f4ae1b751bccda5609801eed1233f9c50fbb427321ec504e322dac2dc2,30388058132
20190116,"PAYMENT RECEIVED",1278760488,0,90d048cfff6fd1d56573f6ba2d129355309e98059c1da7f8946b602e1b5f9ac7,29128311340
20190116,"PAYMENT RECEIVED",1259646688,0,c64edc979dcec0734f03b0836b51d53eab1ab7118120b4fbdcd1c477271268d2,27849550852
20190116,"PAYMENT SENT",0,-49287942179,7d18ae75890752934f5ccb901e469d0b4182b51407e7e77adb650168ca920f73,26589904164
20190116,"PAYMENT RECEIVED",1262295562,0,098005c06e099c5c2528ff2a6450da87778d45cdac392ff9c5f45c4c814fec62,75877846343
20190116,"PAYMENT RECEIVED",1266726706,0,efcf570edd355a2100d297cba5e3185c418f61a61c97e0388b78dc5a63d5a9c7,74615550781
20190116,"PAYMENT RECEIVED",1273867114,0,3fe6ecc1f2b57b7adb1d4f80c03a069e024dd1945cca36e29d5aaa1039771751,73348824075
20190115,"PAYMENT RECEIVED",1267198682,0,15d0f512c673d04bee5a50da505ac033d9d23ad58eab98b475d73f40da57b3e7,72074956961
20190115,"PAYMENT RECEIVED",1256892325,0,844f8f0df71b501e707a5d6f20a481bb86409df95ea0ac6ab304deb8dba5d6e7,70807758279
20190115,"PAYMENT RECEIVED",1264226387,0,55e243bc64a0e11d6753c9564f6526817fd5bb5cd4f446cdcecbbdbebe3210d0,69550865954
20190115,"PAYMENT RECEIVED",1257983256,0,f0c73c795836dda483a7e86e409f7df8f0322f14ef7b1516ae1cb7c5ad446cf0,68286639567
20190115,"PAYMENT RECEIVED",1260831175,0,3be58b966a3ae855590681fa8e2955bf26f1c4f559688be18128d85341e611aa,67028656311
20190115,"PAYMENT RECEIVED",1273558716,0,364f03578542b2f51205c8e76b0b65196ff3de150a10e40a24e1b0a9ca1baeb5,65767825136
20190115,"PAYMENT RECEIVED",1263407710,0,f2c1eb960040360c43a056a21885f254c62b030fac63e08dce6eaf15dd20f8f2,64494266420
20190115,"PAYMENT RECEIVED",1295418357,0,0df76a98fbde9ecfdcee3bc398310a0a0029adbe77e798410f2abf2dd3c72b1a,63230858710
20190115,"PAYMENT RECEIVED",1283310569,0,c82b9cb69a9a07a840839aa31aa9ded0e03ed59d143ff239bcae5d58f3760ca5,61935440353
20190115,"PAYMENT RECEIVED",1291881515,0,fed51df7cf5906c174d1bccea2cd70102a3ba62b8ef4baec949d5dcbb764d2a1,60652129784
20190115,"PAYMENT RECEIVED",1253123041,0,9c6abac35fef45dd809cee3c9199fd7508a8a058897b9e4efffe75cf3931de67,59360248269
20190115,"PAYMENT RECEIVED",1264757265,0,9c4271855aafa82b5af5d9233367d1b2807c54526727ad455fede288ed541bee,58107125228
20190115,"PAYMENT RECEIVED",1261777783,0,4addede79fed50699f9558f8826290f087907fb77235380ded93458422c67eb4,56842367963
20190115,"PAYMENT RECEIVED",1262685125,0,578a066f7936dc6fc522a23f35acb8535f889ea4af422112804900966cb5d9dd,55580590180
20190115,"PAYMENT RECEIVED",1257034664,0,7cb11146834479af88869af3927d45848519ab2d39be96e6ec9721d1be150541,54317905055
20190114,"PAYMENT RECEIVED",1277591917,0,0bba94a9b3d0f3df6b1107dfa01b9e4e76413f1d1a7f84164ec17d05c7c4312a,53060870391
20190114,"PAYMENT RECEIVED",1254033169,0,24f0c76d52a1379badf22f87a3941e6349c9beec35f443db41459cad3c2f0f50,51783278474
20190114,"PAYMENT RECEIVED",1268546754,0,b4e8a1b869adcbae2b18553c0fe811ea4d1767a5d8f08873edc54314be4c762e,50529245305
20190114,"PAYMENT RECEIVED",1273541560,0,6dc8e77dac8cf2e34fcd96a41370f2ae7f57ee9fe65a361b0bfb516632a5db92,49260698551
20190114,"PAYMENT RECEIVED",1254604854,0,cb24ba4fa3ffa16c9f2f5a75ba78b2e220110ddbdb17973bd3f8ab8f0b1c0241,47987156991
20190114,"PAYMENT RECEIVED",1254838312,0,1b3d963e68c465b53db00f7d8d18f7faa7243a80292ed1685d90b11ea2db27fb,46732552137
20190114,"PAYMENT RECEIVED",1259438071,0,f9f3d8deed6ce0d60182d322290f79f303f57034359af8f127e29b694b1b65dc,45477713825
20190114,"PAYMENT RECEIVED",1255994980,0,d94cb74f1beeba20b631adf389f02aba5044d9df995a7f72eb885a3d94132afd,44218275754
20190114,"PAYMENT RECEIVED",1251026370,0,b4d1149b082e7dc7bd5f78251d0b6f2cacdeb2a5183c5397ffb0e075caab4eb3,42962280774
20190114,"PAYMENT RECEIVED",1259881385,0,17bc6a7344ca1d74dd48abc7631e24158e1d012cd525fe68c4558a455b22f341,41711254404
20190114,"PAYMENT RECEIVED",1274021681,0,4553c32ca5b6edb93dd84111ea55269c0b9fe8e27ea05f9a31eef85273c3887d,40451373019
20190114,"PAYMENT RECEIVED",1259443700,0,246fbd99986e2f64dc01689db7612fb31bbf0fb61736f46e859ba77388da5ea3,39177351338
20190114,"PAYMENT RECEIVED",1259927154,0,3f86f21b73e3d42ad95264a6384342f59804654fc828721b03d43b5efd1e3e7f,37917907638
20190114,"PAYMENT RECEIVED",1251716856,0,4af85465f6b3e796beb0191c018b4652fa54b6156fa27e0e3b1bd56ae845c162,36657980484
20190114,"PAYMENT SENT",0,-50577700724,875fd58599f511e52773b571780f9a6072da1573f0a15011348ef4a0d49930e9,35406263628
20190114,"PAYMENT RECEIVED",1274035888,0,9d28db9859713fa4bcef0d68a42352f9c77e7f63c9932e77c408213ec15fba54,85983964352
20190114,"PAYMENT RECEIVED",1251280040,0,653e6e5cc7b1c59c7cef6fac1bc19eeecc18d9c072739a97fb8175bda3620f91,84709928464
20190114,"PAYMENT RECEIVED",1252571032,0,d64ab803542e815a15d46a03751713dbc867426de6906dfbb1ad3b71a5a69590,83458648424
20190114,"PAYMENT RECEIVED",1259113760,0,7c6ef76634326a91c4035accf5e434e699017f6428e3699dd87bf37a13a0300f,82206077392
20190114,"PAYMENT RECEIVED",1254918021,0,58a8f7d66fc85948e79ed0b126f9e001e5386092725e4a5c9f99b86d74aa0e63,80946963632
20190114,"PAYMENT RECEIVED",1267441586,0,fdb232b4203087e4432c8357ec5906343853c70659daccdb96fbaad4c3d53768,79692045611
20190113,"PAYMENT RECEIVED",1250073735,0,03097611de4b6e945be3cd92d10de01f20b03f691abddcc7245ddefbd4bcabfa,78424604025
20190113,"PAYMENT RECEIVED",1266079560,0,d4f4a8f00b2e98e78e51cc2f8a752e09ea793ae2ababfeada3336256b0d70171,77174530290
20190113,"PAYMENT RECEIVED",1287001183,0,0020e65ba9131dc34d30fb6b71d641f24e978c938065e0e33d9048fe5fe46dd3,75908450730
20190113,"PAYMENT RECEIVED",1254986215,0,2c1b8977f9b42ddd00cedd4708206ba40a1d5ba77792cfae8973411dbfd5bd09,74621449547
20190113,"PAYMENT RECEIVED",1256156235,0,4687ff54575a835ba749a5acd7cc5173d2ce360fc8a6e34d10d13a1fc92ac147,73366463332
20190113,"PAYMENT RECEIVED",1267739429,0,60369b6d1c5380df07bcef9c6d12df0ca87fa1b3105a898aafc4b1b77214ae7f,72110307097
20190113,"PAYMENT RECEIVED",1294520038,0,debc409352635cd4dc2cb0a416618629d06b406a7be1ee6ece4e725bd3d99f19,70842567668
20190113,"PAYMENT RECEIVED",1250723684,0,cf2e617955ae5225d57b586d184cec4e49c1cdfd906b79c5e679509d902e4fea,69548047630
20190113,"PAYMENT RECEIVED",1258809190,0,b316e64be114af4f3f5d06052b25969ea9f49aee159dfcadf739524d0b5c4cc4,68297323946
20190113,"PAYMENT RECEIVED",1261868581,0,3a9ef9666d9682b99226a0263f1c9052b9cf14ebfb10159dc7001f8d158b802c,67038514756
20190113,"PAYMENT RECEIVED",1250088350,0,7b860e5c500310cc1739233bef69c3a3519a98ae15f79c6318c653487f783310,65776646175
20190113,"PAYMENT RECEIVED",1257543806,0,35c4d1aeadf402e4ab15d6df887984b3a382f79c77eb2721c510f74479b36da9,64526557825
20190113,"PAYMENT RECEIVED",1258836675,0,c76d0ba302b1eee3b352e4336b34d9be5b41e37a861d05d755056247ddfd5086,63269014019
20190112,"PAYMENT RECEIVED",1255277762,0,8fce0b0c243af4dfa21f09a776ef840aa5ca97532c671e222c2882e4e134fe2b,62010177344
20190112,"PAYMENT RECEIVED",1291332184,0,de59356c47785523d0cc65a9a138911d8a2713e4137f099b422f849aac04a3f9,60754899582
20190112,"PAYMENT RECEIVED",1258426310,0,5d890dd82e9e9d1953261c53dae81402664c950e08ada864583223b95d2390b9,59463567398
20190112,"PAYMENT RECEIVED",1263915683,0,cf63b01ed24d6d6fa7ebf70ebd95065eec273c51563e3831d6b2b72c89dd122b,58205141088
20190112,"PAYMENT RECEIVED",1260679764,0,708f0fc02daba66e16b8bc97d76a86164fab8bcae928720bad33745ae9ec59ab,56941225405
20190112,"PAYMENT RECEIVED",1258769125,0,d59ba7c563398cb7a138e6727d4ea079210018b55487ed07eada5e900cd4f43a,55680545641
20190112,"PAYMENT RECEIVED",1260268565,0,3ffde52911f82bb9991f05f0226db791a7eeb34cf883abb555c661d2d4b38cfa,54421776516
20190112,"PAYMENT RECEIVED",1316955988,0,5fff0721cd94d2f36a1cced1a075c2add4bbf5988fd994a34dbf2a146aa6ec83,53161507951
20190112,"PAYMENT RECEIVED",1000,0,8b527980c029123a4bc48f6d793994a1947526382cfeafd4c5f7e041971551fe,51844551963
20190112,"PAYMENT RECEIVED",1267161145,0,3b207ad52875ec266088ec3d0350d390ad98cfc56d70c5f10261ee17556e6eba,51844550963
20190112,"PAYMENT RECEIVED",1267426000,0,04e448c695e983f8bcdd285ea5efd5ae9f13e3391104196b7e26459fbdf07b04,50577389818
20190112,"PAYMENT RECEIVED",1254777549,0,4d338d24a52ed0af196c6cd73a273d3c8d2a4961250b930a8185ea59ad1efdb1,49309963818
20190112,"PAYMENT RECEIVED",1251914336,0,a016ed80fbc1e61b262302698bad6985494db550d7b4651289beee5944b5dc95,48055186269
20190112,"PAYMENT RECEIVED",1251914598,0,adadff4ee8c388e5e803e8f747dbc561355b08468199fd852435425a950487b9,46803271933
20190112,"PAYMENT RECEIVED",1256509467,0,c8c2dc96b530c12b7b7950ae9a2cfdb5a32670f290d72b246ccad84e5d3a84b6,45551357335
20190112,"PAYMENT SENT",0,-49400915564,3e2cbc41db09a57180d4746762a2defaf53eb2d465121d879b3e0d04f82d5c57,44294847868
20190112,"PAYMENT RECEIVED",1297319647,0,1065bfea053385245958b85e99887491ef3a459721cf5ffa4eef0242490c61de,93695763432
20190112,"PAYMENT RECEIVED",1261697808,0,05c181bb240e31172ae8c802fafe675e14581362a6e7656f170a76daa5fee62b,92398443785
20190112,"PAYMENT RECEIVED",1268482189,0,b84b6e3653f1c16734ea08146825c905218a8574ca77fa8a6237d90c3f21e8ba,91136745977
20190112,"PAYMENT RECEIVED",1252749934,0,1085be557ded8ad5cdd73cda0f2b7fa511f59f3f576f770f83a948d036dea8c4,89868263788
20190111,"PAYMENT RECEIVED",1254065512,0,d3aed0bf39dd0e336390a6ce57d02db55873e74ed43a625506fcc4ddb27562ce,88615513854
20190111,"PAYMENT RECEIVED",1253354041,0,edacf04e8ca2ac41729ea182a2ad26e5bf8dfe642b697bdc0e50996279c23f3b,87361448342
20190111,"PAYMENT RECEIVED",1264006008,0,a13a5a5709f30b3ba3ba9d10f27eda7b4d73c9269c28434e932df5a22c7f0fe1,86108094301
20190111,"PAYMENT RECEIVED",1271506826,0,dddc9de25f760b9d9ec18fd62b815388393293c2800e548beac69f42d873e5fb,84844088293
20190111,"PAYMENT RECEIVED",1259294972,0,f27bff211adf1f298bf0c649fb0515ba2583d67380ce37c2f019190ec90ba374,83572581467
20190111,"PAYMENT RECEIVED",1284817694,0,1bbfc019ca2195a6b1a214d8790fd6b40b542f25fd9f8c54581e7d1767336034,82313286495
20190111,"PAYMENT RECEIVED",1275765716,0,462b942038778f7a96b702aec9781c9ae6cb027c5889308a17bf036e0a7309bf,81028468801
20190111,"PAYMENT RECEIVED",1269385565,0,22167e1807546fa360a6a82570d113daa5d8a0339867bdce1708086317a6fc50,79752703085
20190111,"PAYMENT RECEIVED",1287030600,0,eea7627f64986c933015cf862f70f49a89da15fb71eb3c96de3b8b832475c057,78483317520
20190111,"PAYMENT RECEIVED",1293392681,0,e93d18dddebd3a0680a52cd93d61b64a68e7bb89bbc89ef9bc78f962d0fdff03,77196286920
20190111,"PAYMENT RECEIVED",1267196185,0,04f2175fe594d88c583a6443d3e67ec4cc30afb5bf3f18a763cd1d45dd66662c,75902894239
20190111,"PAYMENT RECEIVED",1274205295,0,aca09e56cfd1c3da4df38a7c8f567233ee128118add86fa447a6d7016782f1ff,74635698054
20190111,"PAYMENT RECEIVED",1252465167,0,6440e51cc82ed00af4698ecc4f1bbc017206126f53dbd179031f3a4efb4c8295,73361492759
20190111,"PAYMENT SENT",0,-2521624555,86559ec98ac7174ab4c26f63179b24b1298b1755b0289157233752f18d944c91,72109027592
20190111,"PAYMENT RECEIVED",1259164232,0,d76797b8b8f8209b1b1078439d1042c120ff38cda05c67844f252761a43ef676,74630652147
20190111,"PAYMENT RECEIVED",1250003936,0,b788611e0e55b6e5a658a7b468787f9e081e9423999687f6d342cd789ad20ee5,73371487915
20190111,"PAYMENT RECEIVED",1259350703,0,eabbe0d4cf191a827cfcaf9a83a0b0bf1652f39e5001c1ac1e09ba51616861ed,72121483979
20190111,"PAYMENT RECEIVED",1265693561,0,6bf5da0779663aee547ee0738a950c98a51f4248ed038fe417f4c6168e6ce098,70862133276
20190111,"PAYMENT RECEIVED",1288562162,0,2b3d4cdb3bd00912e09e7362b140daa8f6efbb59e7a9474af5646e135f0ffeda,69596439715
20190111,"PAYMENT RECEIVED",1254419301,0,38f3a04c9ade3aaf049108145ac2a6e7e5c621aba1ca143fef4aaedc0cf7aca0,68307877553
20190111,"PAYMENT RECEIVED",1251346466,0,05fe5d192e7da195e1c3ff5dcefb1b3a6dce74c25de283e7e3f6c72c0c3c7956,67053458252
20190111,"PAYMENT RECEIVED",1260594801,0,ed6e8fd65832d91e993cf026d8108362b7e0a69a3e52bd6c52076929dabbe27e,65802111786
20190110,"PAYMENT RECEIVED",1250003224,0,1cf758cfe35351662c70ef509e32b0ee636fc3f53d039fb66aa85b111bb9d883,64541516985
20190110,"PAYMENT RECEIVED",1262610808,0,3acc12fb2f5be7188cf0ec616ae1cc4b6f7af59408f5f29107c93ff2c90f76bc,63291513761
20190110,"PAYMENT RECEIVED",1253381077,0,e2d444c5f721f2fd43859abac0140489929b7496eaa5f756cf991ae46c176ee7,62028902953
20190110,"PAYMENT RECEIVED",1256123876,0,33d32bdfd970b10ca4e4d14382096a1b0b6b89beb948f1e6a1020dbea8d58334,60775521876
20190110,"PAYMENT RECEIVED",1276228836,0,9f193f51202ee7fe0bcbde5816908fe30fbc3d023116381caeb4c7c5d97ccb48,59519398000
20190110,"PAYMENT RECEIVED",1286218902,0,30032a1bf98ba5ada7cab67a62bd28f3c355447b43afd8e4facb71f78700101d,58243169164
20190110,"PAYMENT RECEIVED",1261816096,0,1c6806c93312f26399f481de4ba0310b2640c1fbc8ed9ca3010e9a1c66cfdade,56956950262
20190110,"PAYMENT RECEIVED",1280682043,0,a30dd196938197f9b1dab8d399b4aeaec7f371d05dfe53e3a44e82aee2377e4e,55695134166
20190110,"PAYMENT RECEIVED",1276021122,0,08d95834237dc6d8902ff57dc2639d7848e8ebefd37fc6740d3e02819f2dc266,54414452123
20190110,"PAYMENT RECEIVED",1272164838,0,bbee8c603280250f59e0c4517a8dc965876687c624334ab1c923a290dc8c41ef,53138431001
20190110,"PAYMENT RECEIVED",1337077659,0,d3d0fe56f5d65a5a9e341f2f54e6e8797434d8df0b69710218a8c5e6a13dd8b1,51866266163
20190110,"PAYMENT RECEIVED",1258589733,0,eccd792056cc77232cd6be2e97a59240922363e65e28d638c8cbdd203159ff0b,50529188504
20190110,"PAYMENT RECEIVED",1283778202,0,5e3f08a99854462f0690a62f54ed626cfa84f9f310c3a6d3d76c71b66832fbcf,49270598771
20190110,"PAYMENT RECEIVED",1263609867,0,6d8780576ffe8269a0bdc063baffd5a435485656a7df9920075db5802950589d,47986820569
20190110,"PAYMENT RECEIVED",1275485944,0,5ead0d9ac775dfd4dba2cec9d5cb4fe844b20f2c978172a8e44649c23ae672c3,46723210702
20190110,"PAYMENT RECEIVED",1252565051,0,cfa88996fabd260b00195abe1013eb2d7839b344a6485eb3f65a16efe6eb7a09,45447724758
20190110,"PAYMENT RECEIVED",1252450747,0,3630ffe5f955488f445a2cfd12aea59748f53ae9b485cb5ba19ea0366d57d094,44195159707
20190110,"PAYMENT RECEIVED",1268291039,0,f9501bbd19c0b3727d7c22cb89cccf7785d0700f9676f1c418b8992160c7fa21,42942708960
20190110,"PAYMENT RECEIVED",1263164905,0,ccf0df3d542153c7052beee381a5df12bcf39f399548f731aa577f9d01875e08,41674417921
20190110,"PAYMENT RECEIVED",1269584477,0,f2c3b168ed5f91cb6af22bc9821805a0559fbc8660c590f717a4d6dc6b676119,40411253016
20190110,"PAYMENT RECEIVED",1251225479,0,ddc111868211a069863b0f7eb5db7c2981d1786fe4380b3bf0cd6fa09012e37c,39141668539
20190109,"PAYMENT RECEIVED",1262231925,0,8c69e713172dce611a6545e8b923deee531de307e6af3433e2a833c0a184e216,37890443060
20190109,"PAYMENT RECEIVED",1265887602,0,eb4d7c978a8f6ffe38e50f96be533aa9cde5d77bcc1a05f5a3ab49aa0d87411a,36628211135
20190109,"PAYMENT RECEIVED",1267659175,0,d6cda9a7bb01cfac95b398354c3ef0c30fd13c8e9a7d68d906c18b99307b0cb9,35362323533
20190109,"PAYMENT RECEIVED",1253448062,0,79c51671e594aaa917daa7dcff902f6c4e8d89d57595040ac9f35d7fb5c8d062,34094664358
20190109,"PAYMENT RECEIVED",1250939969,0,85b6981db416933c0cf4fa4aa72d8e4fd5551bcd655b582992ba095d7908061b,32841216296
20190109,"PAYMENT RECEIVED",1258397556,0,8937686aa53888083ac2b27fd260f612b70d985d71f79b5a4973b2d5d4d0d7fd,31590276327
20190109,"PAYMENT RECEIVED",1277566458,0,c46a828b1a041131ef4781fa91333a567f804f25134882ffc3c79c4e91dc0472,30331878771
20190109,"PAYMENT RECEIVED",1270908502,0,5222b7293b9686f19a04c10b4beaf5522f03428de3bd4af774b3584cad752cd6,29054312313
20190109,"PAYMENT RECEIVED",1252105067,0,3446d5bc42225b6603d15b0f3137b14ec88499ae38960b991974322b338f0a58,27783403811
20190109,"PAYMENT RECEIVED",1254832859,0,9c0d14eb368e53a67f27d90b5f745c33700d7978bd22a096ab52e7c8a82b95d4,26531298744
20190109,"PAYMENT RECEIVED",24692,0,13841fe9544c941e190cf06d8eb35e8c9ac978b2c562f79674468b688651e3b6,25276465885
20190109,"PAYMENT RECEIVED",1256378198,0,fae5dfe6a47058c3858b4ed7c4607e861594c6c94763106564515a9bbd9eb785,25276441193
20190109,"PAYMENT RECEIVED",1255676544,0,a7308c9eba9a05cf7c1d0f886a0ceb0c03f72bc09c259599e12c342e29c27bf9,24020062995
20190109,"PAYMENT SENT",0,-20078474838,8635ed97cb5def17911973c09f19fd684b31caf36c3e58bb9cb5fb65770cef15,71934737465
20190109,"PAYMENT SENT",0,-49170351014,615715ca65aa5f99c4ef68783625035d9c44499de9db86f9b3e4ed71d3e02242,22764386451
20190109,"PAYMENT RECEIVED",1250931498,0,a21739553848155b51c8c5d90beff4ce299c20a2b5d200c753103c4fcbe480ff,92013212303
20190108,"PAYMENT RECEIVED",1258474857,0,1f40b4a877916373a8e37cacb996fbeda8110d4287311e0d74aa3d915d3e02a7,90762280805
20190108,"PAYMENT RECEIVED",1272087616,0,0c4c68ae4f22f7b84cbe04d891a4d3b96a9be50188f7547e52630a51862c7e11,89503805948
20190108,"PAYMENT RECEIVED",1266057776,0,37e6b9f95e7b21d417915ee5af2f626a5f462d8a3842cbda1d357207db811b5d,88231718332
20190108,"PAYMENT RECEIVED",1269156493,0,379de404060cd7bb9c99577519ed38224fcbc87f7d83a39c6ccf17c5591bd275,86965660556
20190108,"PAYMENT RECEIVED",1280627359,0,233aabf33a3ec687b8a7634314a71b92ffe432ce0bb700586c34ccd9dc9b7354,85696504063
20190108,"PAYMENT RECEIVED",1266562668,0,a069366a2eead81b3c9bb446be7458a83c95250e96798c0407dfc886dab1de75,84415876704
20190108,"PAYMENT RECEIVED",1267833445,0,0673bc6797acbedd0abc629a0e27c5f6b0ec9fc3d0077133608100b051f23c12,83149314036
20190108,"PAYMENT RECEIVED",1251204160,0,706c0473477f7cc3a32cfffe63b3686c4dee64533999706297cb0e689a6c0677,81881480591
20190108,"PAYMENT RECEIVED",1277768636,0,47901eebde5e88885c146c9d93863fd9169d54508d328536a20d22de1925fd9b,80630276431
20190108,"PAYMENT RECEIVED",1257277068,0,10b85b590f4a0ede5f738e9c28525fad3e79607c21c481099dcfdd1ed0738286,79352507795
20190107,"PAYMENT RECEIVED",1288727833,0,74a8f88eafffd4ebcad1eb307ec8a08039d1442b11f7cdf81a7986060486f010,78095230727
20190107,"PAYMENT RECEIVED",1261453999,0,2c776b2870413c38a27c8606deabe122c005a287d479d5f327a52c805b45da83,76806502894
20190107,"PAYMENT RECEIVED",1273337627,0,168de9f783dcdccc9d300089b9397040284919389020f729e312b04b64c9d43b,75545048895
20190107,"PAYMENT RECEIVED",1250934261,0,721daf012ddbd5499aa8e2b175b3acafad2812dca11e36a9a4e06dd857b8af7a,74271711268
20190107,"PAYMENT RECEIVED",1273518035,0,5f3f43dbdb53d8b4fb09ae44bd32373297c6c54af696f6965599e8834d003fbb,73020777007
20190107,"PAYMENT RECEIVED",1269865944,0,d355831b64350435523aec726fb82076178dc1caecf5f2d5c4fc480a28369682,71747258972
20190107,"PAYMENT RECEIVED",1254686153,0,e74790346bff5e787f80884d0bb85ecf25683583c5e523ccb18cd5aba6fab212,70477393028
20190107,"PAYMENT RECEIVED",1267787998,0,9b78593014fd221d3dd80a61d2e6dd129f4c9f069aaa72623ca85fe8912286cb,69222706875
20190107,"PAYMENT RECEIVED",1252095027,0,90605a0a04a8f721102f724fb90d826856766cf38547cc4cd1d1328357ce4e87,67954918877
20190107,"PAYMENT RECEIVED",1255018842,0,6fec8530e8d2a057a60e16d6aba1098461f68401343422ea40a81ffa01d3bb7e,66702823850
20190107,"PAYMENT RECEIVED",1255177123,0,1c9033a235be35e89f098aabbb26c1984d4bbe2559bd79afbb66a1f1a29a5362,65447805008
20190107,"PAYMENT RECEIVED",1258381727,0,46d1ec0d0f4f6be02213e57408f7cfc31ea54b869ac4dba4f79ac60ef0da7a4c,64192627885
20190107,"PAYMENT RECEIVED",1263155002,0,8b2e743c9da0c3a3af1caef604342b9a4489ba3e4e9087fa95483a00f06df4c4,62934246158
20190107,"PAYMENT RECEIVED",1262969098,0,4e1354df5739de0948a16c527c505b52c239133028a8b2f767efb8c8405f5ed7,61671091156
20190107,"PAYMENT RECEIVED",1250000000,0,b2a62242379e72e30bb5bf055f73a42cf98b629de720dd8be205292dd76f7008,60408122058
20190107,"PAYMENT RECEIVED",1253129237,0,2c41dd34ec559b01a24a6fb7ec3858e7f7c88f337d27a2144f90f07b1a559e68,59158122058
20190107,"PAYMENT RECEIVED",1255493072,0,b7e67ce0b11abe9f9785dc40ca79475000553dbd36a7706c5978d95f2f7c0e10,57904992821
20190107,"PAYMENT RECEIVED",1250471462,0,7ca741138bcadb5ee746eec25724da849316337f562ff5d9587c9647fe05fd1c,56649499749
20190106,"PAYMENT RECEIVED",1257575468,0,722ec21879ec9e100f812a5df6bbe52f07fca5e27df9e524bd8aa60acdd7d927,55399028287
20190106,"PAYMENT RECEIVED",1250000000,0,3480d38beb3bfb76779fe8a08f406a9593f150d6ed12a2e7eb4c72a28651a92c,54141452819
20190106,"PAYMENT RECEIVED",1269652515,0,77f9f741143fd28cd0abaf89eb4d0c9b03cf02112d8cad5aafc860281172922e,52891452819
20190106,"PAYMENT RECEIVED",1250599772,0,3a1a37f2f419575cd2aaabad23d62f56003597cc77cb9f226d905056ac4934d5,51621800304
20190106,"PAYMENT RECEIVED",1259149590,0,6d71d24227b4aa250af8872e8834bb4efb916171fc84be4e948ec83a0b8f0598,50371200532
20190106,"PAYMENT RECEIVED",1270743903,0,a72c00bb2ee6bd6838f14db7e7e10a6393112d1adc319c0bd2c2c7495ff08def,49112050942
20190106,"PAYMENT RECEIVED",1250000000,0,0ed8b6cb45d963ce7ff61e3793fbc3d1cb7ed220c3b625ef054366954bdab604,47841307039
20190106,"PAYMENT RECEIVED",1252603190,0,00bb342bc6670b31a41b7a0b2fcbde8d4c61a03c8fd907b235af82aca145196b,46591307039
20190106,"PAYMENT RECEIVED",1273875873,0,079539a8be87f3e2e0447b10cdb271069fc3aba751cfde079aeeb15db0674ab4,45338703849
20190106,"PAYMENT RECEIVED",1261210980,0,d4756440438c1851f9824c66fbd95a0669a5c109483cde597c5b28ca5351dd07,44064827976
20190106,"PAYMENT RECEIVED",1251847126,0,6ed35db32fd3b81910f855b56272d41e0234bcee6bbf95d55bf1e3430e8b10b0,42803616996
20190106,"PAYMENT RECEIVED",1250198650,0,303e2dc42e56843ae8dd2199ff195d2a0e71346e0b93506a66905067d92c6591,41551769870
20190106,"PAYMENT RECEIVED",1251819258,0,cd60506ea7037d3617390441126a6122d6cb36fcd0afee8bb94d46de2e24caa3,40301571220
20190106,"PAYMENT RECEIVED",1259799172,0,0c077ea8578f5ecb5667dd48417895bcf331f2d22d2d793d2b1d53b245474d7e,39049751962
20190106,"PAYMENT RECEIVED",1250657640,0,d75740a282568aab88156401913d1c4675cad07080dfe925b79fd9ef085174c2,37789952790
20190106,"PAYMENT SENT",0,-50392666822,d0a9100a3da52f79858c3eee74152a9c23d0f730a74c7a68489179fd5f398650,36539295150
20190106,"PAYMENT RECEIVED",1250235557,0,feabcd4892bf30a1deb1967152de30b0afea3659744002aef7a18b0d39d2d8b3,86931961972
20190106,"PAYMENT RECEIVED",1251120275,0,d0723e9f8b71ef298a3910b78b2408684df1e1f7fbf6053b44f6440e4725a0f0,85681726415
20190106,"PAYMENT RECEIVED",1253631182,0,44d066190569b9252494436794c338c6956e57b52f269fdd3b9c97becfa05802,84430606140
20190106,"PAYMENT RECEIVED",1253667198,0,315f63d3a2a22c5073d683d050151c932318646e98b0aaded5380c3db025b89f,83176974958
20190106,"PAYMENT RECEIVED",1255821482,0,f6c1adf61f818acc0356ad724af32aa2fc751fdd152599d987a656532d8cd74e,81923307760
20190106,"PAYMENT RECEIVED",1260388394,0,438b5a7b0744f4c97458842f8bd98d443b4d0bdd3faa0a5a9e7c65fa37fc11bf,80667486278
20190105,"PAYMENT RECEIVED",1254446972,0,f5d08af585a964dd0e16c33c18a778aa481c4c9c5527ebdda526a6f418ee3202,79407097884
20190105,"PAYMENT RECEIVED",1253738517,0,94770530b0bccce2682b47ce4298e88f6749d314b225c0f6126f4ec934f701d0,78152650912
20190105,"PAYMENT RECEIVED",1250296836,0,cad3fffd08429b5b936269defecec290927ec02408fdb5cf6fe2a82518a8ea36,76898912395
20190105,"PAYMENT RECEIVED",1250186230,0,dfd9d707addcb8487f743853770d62ea317bff8ad1d47612b3fd2203cd6a49ae,75648615559
20190105,"PAYMENT RECEIVED",1254225553,0,11a7cee45f3f9367053b0415bd104cf6eb1b723c3187b12489f45d08943375c4,74398429329
20190105,"PAYMENT RECEIVED",1260227255,0,b669d139650be9864e274f075910f33ee7c3f8e928e0ec66dd3d02b70a65e2dc,73144203776
20190105,"PAYMENT RECEIVED",1268516240,0,55f6bc63730085ce3f3c82814c1b8b676c959cec006e25374ab9c1e332dd9730,71883976521
20190105,"PAYMENT RECEIVED",1255589255,0,02549442036f24d4abca3019a9aa4344379459565a402794ba4aa50363cc7386,70615460281
20190105,"PAYMENT RECEIVED",1250796074,0,dee61b270e3bbb1b0c4c429b6fb6aeea5ca1244b904b01cdea6c5f55721b4b0a,69359871026
20190105,"PAYMENT RECEIVED",1250178514,0,f22339ec4af2179bc2aebfaeb4631c139aa16a9af2a4e7e325f5526bd9aeaf6a,68109074952
20190105,"PAYMENT RECEIVED",1252016474,0,fa0f64f678afa1a34de1ead5eed36fa1915b6e1da532b6e7368daa0c6207394c,66858896438
20190105,"PAYMENT RECEIVED",1253628515,0,fd70682168037cee6773b72e3e353152dda72a1f38de35af1d89a34e698301b7,65606879964
20190105,"PAYMENT RECEIVED",1255765634,0,f19821b919bee52aa6206c49b9a045e7921e02497c1fa72268829c7fbbc0ed93,64353251449
20190105,"PAYMENT RECEIVED",1250000000,0,d9f67f5c372b3d155fa3ca6b788b6a7e62693e2e2528813e5ea1303d886f15a0,63097485815
20190105,"PAYMENT RECEIVED",1258412150,0,8d7908b849164602a7b6ee7fb9447d3a1eeb37c5baec57165ec266cee5e94284,61847485815
20190105,"PAYMENT RECEIVED",1252464866,0,036f9589bedf8dbd7901d56447296f25306a402f2dc01e03ad7199366bd8750b,60589073665
20190105,"PAYMENT RECEIVED",1257926479,0,b1b2939d47361d78833517c4005947f5ee86da0c5a2ea006b86b074dd603419f,59336608799
20190105,"PAYMENT RECEIVED",1252017538,0,228fb3e2f75f42b21e0262701ba86767733caf2ac98bc3ea55c532b88a7b6584,58078682320
20190105,"PAYMENT RECEIVED",1258568953,0,29b77bd177ad2bc60a9cdbb5ac1b93802de995128738c6ba83445b1b6cc30dfa,56826664782
20190104,"PAYMENT RECEIVED",1250080547,0,818ec20a905a3f120c429a996aebbd973e57f1ac556ec3e5b566e28367ba9bee,55568095829
20190104,"PAYMENT RECEIVED",1261618008,0,ce3b092a5e8fc1b39a971d7b815bd24984671fff342b88d8978fd4e105c8353c,54318015282
20190104,"PAYMENT RECEIVED",1250000000,0,f6db11e136c76591024272d50bb52738273f5fbd33bb9a6c62c6b26acf6f8cc3,53056397274
20190104,"PAYMENT RECEIVED",1259286344,0,664dbb4338e8eec53daeeb61ca83d27d3dc169923b8616a697261fa4216740a9,51806397274
20190104,"PAYMENT RECEIVED",1255379131,0,c652a35351e0a88200b06ec231a06cba3a48e492eb1dc5294835d4196a7ecc52,50547110930
20190104,"PAYMENT RECEIVED",1250000000,0,1089443b0eb7253a8afc00e753ddff8d63708a6bc27ce22ca25d00ba01eb1edd,49291731799
20190104,"PAYMENT RECEIVED",1251195477,0,d6ea18464d5a53aa34400b1b3da8dd9e9ffb7ea0110e6a84ab70bcd96f23344a,48041731799
20190104,"PAYMENT RECEIVED",1258104058,0,066d6b98e714a9ee8f737bc0085ad376b6f2d24958cde33af3aca41587e6872a,46790536322
20190104,"PAYMENT RECEIVED",1275689175,0,32e3fd39000865958e568bfe6629ff5bfebce5788b47d871607a992cc618d244,45532432264
20190104,"PAYMENT RECEIVED",1289564062,0,a1b97e02a4cebfaad25bb637d772e144f1d6797e8808c0e5f558cc3003db0d35,44256743089
20190104,"PAYMENT RECEIVED",1262359256,0,0264fc77a6d2625fd0e9038e9d9ce8a1e2056d9b5e72636c1a761d06723d6100,42967179027
20190104,"PAYMENT RECEIVED",1268959903,0,15f34b8b183b2cddbd4f79929de211b4f8136c7221458ea5d583e112e2966d9e,41704819771
20190104,"PAYMENT RECEIVED",1298167324,0,69215e1e47c7f51aed992d8de98554130b7422b0e79c6356bfc9baa31385fceb,40435859868
20190104,"PAYMENT RECEIVED",1265760672,0,f84e9e2d54dd1dbc0c41a43aeb6008ae947b7ff7db6739427078d61803dfc151,39137692544
20190104,"PAYMENT RECEIVED",1289547883,0,3fda9fdb14316884d58d1d0dd193dec558d1252ba46866512116e2c836de3d99,37871931872
20190104,"PAYMENT SENT",0,-50355385712,49beae73a29c457aef654e5fd558e00db24100fc36cfcd71ab85c92ee760788c,36582383989
20190104,"PAYMENT RECEIVED",1275646553,0,a7f423082cf5e7d04595cab015f7fbfa3d9fab1f069b79a25cdb3bd028843bc3,86937769701
20190104,"PAYMENT RECEIVED",1278422482,0,d1483dcce587f24d47df5be7213bd7007b275da0caa102f4c0a9dc12a4fced10,85662123148
20190104,"PAYMENT RECEIVED",1250000000,0,bb2310fb984f644a628bb2322b32e98c6d567b81ac05f75dc020a39ad95e7c05,84383700666
20190104,"PAYMENT RECEIVED",1257321771,0,89e64986ba9c3d1565e35fefa35bc7e1a205e9fdf5add4f2d8b831fae2955814,83133700666
20190104,"PAYMENT RECEIVED",1263742316,0,471cf0d9c39fdb983255572e55cd4bf8a4172629c06cdec54ec0488405153ac9,81876378895
20190103,"PAYMENT RECEIVED",1250000000,0,512340bbe4749da72c8a9fe0dd999d2672d89d738c354faa778ad7e02b4f840b,80612636579
20190103,"PAYMENT RECEIVED",1250307768,0,83b9ff6f07cf6c9f81de1d3a885f2df834f26ad24b34e3154b117121052099dd,79362636579
20190103,"PAYMENT RECEIVED",1252673847,0,a5a4463271571bf5f253658c0271d662eb0e2c0ece492edaef0523e834619f2d,78112328811
20190103,"PAYMENT RECEIVED",1269825612,0,a0d7c1721d6a4ecdb3ee2b154b48877f23d7c2a71a810beea5e9b66b362cef9e,76859654964
20190103,"PAYMENT RECEIVED",1262081888,0,143f60cba26a886fe80f790c85d9546758d9ce9db468dc1044683dce5878f3b1,75589829352
20190103,"PAYMENT RECEIVED",1253070538,0,5cb56dea4053946f6a20abd92d39ff3ea167413673c62d449c98c02455ab73c1,74327747464
20190103,"PAYMENT RECEIVED",1264963057,0,cafed5cdc7dfa7727cfbd8d2195e5dcb00b1df550641d1467a33d0ad17c4e053,73074676926
20190103,"PAYMENT RECEIVED",1281861245,0,bd531898885c83694422621473cf594b5f3c707a4beb9ea547f90489b56d038a,71809713869
20190103,"PAYMENT RECEIVED",1333747032,0,ba6dbdabfad2de8583e786621cd0747f4667d4c2373c3979ed52bfce8ce7fb72,70527852624
20190103,"PAYMENT RECEIVED",1269460204,0,3f1ec6833a0ee9ea9f16a669ee50b750a97881d0a50b8b165e742460d0f89064,69194105592
20190103,"PAYMENT RECEIVED",1258228581,0,348415d58f4d6c99a89d05e239f76f026ef973bd730c499b5208d47d69dcda93,67924645388
20190103,"PAYMENT RECEIVED",1250000000,0,7a281ca6d907b3ff1e4f565983f6ad2b32cfb61390277f8d1d4c438991f6ade4,66666416807
20190103,"PAYMENT RECEIVED",1265053756,0,9f598f4938f16a99730b28651a69713d04b43ec9b71451616663d599a63bd31c,65416416807
20190103,"PAYMENT RECEIVED",1254837087,0,2d62a4532d68c95194c05e33f0579c2d65180004d26eb3af30003404c1d8cfa3,64151363051
20190103,"PAYMENT RECEIVED",1274164450,0,615bfc76ffc423bda1296983def6af5cd878b0a999cedbff5a422e10372a7c59,62896525964
20190103,"PAYMENT RECEIVED",1270693057,0,6b5d5975327dceb86fa5f21c15f3dd942d7104478146f4630938cf3ed44f43ca,61622361514
20190103,"PAYMENT RECEIVED",1288294183,0,4db6ac31037c8572d0b2a6e9fed657d73ce207cb110341e00bc9a60440ff2ab6,60351668457
20190103,"PAYMENT RECEIVED",1252220902,0,c131436c4598dbdb1c27ab9069ec91e3b8458908e9cf476542a5e91411ac670a,59063374274
20190103,"PAYMENT RECEIVED",1262646844,0,d5e692fa365a93edb86371f8dd6d33f2d9f06e4660c4c4e7838cc133259293b1,57811153372
20190102,"PAYMENT RECEIVED",1252086017,0,84d0f62204ba7c7d6c37512325fd2c73feb60d24205d4ce4b7e18ed71e973a47,56548506528
20190102,"PAYMENT RECEIVED",1253063990,0,f3a61aeedfe166be0bc91d8e21adf33c2f761295a268dc7906ffedbc5939d577,55296420511
20190102,"PAYMENT RECEIVED",1260027092,0,d264150806d173ac424ff20db9fc4c22912ba2806fd825190c959d793d7094f9,54043356521
20190102,"PAYMENT RECEIVED",1260764382,0,7ee7aed67e1b33df1a0bdde8b3c82ee7d94a34d83163cf725be95a307bf292d8,52783329429
20190102,"PAYMENT RECEIVED",1282778189,0,2b3f8c31b2475bdf379ca5086bc5b722da789bf83727be608b02352049c65d1b,51522565047
20190102,"PAYMENT RECEIVED",1271358653,0,1898100e88a9824b19ba5fbdc09fe19e17b7ee5be6f00671a6a6c335f12d45c5,50239786858
20190102,"PAYMENT RECEIVED",1265640438,0,8718ca920fac6ada22c2824a1b33631efcaeb189c052f4965ec633a64eacb876,48968428205
20190102,"PAYMENT RECEIVED",1250155180,0,2371b5011687976777fcb691db25f1492e4ee51509c4b22c85120a844b2c9fe2,47702787767
20190102,"PAYMENT RECEIVED",1259897310,0,7b68e911b61e00449ea2e784df3f7023b1e0cd7513af2734e06a0c88be72f5fe,46452632587
20190102,"PAYMENT RECEIVED",1253567319,0,ab559c8f2f84d417cdb27121ee8f4b3d43698cffca495e93bc8e471bb4159c76,45192735277
20190102,"PAYMENT RECEIVED",1253805873,0,f4bd125878ab98c5299036261e32db08cc5cb321b9d836399502681234ed0f95,43939167958
20190102,"PAYMENT RECEIVED",1250606008,0,e17378c46ff346eb99b2fb347ecdca6aaa93ac200ee14aee2aa0edb4eceb9c0d,42685362085
20190102,"PAYMENT SENT",0,-49206538851,d8adfb390a209d6aeef63a140b5598fcfca95d834f2e11a4295418c2e2b22c6a,41434756077
20190102,"PAYMENT RECEIVED",1254233396,0,04fb45488814a3aacb8e58fc96a1d691cc8ae39f80485022155144ee4931816c,90641294928
20190102,"PAYMENT RECEIVED",1255540258,0,017b56d4771bceca89cc657edb921b687e917caff8b060fa76aea7f5fb558c51,89387061532
20190102,"PAYMENT RECEIVED",1251385039,0,1ecbf09625a528aa0d46e3e7ff15b633dd5dc738e88d26733885585dfefdaf44,88131521274
20190102,"PAYMENT RECEIVED",1257323929,0,3f667c4521d63a893e7f1c10c722d97be815c141989e86ef4329cb4283519d44,86880136235
20190101,"PAYMENT RECEIVED",1251542845,0,0bd2d32123c9109fa679b5dcb112307a5e978309d1938ad232ba2faf4c0ed881,85622812306
20190101,"PAYMENT RECEIVED",1267792138,0,330e82c0c9e59bbbcdc9c26eab99996d81f6c5514edd0e94736f71114b4e08bb,84371269461
20190101,"PAYMENT RECEIVED",1251791959,0,b4bab13d05a184095fdcbc1bb0f016148bf82001e0353f4e43a48750e961e277,83103477323
20190101,"PAYMENT RECEIVED",1254945444,0,49e292ed9922800d567f39cdaf0cfacb2c9f173a04cb1f82b2533f69962acf70,81851685364
20190101,"PAYMENT RECEIVED",1255757915,0,305ab2d375ad12aaa5b81730fe4e9c9413cc70a8ca8c1f0856eb0d16b898bcda,80596739920
20190101,"PAYMENT RECEIVED",1255987706,0,7265cc3c1aefd0c2b83a0d571b0d08ed56eaba13dbc15849d19edb9941e195f9,79340982005
20190101,"PAYMENT RECEIVED",1263541921,0,05bb10085996f5da4c7eb398f4a8cfa61447101dd3987c7bb67aedcf5cb03655,78084994299
20190101,"PAYMENT RECEIVED",1269041398,0,cfabd9ac236f0cba2d7226f962a8c69642dbad40295fb4a1e7f054f857e9bde9,76821452378
20190101,"PAYMENT RECEIVED",1271602785,0,97d3876b312b93e1de17445afbcb82a916a5e977170993d9bad642a08bf6391a,75552410980
20190101,"PAYMENT RECEIVED",1263111051,0,c431f078b4ac9093118770e256a96a29e71d5f4025bef18a215a0ebda66f58cd,74280808195
20190101,"PAYMENT RECEIVED",1281353968,0,276e998545e0c14eb6c7ea25745d9138fb779f2bc95fff99eb54cf37da6b8312,73017697144
20190101,"PAYMENT RECEIVED",1251258862,0,bf009b40c1fbe36c8b11b82cf7b96965237b5df8361b22c0e19ee271c9479d50,71736343176
20190101,"PAYMENT RECEIVED",1256778666,0,59240e7f2da739ee12845aaf83955d22f8b0837fd88d7598a90a15eb5cdd3494,70485084314
20190101,"PAYMENT RECEIVED",1260531647,0,d18350f93be0f2d49e9a8dde626084cfa5f50b93cea45f9584637bc9bcfb29c2,69228305648
20190101,"PAYMENT RECEIVED",1254676084,0,8c8ded15022caeb9a598c978149bdf9662e6062519f92b6df0f70103a8e8752c,67967774001
20190101,"PAYMENT RECEIVED",1267727054,0,6f0927b0549076fa07286958b9d6e41c68e1b2506877080319ec30e4270d677d,66713097917
20181231,"PAYMENT RECEIVED",1253806011,0,65204ead6c529053fee59125745ca87b521b2a3d41de5006546fdd300317b1f0,65445370863
20181231,"PAYMENT RECEIVED",1250502237,0,6f57d094e9eed72bae96904ae3a8952c7018379bfc72de09ca9caaa2ecad93f6,64191564852
20181231,"PAYMENT RECEIVED",1271749966,0,cb34203ca88f5d47b6d4bd67ac4b9eed7e35f17b3d725b7c766a4ae98cb19444,62941062615
20181231,"PAYMENT RECEIVED",1252195865,0,6aa69eab449ff1584e0e1c5fce37b5f71425dc6a5b631b78f0d686fce39b34fd,61669312649
20181231,"PAYMENT RECEIVED",1254203411,0,c6e445ed3698ea1fdb5f80792e9c4d92176ae91a1d38f4aeb333d7580e7bcd8a,60417116784
20181231,"PAYMENT RECEIVED",1267490752,0,655d97cdf28b4b95dd76282514d979c749bba03726df646c6fb27b90892899d0,59162913373
20181231,"PAYMENT RECEIVED",1260107103,0,9a313a2b1603aaade02a3139818bc500db58ed040f1fc20d59bacf901cbaa467,57895422621
20181231,"PAYMENT RECEIVED",1260101661,0,13f67a29c71d379aa36bf1cb7c92f017231fe3deddd15bb4b768c90b94ab3ecc,56635315518
20181231,"PAYMENT RECEIVED",1299141997,0,972797c388ee335d8499d86ab594af57156eea2b88d4e26861e651aa5f9c0d0f,55375213857
20181231,"PAYMENT RECEIVED",1260409962,0,8180b5e822aa607379f213051f246e3c1d57ef3b61b93f814bfae71257e6cf21,54076071860
20181231,"PAYMENT RECEIVED",1258106989,0,e462eb5cafb9412bfb58cc639bab17960070874fcfb0a9055a853e2fe60ab5c2,52815661898
20181231,"PAYMENT RECEIVED",1262237192,0,3f4272d01ca5380937526f6c0f952a2c4e463928a73acec7df8ee120345ae55d,51557554909
20181231,"PAYMENT RECEIVED",1253279616,0,f298e0fdcfcaafcfb0cfdc70e731f71aa495d1dbe5d28bcbee4dfca65d5c4e47,50295317717
20181231,"PAYMENT RECEIVED",1276847714,0,e5e2d504dc8daef38c7cf073e55ab7ae29a48a90930b8ead6dad8d05a121bc67,49042038101
20181231,"PAYMENT RECEIVED",1257853003,0,9684762c5eafd305f7ebc65bec03b16c5c27f5d4b8dc561958525bf41d6f11b9,47765190387
20181231,"PAYMENT RECEIVED",1251141789,0,be8ad94ddf76db036c0648b2edb22f99873043dcb29f2e0a93f4f2316c2c4c2b,46507337384
20181231,"PAYMENT RECEIVED",1258920473,0,6ef3950f34c8fd199777badd9016ad22f1971895cdf6156c233ceb8bdf6e4da0,45256195595
20181231,"PAYMENT RECEIVED",1253690181,0,7c6723e52fa6273c71d0e97a46126676405ab1cd4103da318fc1a337d0454732,43997275122
20181231,"PAYMENT RECEIVED",1253705363,0,b8202d8fe33be94422c60e197e143af25b7409ddc5e65e193c3701c16cd98def,42743584941
20181231,"PAYMENT RECEIVED",1261755704,0,88ee9dbc7746ab68b0b2267308721032342d0df17d6fc3fc8f4c0499fcf6dbbc,41489879578
20181231,"PAYMENT RECEIVED",1264051704,0,0aeb330b3cb70e6b4b6e88bb88dd26e0e0aa0692bc5c9300d927d09652f65058,40228123874
20181231,"PAYMENT RECEIVED",1256547261,0,469644042277b1c9eeea2d7a5c811f992b25544c727e41dc41e11d4b978f0f87,38964072170
20181230,"PAYMENT RECEIVED",1251866497,0,0e7e5dc4314f29eaab5fa84acc732a282e4ff024a949ccfe5ee8b217ce947ece,37707524909
20181230,"PAYMENT RECEIVED",1250850106,0,701a3960ce9784b54004ead933dbad0c45b2a19826b3c8ff23eba7fa9890900d,36455658412
20181230,"PAYMENT RECEIVED",1259549084,0,3f40db5990468df18c34f66474f9a6c0da50f40c61f3a71baf3d9f0c12d4c7d0,35204808306
20181230,"PAYMENT RECEIVED",1258279534,0,8b565d8a204152034febe072d8f8ed68b9deb0336d394d05d6c9628ef2a491b5,33945259222
20181230,"PAYMENT RECEIVED",1253067512,0,75b985f9a4b208ddb9a5c672f13d7b8190be84a7dcfc8c3f242bebf30dffa506,32686979688
20181230,"PAYMENT RECEIVED",1251809538,0,9deb43bb3bf2f50b42d28d3fa886acc4f254fc4d7ff1b737b2a2c6068b198141,31433912176
20181230,"PAYMENT RECEIVED",1252893709,0,8545ca937d384e0a1cc2e991f5e260a1c644c01ab4a0665d8b31313c65c7f87b,30182102638
20181230,"PAYMENT RECEIVED",1255382838,0,490ca6c0099cc9afce17fba92e37e87f4b6c1fd63953a8355a850b57caf42ca9,28929208929
20181230,"PAYMENT RECEIVED",1261597888,0,26b89e15c54ff460c2e09e778b827c4b15046f8534ce575bc0e71a93406e6ef9,27673826091
20181230,"PAYMENT RECEIVED",1252433268,0,aae44fec18f9794ae32cb30a46f76d868a00687bcdd0862444b42a5b5cd85f98,26412228203
20181230,"PAYMENT RECEIVED",1261668361,0,99c99b5335d661e8140dd255fba5cdfd94ffea85f335723e0f9ed8281d5e6a99,25159794935
20181230,"PAYMENT RECEIVED",1253376826,0,d5a658d5c2c132cbddec6a7218422ec49d9a06ac33a2e5b5faf6fd70bdc1c327,23898126574
20181230,"PAYMENT RECEIVED",1256297903,0,481df89e519103055ee109d909bcd5d8d8beed835ceb1e6e78a5d842ec8b106d,22644749748
20181230,"PAYMENT RECEIVED",1250165959,0,d30a680c267486857fdd2107d61d28d83bbf8731d40f559d75c3cf8d9ff28c19,21388451845
20181230,"PAYMENT RECEIVED",1261664746,0,731b410d2d58ca73f7d9427b5037c89552dfa4f8560854ba344743b2e117bff0,20138285886
20181230,"PAYMENT RECEIVED",1261222808,0,6990a723ac0159db21c0b76efdf99168223da8a41e70bc982e26811654318e4f,18876621140
20181230,"PAYMENT RECEIVED",1251106124,0,3070ab4f367c38e290ba93f5ad5d159fccf4a5064b4d7f2d57c6da471313f632,17615398332
20181230,"PAYMENT RECEIVED",1254344163,0,11d8d3554ac125867773f77df4459610deba64ff72be0be7c3e56bb4cc5f361d,16364292208
20181230,"PAYMENT RECEIVED",1251323949,0,304b19da7f0abb7482ecce307a94511b3282f4caa38e3eb6e3417722b5d46f46,15109948045
20181230,"PAYMENT SENT",0,-50375728560,d998f1cd1d4adc4719a39ee97ff90faf9adee0e0c855b905129c8c90f230ac96,13858624096
20181230,"PAYMENT RECEIVED",1266938973,0,0040e7e4abedf4bf117596c41541ba0b16ca23c8138029ec3d0c10df20d94dbb,64234352656
20181229,"PAYMENT RECEIVED",1251083931,0,bf6b9b39e60902a697b14d48e2d54e33800d4051ba70c9ecd7a364fc67f9a390,62967413683
20181229,"PAYMENT RECEIVED",1254698659,0,489d39ba29223afa6e8394e545b7fcbee04cf279f4151321b074f83cc0ba3430,61716329752
20181229,"PAYMENT RECEIVED",1263911666,0,fedb066ef4d794e284734907e38dce2a9b4272b027dd31af795b75d9b5437711,60461631093
20181229,"PAYMENT RECEIVED",1264277924,0,92cc240794cf335008460e29584de3184a8ca4c64afaff60c0cd3c41dcbd2475,59197719427
20181229,"PAYMENT RECEIVED",1271043200,0,fb707a1bae71ce21579a047b0c4cf6e3fd44a21d43ac560fe9ea2700c80968eb,57933441503
20181229,"PAYMENT RECEIVED",1255104148,0,4431bb0095d7ca34b83c89d42bebe83fba1457d2243044bda2d488d80fa8be8f,56662398303
20181229,"PAYMENT RECEIVED",1263577837,0,119b7d1fab21dd8507c44fcec18e581e72a9212e72cd158de77acdfd3ce7ae2c,55407294155
20181229,"PAYMENT RECEIVED",1253893810,0,505fd84b98be0b40dbe05f0e0127f1f3a5e9ec9cae4f4d03e88ab1a81b788d99,54143716318
20181229,"PAYMENT RECEIVED",1255100763,0,9b8cdd0fb1fa6cf1e7d7ea3a15698030f298e5587fc09aa849aceba7ec81d84d,52889822508
20181229,"PAYMENT RECEIVED",1258993185,0,132c7105a447c0addc2ed5539593537f0b1fb4fe347474fba8350801520a712e,51634721745
20181229,"PAYMENT RECEIVED",1251763870,0,f08b99d83e938a4475dac109a8bd472477a3f427ea8129d7a62ae3936f95ef0b,50375728560
20181229,"PAYMENT RECEIVED",1257455282,0,e3a88abe80505c2a2fe04b0fe14137491bf3a33992e44187c944d1948f9fb37f,49123964690
20181229,"PAYMENT RECEIVED",1254059150,0,3fe699d5997e193cb4742e9fd09c4cc254c1a4dfa7447adb80e6249183f14999,47866509408
20181229,"PAYMENT RECEIVED",1255379767,0,ca4506262a5939a36e998f11c096400b2caf24e6dbaa33bb490b74bed829295f,46612450258
20181229,"PAYMENT RECEIVED",1255691628,0,8b492aa626d0ca3e275979451adcdee693bae7d23599bd71955f2b551587b5b6,45357070491
20181228,"PAYMENT RECEIVED",1255553990,0,3dd00f79b17b88fe46d65e268e90ca2bbb96291dc8f8a20b34875a1720b01bcc,44101378863
20181228,"PAYMENT RECEIVED",1257448762,0,3937f285002abca817e9f95bd966af73f9ec6701c90d26164d316e814ff12e65,42845824873
20181228,"PAYMENT RECEIVED",1258227317,0,52c71e40d02363b28260e6bb3637d4ae3aaeb3236ba0db4f0cd67c6220e0fd06,41588376111
20181228,"PAYMENT RECEIVED",1266532132,0,26fb15e0995fb618cb0d581d23e2fa469c17b4bcaef5c816f900cd8271422066,40330148794
20181228,"PAYMENT RECEIVED",1261438086,0,30d55c2ee37f0a2c24ef8f555bc1f97e9b5c26b865ea299af5bba9d39ce179ba,39063616662
20181228,"PAYMENT RECEIVED",1262003374,0,454e674d27025a2da154ebffde177c834d54005f398cacd438f28c30cfc4a376,37802178576
20181228,"PAYMENT RECEIVED",1267448991,0,753c28ab41848f22e4f3ce73cc5fde2cdca89a53db58a5fea4fa77667120f89d,36540175202
20181228,"PAYMENT RECEIVED",1256424321,0,258d5666a9202dca82e170d60d321f432d1e5ebb6f1d27a55e8368db89c13e58,35272726211
20181228,"PAYMENT RECEIVED",1253286800,0,1b942a25fa1a4874d323b3dee7ac8c42a7cb4387bc47f52dacc001c72a3f1f4f,34016301890
20181228,"PAYMENT RECEIVED",1278424833,0,d7b5d0fff7a27e0c6c2c433a6dc16d06678fd382f40e656440c91d1ec6b187da,32763015090
20181228,"PAYMENT RECEIVED",1293629190,0,1a646371488565d877a28ffbc899469aa06e844d9f7065a1ad8b74bfc9d0d718,31484590257
20181228,"PAYMENT SENT",0,-50353306668,04e47661f2b4b19d5b5cecc96116a51288e036e1010a402199a1f7647663e99b,30190961067
20181228,"PAYMENT RECEIVED",1251186057,0,3bb4e0a716b5a1b537e17ab27abf301e874220354dc020f29c3f904397e4b079,80544267735
20181228,"PAYMENT RECEIVED",1251439018,0,8587853def2d93398a3f510f823c66ba761ef3cf90f210e70f3f722f2b32edc5,79293081678
20181228,"PAYMENT RECEIVED",1251372230,0,ddcd784c374fc54c954278bc2d2de495d9d02d8317cff6773e16ebea6ad3db4e,78041642660
20181228,"PAYMENT RECEIVED",1255987969,0,26952116435076d51cd69ae881e445d4a97f72850cb1a36d0f7c9411982b70c9,76790270430
20181228,"PAYMENT RECEIVED",1281099685,0,2edf0be87163bef1975b4e63bd29e83430a51c742855a82ea1cdf4a3131d93b7,75534282461
20181228,"PAYMENT RECEIVED",1269709864,0,b7bdb3fedc87cba8e34fe4ad7b74c2d3d1b712e1a920ed4f129d6756e7c69b7a,74253182776
20181228,"PAYMENT RECEIVED",1250912865,0,be00dcd07bdd8237c79c80df0dd2d2f3a4c6b071af21c32eae0817495e301230,72983472912
20181228,"PAYMENT RECEIVED",1252929669,0,3823e161a0516b10ff06d0cb8ad7cdf539556301a7b88fbdaa86c1669d1c1f26,71732560047
20181228,"PAYMENT RECEIVED",1265432109,0,765fe384c3631e7c4b8ebd4866dcffbafd81198a9c65956309df241ef341316c,70479630378
20181227,"PAYMENT RECEIVED",1262647547,0,abedce356a211d2b6b4eae50d27b4067d8c63287238618d2234a588ec9c5ea6a,69214198269
20181227,"PAYMENT RECEIVED",1254736167,0,5cbc1325e107317af186069bdec809699eb7c124799f4f8a1c5d36bd015b3fca,67951550722
20181227,"PAYMENT RECEIVED",1270347693,0,de5285b4d593e43574c1900d94e3ce46d3dc626857d081a6d7e35fa1eec71c72,66696814555
20181227,"PAYMENT RECEIVED",1251876855,0,2accac5cb4fd3ec09bd138a05d10d04a867f3c3026ff8ae6105d65815498d36c,65426466862
20181227,"PAYMENT RECEIVED",1252409148,0,2ede0c96742b8d0ba9248ae44516a3fedff16247100f7274854a4f70c965dff0,64174590007
20181227,"PAYMENT RECEIVED",1254306731,0,1a8172c894c13df5eff18b8168c899c7a9e8acadbf3df0f9cbd4062509c1728b,62922180859
20181227,"PAYMENT RECEIVED",1258039431,0,b776a912b7634726f5c58514a37a755d666dd19d6fc34011eccdd8a3d1fabedd,61667874128
20181227,"PAYMENT RECEIVED",1255658611,0,279a9457b354300f656d6e884d015095537b699c98f62eef881b59e7f986de61,60409834697
20181227,"PAYMENT RECEIVED",1254320957,0,d49510c839169a5901296a7781d783faef652ef0189d3f72caa3f48d97f505f6,59154176086
20181227,"PAYMENT RECEIVED",1257365421,0,9914f0929eab3af435938907e336e86ebc681a6526667065ed33e48faea28e83,57899855129
20181227,"PAYMENT RECEIVED",1275417786,0,798dda6eaae3277d76e1276946d06322f5a7fe2ef87cf0cceed60991f62849a5,56642489708
20181227,"PAYMENT RECEIVED",1251984916,0,0b517c908c205a3ec0bc0d4036be0ead6d2b7b966bf124ba85c3d55388a038fc,55367071922
20181227,"PAYMENT RECEIVED",1270963442,0,2bd7794f4d08531c89c38cc13a94a61272e40b3f3c8eba437b07281c48925dab,54115087006
20181227,"PAYMENT RECEIVED",1265620322,0,b2542a09877bd65074d0ead9181e3dcdbebd484f62fbe76fc9a833113bb5944b,52844123564
20181227,"PAYMENT RECEIVED",1252495874,0,c92b522d21aa16f51a425e708ef46926ef7f3853fe5697bac9a0d57bcdc12b6e,51578503242
20181227,"PAYMENT RECEIVED",1254796444,0,396ff2115a900253f019227c0ba22e4024bd7dae5b13a3700ebad50e3a5734e5,50326007368
20181227,"PAYMENT RECEIVED",1260693066,0,31224d1ef9b43d3b975dc575333e85e69561fc5ab635e1e03c1b7186404e1527,49071210924
20181227,"PAYMENT RECEIVED",1251462257,0,8ef789442777f139345aa6e3f07028a9100353f048744085f72782405cb79088,47810517858
20181227,"PAYMENT RECEIVED",1254717797,0,2175827af38fb14f831fb7d4a74c553c7ab41b2bcbd40b6bf18340efb04844f2,46559055601
20181227,"PAYMENT RECEIVED",1258034046,0,b35add57026e22638cf6d343c35470c5cc05c237f0d6a6ebe12ff64da663ae82,45304337804
20181227,"PAYMENT RECEIVED",1250450982,0,41ab3030689c991fb14b5a676e728f09bf3131342dcdee09b4eb84a90108c21a,44046303758
20181227,"PAYMENT RECEIVED",1262745386,0,a33fb477b8fa4c1a91321b650b5b96bff26148e1db03374ac766f24eb99fa172,42795852776
20181227,"PAYMENT RECEIVED",1255708353,0,389c4801e885a7fe665bba060a462af184f34df4fe5d1270d7e87fc485671acb,41533107390
20181227,"PAYMENT RECEIVED",1256912087,0,e017e6fc858bc2cc4050f57c317988b6006d86a226358f691ffbbc67435c67c8,40277399037
20181227,"PAYMENT RECEIVED",1258152362,0,7675a5086514eea83b58bcf3e78651c65a3ed347b69e5877b3d5d67e6cec6523,39020486950
20181227,"PAYMENT RECEIVED",1252994040,0,a0b47fac49b8391e62513c3277d195a18e64f4cf7d893095a0b82b7de73e3a25,37762334588
20181227,"PAYMENT RECEIVED",1256678937,0,908f60fbadf40acfcf9cd103607caf2dfaf7869db6ebb64b8cd2eb6e2f418aa3,36509340548
20181227,"PAYMENT RECEIVED",1257760987,0,ad4b49eaf13fe41a8b59789476c6defd8aa7eb8e61d723d7f5309bb85c068449,35252661611
20181226,"PAYMENT RECEIVED",1255222404,0,5cb7da0f86cd6647011b7cec01b4b826f6c9e5530138008791959d1f70128f12,33994900624
20181226,"PAYMENT RECEIVED",1261770663,0,4dd96642a4f45b0e2e731a37cb942b820f3d30bc7117f61c0bbe8f1672c79592,32739678220
20181226,"PAYMENT RECEIVED",1250325692,0,99befc5b5f1b30a0de4ade9614026acfad9a0232c8df23deb7d2e647a99580de,31477907557
20181226,"PAYMENT RECEIVED",1252239691,0,0637bdb1a822721c87ff66d5bdac4a32545ac8824343bfd202a3217de48297ed,30227581865
20181226,"PAYMENT RECEIVED",1264873924,0,c6966e63a888429bb3f7f11416dd8fdbd347ba9e9528b1a4258eccbfefdabfeb,28975342174
20181226,"PAYMENT RECEIVED",1254346338,0,af7851c9ca6dc3904f1a1ddeec830c48234d12750358620ba5f888d6af0f51cb,27710468250
20181226,"PAYMENT RECEIVED",1279759366,0,5e47c2d49163c98c4287755b2616185220e6770ff22b0000668b66efade0613c,26456121912
20181226,"PAYMENT RECEIVED",1257745611,0,d248dff606346e70a714c3bb08dbb87429a7fcfe62f10fe0ac933f6f8d428979,25176362546
20181226,"PAYMENT RECEIVED",1258661082,0,bc6fc0190629eb5caa9e3e0cb06ca1589e6db794afe4e2a9ff0ea8990ebfb928,23918616935
20181226,"PAYMENT RECEIVED",1255383147,0,421d9c947efbb11f1ea49cd114d739976ce01446c778d37def1a1bb75d3b4a2d,22659955853
20181226,"PAYMENT RECEIVED",1252844485,0,585da3ef7f592a081a33a36ded3213967c682c3cf60f1fc187140c80a2d44a11,21404572706
20181226,"PAYMENT RECEIVED",1259422098,0,d61dd1af716d4a3618db7237549c5b33f4b726df65178f567108f3a272cdbf68,20151728221
20181226,"PAYMENT SENT",0,-49181359325,dc2f68d0dd62e720ecd1ad4021f9111e051c71872406312c6687adbb6af7e0ba,18892306123
20181226,"PAYMENT RECEIVED",1268238270,0,fee3fb4262e4aa660e8ff25d38b884b7f36284c1414dd2ba1ac9c0eca178e225,68073665448
20181226,"PAYMENT RECEIVED",1260479340,0,78bd41213ee7f69e62bfde5ae9bac586a4ac4c2723233fd1772e756eeccd77f9,66805427178
20181226,"PAYMENT RECEIVED",1254765945,0,ce831353b1e9c78a8f26cfff069adbd77e186a862ebc1ea85ec72db881988c13,65544947838
20181226,"PAYMENT RECEIVED",1253372009,0,0442219f1ad5b00f3fec9060e16e9b6537c63e49cf5f79cf67b68db5b04d06a2,64290181893
20181226,"PAYMENT RECEIVED",1253569300,0,eb52c8662c0897c9dbcb46364484b0770f7c5d9b7da0d9034f20376fa5f10113,63036809884
20181226,"PAYMENT RECEIVED",1256620093,0,bd978368de1587eb321b7ac9a78b56088f0f2492a53fdeed7034dac164d4f98b,61783240584
20181226,"PAYMENT RECEIVED",1257158811,0,ed6649fd6fc4ca36874dd21214d3b5af44bf7e7c61690f2d4719951724403cd3,60526620491
20181226,"PAYMENT RECEIVED",1264685118,0,7f2e0fb48304e8ccc4bb87fcd36693f1f99e9aa86974d80d859eb3793ea86b85,59269461680
20181225,"PAYMENT RECEIVED",1255496576,0,d015a465ad3969bd4fdc14e994f5b741358e6919ca165041f9077de63abd6fa8,58004776562
20181225,"PAYMENT RECEIVED",1266442696,0,782df5f8891eca0eed41c328d23209a612be0ab6ee77246a1571ec38dc5d35cd,56749279986
20181225,"PAYMENT RECEIVED",1256744782,0,39ca09673695942e1116f34376a02b578bbfc9814dda5423d23207b1dd2e1769,55482837290
20181225,"PAYMENT RECEIVED",1265148167,0,3ae3065445699344d3dfaa8e5f0f7dcd1d677ff0a8b97629b3f78c9754761a07,54226092508
20181225,"PAYMENT RECEIVED",1269431010,0,73716a8a5e4be5f28bf43801ead935085138a580bd14200b7cafc7b3d6bd8166,52960944341
20181225,"PAYMENT RECEIVED",1255206936,0,6bd03b22ad8dcb32abec57048e4eaebdd8d53042c07e670a7c9f5bc59d386127,51691513331
20181225,"PAYMENT RECEIVED",1267801639,0,81fd82cba9ee2434595a12e643f1ab667421e6a8f5d9bfa41a5e8ada8729d785,50436306395
20181225,"PAYMENT RECEIVED",1287063722,0,acde34fb206eff198c539eb493abe46dfb18be0b03770a1231fd48f10fa4c231,49168504756
20181225,"PAYMENT RECEIVED",1250864871,0,b85ff81387a249732d3e84ef13b7c47e08ca2d98809afbdb373c5355087846ef,47881441034
20181225,"PAYMENT RECEIVED",1259030426,0,ec8a9b104baea6ac699b1373cc4fcd19cc3487954fbd09cf9e5195ac72e50694,46630576163
20181225,"PAYMENT RECEIVED",1252672055,0,e4c7eb15bbc0e79fd52321535cb091f39d95e26d283de35ff2ca4936f0fae1bf,45371545737
20181225,"PAYMENT RECEIVED",1269007218,0,f8e0942146a87820f9f4b99bd4f7179d48a494e9766274451230d648bd5dbc34,44118873682
20181225,"PAYMENT RECEIVED",1265963436,0,a81abefefb2c4f42c44a5f8c6b80132e1a7a6d87e6ef8c01d0c78495f9524723,42849866464
20181225,"PAYMENT RECEIVED",1252978313,0,5cc1c70aa8cac239b097953d6ed81990401643d5d67a0497971153147cbeb138,41583903028
20181225,"PAYMENT RECEIVED",1251849575,0,577ffb7594d2bf9926e5ecb1ffa26a8d1414614ed6a3d2689283206e8a1774fb,40330924715
20181225,"PAYMENT RECEIVED",1269311837,0,758b69ea6f13121aaba3bacca7d0ff703791e02a4fc9171af0788e2eed7ecd01,39079075140
20181225,"PAYMENT RECEIVED",1251665404,0,7761119b7d06b7e53745b206a7d9d3103f1d8c192c53f7864b759569fb79b517,37809763303
20181224,"PAYMENT RECEIVED",1270369545,0,011880f13e3d130d890cfd6daded96811a49d23dd61dbc86aa2473b388798486,36558097899
20181224,"PAYMENT RECEIVED",1263199623,0,535db361219e772f353e37fbe49db01dc93f16b616773ef9c8bc24384e370bb6,35287728354
20181224,"PAYMENT RECEIVED",1259698784,0,77083525e79e766658389204e34b861f2edc81b450e7385155e499dc9bad9e3c,34024528731
20181224,"PAYMENT RECEIVED",1290154078,0,c39193c17bb00993bb7c8b495031d901f740db257b8a4a010bf73ed354d0f3b3,32764829947
20181224,"PAYMENT RECEIVED",1270529056,0,1dd6d0e517ca8e3e0b963b0610917273db34878c298a602dcaf2d93b4595fc3f,31474675869
20181224,"PAYMENT RECEIVED",1252885241,0,910628f2b5e1c3799b17c8583f38b0004cd8d60dc5592bb8763a2a22f78d6ad3,30204146813
20181224,"PAYMENT RECEIVED",1250931116,0,28ea4366e1641ea4ad0d0e1f6cf0169a36d7a169ed4ef0782c43de7c5a8f46f1,28951261572
20181224,"PAYMENT RECEIVED",1254070235,0,f7a2e78513ce2e17fb3a531fb97502b66e95034a8c945824da9cfa098bb143ff,27700330456
20181224,"PAYMENT RECEIVED",1257639333,0,d128ec78f0e3c1b119aa51902ca8ba9cb86adba6b42483e24f9f0a8b6027af39,26446260221
20181224,"PAYMENT RECEIVED",1276243625,0,9accc284021db4652a538a7bb5e5c5a80f0656510931267b528980ad4e83a38e,25188620888
20181224,"PAYMENT RECEIVED",1269304337,0,94221cd5903b0f32dfe220afd0bb49f60501d0683d8c3032e4c2896936957558,23912377263
20181224,"PAYMENT RECEIVED",1267784602,0,6b14f299f44bef6a8fc481fb1188aff5a540b59d24c430b63e62e8d7fdf9c618,22643072926
20181224,"PAYMENT RECEIVED",1252185154,0,14f226c5685d40b990d1aede3e0ccefa7071a6f9af24e9a2a45ad6ec5920857b,21375288324
20181224,"PAYMENT RECEIVED",1254947070,0,7ee2ac19160857956fb4d99dc05087579aa3bc9b0ee84961a39222c6e21abd0f,20123103170
20181224,"PAYMENT RECEIVED",1262070328,0,d49f9fae5277c63ad4734ec49551f332dc0473c66cbf3639d322df2dda96ae15,18868156100
20181224,"PAYMENT RECEIVED",1262834791,0,269d78d60edcd8b0f68025e89f873100b0ba3fed1eee214347dbb8c09d5c42d9,17606085772
20181224,"PAYMENT SENT",0,-50507488672,1326c516606fc141880f5bbead72dbd976de3a5a1ddd41fdd6db8d258260f38e,16343250981
20181223,"PAYMENT RECEIVED",1252306725,0,4e1c60e1e52cbb8d3703b65c5084c00ca40f9a48acb71e12a953c1968ccb34a3,66850739653
20181223,"PAYMENT RECEIVED",1251313795,0,a18be025b1121b39372602192b1e5e9dd93e4c298488aee4b4705c647bf94cc2,65598432928
20181223,"PAYMENT RECEIVED",1250716818,0,9662176029b78a736d4238de6049b4db7679a69d50e59cd6a8d3a04b5f83b74c,64347119133
20181223,"PAYMENT RECEIVED",1259747668,0,8927b95ab93da712117c29b24912ffcfffe3b427e175a71645505437686bd8da,63096402315
20181223,"PAYMENT RECEIVED",1250388099,0,36df8ccc20e1b7b9a29e27303878b39581c724d3f14d6e1ccc0b6866e8b9ffc3,61836654647
20181223,"PAYMENT RECEIVED",1263907213,0,e512e08ebc02944d45a3faba0f4ddf35cc1aab6597fb409680605deb640d5803,60586266548
20181223,"PAYMENT RECEIVED",1256874684,0,17ba3a030d20234eac789fce6b123d0d1d1993908341b46d181d0f62e27b10fc,59322359335
20181223,"PAYMENT RECEIVED",1268770799,0,0029c619c94edf65582ae2cba9401897a7b27e3e1b98c411234ed6e32d1012af,58065484651
20181223,"PAYMENT RECEIVED",1256021023,0,9918e43286d570f8f77ad272002c94d85cb92484a175dda84f5d21d6add35014,56796713852
20181223,"PAYMENT RECEIVED",1250032102,0,520dc2c79bbeee8f0eb515a91e37468b1b91ad4464071d1ec44a00306d9bc796,55540692829
20181223,"PAYMENT RECEIVED",1254443341,0,14f32cda178fb7c98527af1778bb8d7e2fa4a784e33186d92c3563244c94129e,54290660727
20181223,"PAYMENT RECEIVED",1250231701,0,30a8ba676a60160689524a447dac9b07700c06045e8dd4c131fccd5ae94b9cb1,53036217386
20181223,"PAYMENT RECEIVED",1259860407,0,c42b09a6e6f21c5e88d7c2380375cf2c67412e843de82d14fbabe390e59a6994,51785985685
20181223,"PAYMENT RECEIVED",1254325901,0,30efff24a435107f7fb4d199676bdd63d14b5b3a9270b85f0485b778c7afc59f,50526125278
20181223,"PAYMENT RECEIVED",1267166803,0,4b174f69fc11bbde397cd5bb8e6dd5469992d11a09a5fcac365580d3cd482007,49271799377
20181223,"PAYMENT RECEIVED",1253310483,0,27894b02aba6991729a0510591d680ede4e3b0cbe361339e8517afff1744e02f,48004632574
20181222,"PAYMENT RECEIVED",1250269713,0,fe0d48bde30abda27b8a66aacdd16de855d7968c9e664edec1ae024e9a725fac,46751322091
20181222,"PAYMENT RECEIVED",1253784361,0,843d5571ec28cc7c9c576fb78db556c3c60239af2564dce9cc45fe2992692a83,45501052378
20181222,"PAYMENT RECEIVED",1259372519,0,3a152d1376cf6a28f33b47b9bbdb72e0927096e02d2c63b6e0371547b5a5159a,44247268017
20181222,"PAYMENT RECEIVED",1251013050,0,8d6ff36b9d5aaa857d50a3ec65e6a0ad6ad3314485b5dcf5e3f59a77bc24179e,42987895498
20181222,"PAYMENT RECEIVED",1261925585,0,a9f4c9ac6aca3df3dfd6d6d09b3e9f031b0f450253852a7ebd0b61caab09a919,41736882448
20181222,"PAYMENT RECEIVED",1254157926,0,6798be738d30cd7bab9ac533ebf5303e50db0acc54ed3f00732a94ae6da577ff,40474956863
20181222,"PAYMENT RECEIVED",1253247606,0,75e3fa9e839f82e0d3d6a2d64436d9b5b4c3ca36a28bbc2f7c56e7db205aafa1,39220798937
20181222,"PAYMENT RECEIVED",1253641084,0,7e47d58d83b7fc2ca43209b22921bfa568102810c716c75c4f30dfd138fc3e85,37967551331
20181222,"PAYMENT RECEIVED",1274745852,0,8431db20b1c9e2490357918715532c65ca45d8622281ea3beeca621ad5393390,36713910247
20181222,"PAYMENT RECEIVED",1267923771,0,ebec270b0d5cf53ba1928e75e56d02b323f4f37f39f7ec01b1a3c0b9298048f3,35439164395
20181222,"PAYMENT RECEIVED",1280292134,0,7133732f96ad97ebab7df9f787d2e3f27de93c14109e9a9627bd314bb0d124b5,34171240624
20181222,"PAYMENT RECEIVED",1257384883,0,5a478e5c494091084c9050d4a9b2029af5f4bb0ff00eacef1cca5c48b7684239,32890948490
20181222,"PAYMENT RECEIVED",1270041212,0,c69b91ec38ce5bbaf229ec61769b4d2a3a7b90e961f4377adc110d51a512d5f2,31633563607
20181222,"PAYMENT RECEIVED",1259288635,0,12a19fe07ef65400716a485a62d4fc2679523edcdcd4a7db09d3a017e8ef1ac0,30363522395
20181222,"PAYMENT RECEIVED",1253814912,0,f5431969c9266b851d10e6da9408460418ac6f4cc1176a98f130bfe592fc0382,29104233760
20181222,"PAYMENT RECEIVED",1259781886,0,2d7b910d535a5b79f438da1d2158e283ebc330f3a5994318413dead061af9644,27850418848
20181222,"PAYMENT SENT",0,-49676575511,d43b6ec6d117b139f641095c9217dd687b28c8c7efd71c349d8696751dd45aff,26590636962
20181222,"PAYMENT RECEIVED",1259743917,0,c22c8ea9467e884d44007ff47c87eaa510bb7890eb0e345bf55adf02d82ad6ba,76267212473
20181222,"PAYMENT RECEIVED",1262758468,0,5a94964c478368b02469ba45b0605ec179565ff4cd12d84c9f48eb803ee1fc60,75007468556
20181222,"PAYMENT RECEIVED",1253144039,0,f5dab4c49a87d6278ddbaa53e2059c832d7507e2dda4682eff54fa01b76764bf,73744710088
20181222,"PAYMENT RECEIVED",1260544930,0,59dd16df1de1ba362cbd2ec832704b44cad99a92a4b6013af9677f1e72cef487,72491566049
20181222,"PAYMENT RECEIVED",1260551165,0,726dbafd742feaf6b05209e4c63df69b74405647c20614514e6aab360209f0d1,71231021119
20181222,"PAYMENT RECEIVED",1251385679,0,9e746eb00e7189f3bc235b9caa13fb96d2b8b9c1010a8c12a6dc4473575805a5,69970469954
20181222,"PAYMENT RECEIVED",1267622750,0,149d2a37de1e06a2558807b1d285203203edf4b3a0a715b13cbeedc7a8924890,68719084275
20181222,"PAYMENT RECEIVED",1260040984,0,90e9a53b58a716c33a19260adec3f258c3f08a491798d985a2383695e7e1284e,67451461525
20181222,"PAYMENT RECEIVED",1261475191,0,a1251a1ff7e992bcb928cb24b05f1dc69bc01530f762570f6cdaf605b9a3ddef,66191420541
20181221,"PAYMENT RECEIVED",1274748544,0,5dea990eb49980a378ff54a392fc44c934743cb4c9d50e3b8e5fcda18d296c1d,64929945350
20181221,"PAYMENT RECEIVED",1250572068,0,c1618de84cb6f66103ee71e889050ad52911bb85fdccdd4fa69f08a2b3d70820,63655196806
20181221,"PAYMENT RECEIVED",1256429806,0,4dc5f4bbd8b5856d58b84d3cc38049f31c53ff75f8a57b46c2313f56e8a351c8,62404624738
20181221,"PAYMENT RECEIVED",1274115726,0,5b165f263370b8ba7a42f1066989de4bb61395bf73be3c5744156faeb2b3fede,61148194932
20181221,"PAYMENT RECEIVED",1269586098,0,1fd6ee31e88c3a3641a51caa7e3a36a8bca78b3a127b5f4424b6bdecc36b8eeb,59874079206
20181221,"PAYMENT RECEIVED",1313317493,0,8719d3b65285cf79f4fd0c2f52bbcecf6289d5c6320694eb085124d00d0ce512,58604493108
20181221,"PAYMENT RECEIVED",1263263101,0,3126ba3770b89cd0b9fe2d74ccbdb93531ae4aeb249f2a11ab6976a214dc3f14,57291175615
20181221,"PAYMENT RECEIVED",1309044188,0,f26150bb733a1fc6fac8ec201b6fc4a8a436c8ff1451512bb507275c2a3f3462,56027912514
20181221,"PAYMENT RECEIVED",1297241257,0,a55ca362e94aba31a960172a07c67d835c2733d73bc8ce61c2a7caa7e84f22da,54718868326
20181221,"PAYMENT RECEIVED",1259651954,0,bae0526c4b96623bc75da1283962923bc9de5ef7b0500913c18037c112f27c96,53421627069
20181221,"PAYMENT RECEIVED",1275000922,0,f32365e22700c7dc06d8842ad9aafe9775cbcc5fea5d38fa5b910f736696bd86,52161975115
20181221,"PAYMENT RECEIVED",1260921723,0,4a1b0f66d06e893ea51fb6835f5682cb05b0ced33671e94d86a546854f22df7b,50886974193
20181221,"PAYMENT RECEIVED",1264873348,0,f67c12f947fbb9a3ec087ca24d6276b972540e8ec3f99d99fc3aeb3c12a231af,49626052470
20181221,"PAYMENT RECEIVED",1292770616,0,ab44d0c991dcbe1bcfb5928d79a0e132171040c90eb1bda57e7f727200d320cf,48361179122
20181221,"PAYMENT RECEIVED",1258763432,0,fa0cf56b1ce97927427cd776ceca24bed6cf4ee35f5804ce1a94282cd5703a84,47068408506
20181221,"PAYMENT RECEIVED",1273914944,0,470eee85119b90373cd057a23518ff49bb714d6a341ac58d5083af05c8711001,45809645074
20181221,"PAYMENT RECEIVED",1281432827,0,9ce452b228993f7b86a900438fdf0693a4963b329d08cadcafe2da804d992ec4,44535730130
20181221,"PAYMENT RECEIVED",1271821618,0,8b26628bb0a57c12cc4f5d6b1dbc223ff30ad82a19243ab3f56ade59b87c199f,43254297303
20181221,"PAYMENT RECEIVED",1252648395,0,8c69ec21107ba1480980366e4b7f8433cc3100be8a37702e90b5acd8cd205b58,41982475685
20181220,"PAYMENT RECEIVED",1278128158,0,66d2d0c9b592f55b7e28b3f9270fdcf428fd2c8406e7b3e953203bd087ce467d,40729827290
20181220,"PAYMENT RECEIVED",1284291187,0,9943efba21a890c0445ab43ead66ae582592c23e12566c9a5de75d17b7e012d0,39451699132
20181220,"PAYMENT RECEIVED",1269523389,0,3bb33ee44d90750c4e7518f5c871f88705aaa1fc8efddf76009f7dd9a3e07c87,38167407945
20181220,"PAYMENT RECEIVED",1272340399,0,65132ea1b5e4dea30741104704ae97695c404429139c3fe91311b687721e242a,36897884556
20181220,"PAYMENT RECEIVED",1283691439,0,91c78e3e8b02341191e5b2ab73b4526eaf4e54802a2e4c7497391e6b958e09aa,35625544157
20181220,"PAYMENT RECEIVED",1295451846,0,df55224e2d92a1032b963847472340057e743eb72ced09b19eecc42f1b8d086d,34341852718
20181220,"PAYMENT RECEIVED",1272877197,0,98e5db7310ecfcde6807567c1259c5d6076a58ffa7e9b5d808ea3af0391cd213,33046400872
20181220,"PAYMENT RECEIVED",1277802583,0,5ddd93620c7a75bbb3a7ccb48d2e1c81d4cf8e74b5e3b84b1d801a0110b9c949,31773523675
20181220,"PAYMENT RECEIVED",1292788156,0,684286c5cc0a24bb8bbe6d9d258d1f8b565e1d4f55264db4ee73e3a91a6f3dfc,30495721092
20181220,"PAYMENT RECEIVED",1275859824,0,990dffdd3a4f0e896ac6e71e9853ab30ba1dd8633f64192b160c9653b872229a,29202932936
20181220,"PAYMENT SENT",0,-50716364103,0ac9b935d6199a276af8e7f7894589dc576bc6faa647f4504aef16b88f35e23d,27927073112
20181220,"PAYMENT RECEIVED",1272721323,0,a01c7a9b885c18f5a3f7b957eeeefcba2f25dbe384f75fe4aefdd1919ed05d7a,78643437215
20181220,"PAYMENT RECEIVED",1263633756,0,65c0c0b8eae3e2947a89dce09f06ac006e31c65dfaff0a181e62625595582bd1,77370715892
20181220,"PAYMENT RECEIVED",1257349967,0,9c19c6c19f9f4cfdd3676f5e2231931e3c478a64a1e9028cc4a885e4c8d1b7d6,76107082136
20181220,"PAYMENT RECEIVED",1276287996,0,41d5aeec44fd7a86e94622afe2136e9177a9ac8966521628dd2043700c3ec580,74849732169
20181220,"PAYMENT RECEIVED",1251851248,0,6a04a276188b6654b39736e85f878d4e2181e5a0fd116c5e0528087a5cb1c48c,73573444173
20181220,"PAYMENT RECEIVED",1270361776,0,537c64d0286b424291c634e583343867bad562300e3415b249f1eeedd324597f,72321592925
20181219,"PAYMENT RECEIVED",1271515724,0,a90b1b967ea1f41c3db8778197bc6a8546cc127120397a63da1a4165193ac800,71051231149
20181219,"PAYMENT RECEIVED",1254421593,0,d9ca91caca4a1d6a48b79469cc1afe1321053ab7f9ac212a0f7c5b9c1765d2f5,69779715425
20181219,"PAYMENT RECEIVED",1283593153,0,5313d4c9592c614fd712d3d46bc965f8ef3438bdc8493d695060fea0c1386ab6,68525293832
20181219,"PAYMENT RECEIVED",1303117637,0,9f3d10b82ee25ba704b56dcb50fccc30e55e471ad30e15fe782731a454c56c33,67241700679
20181219,"PAYMENT RECEIVED",1268483602,0,499239fb68bfaa049689b82db01f1ae2e5bf2f407909110a913cea4e22ee3a88,65938583042
20181219,"PAYMENT RECEIVED",1272310886,0,6ea3f499877394441028a0ba4bf867bf26b362e785450720172e3d8d3866a651,64670099440
20181219,"PAYMENT RECEIVED",1321175489,0,4439567dd6006eeb912d7b25aefe0607fe44b48ac990137e8271698f7fb075bd,63397788554
20181219,"PAYMENT RECEIVED",1330165529,0,cd96a3ca3305445f41b3b97b23d24952d512a236d37db0bfc81ac558e0db2fa1,62076613065
20181219,"PAYMENT RECEIVED",1268365405,0,e57b740b27fd3377815c973817246fa5c19fbf4f62adbc3d76956f0ef31e50f3,60746447536
20181219,"PAYMENT RECEIVED",1266878686,0,79fd9a48c72c5f62805b4cd8d23b3b06e13ac049f27993790686dadf0f7dcda5,59478082131
20181219,"PAYMENT RECEIVED",1274871995,0,b5113be336ceeea5aefa073acee97e730b91324e08f12f6985da3447a95db37e,58211203445
20181219,"PAYMENT RECEIVED",1255891111,0,568603219776f69fe28f1c9334bd3fea512b73f4d8ed4678df21f5b865b374e1,56936331450
20181219,"PAYMENT RECEIVED",1256077309,0,3a9a752c2cdee8511db04e44d1e41ebf69b737d586569e6f85d6399d3fcc2f4b,55680440339
20181219,"PAYMENT RECEIVED",1266116047,0,395bc428d9db2b5c6a54751129a1480b4ee0d079036c0fb87357587104fef00d,54424363030
20181219,"PAYMENT RECEIVED",1254126045,0,77449499503f6dd1c4e0ae8d9bbdd439ee8fb97d669e4030d96630de334a7932,53158246983
20181219,"PAYMENT RECEIVED",1276799253,0,cfd249b0c9aa4e7d365b360923cdccfe5a77634530a553621076def579b5cfa8,51904120938
20181219,"PAYMENT RECEIVED",1261846395,0,d249aad456d57b4a7e4188bcfeb35c9c8b2ef27a6e95d50c75451b7132a4c7aa,50627321685
20181219,"PAYMENT RECEIVED",1250056622,0,58e6f7e3b1c463531159ef9685106aa4a337e2df527d80011c5ef9c46d90391d,49365475290
20181218,"PAYMENT RECEIVED",1255560490,0,e425ff7dd60acb19d361cefde7854c9e904b655d48874aebd9c66e7c7b398061,48115418668
20181218,"PAYMENT RECEIVED",1261660573,0,0055051d17a8ec686d9ba3bbcd1c3a528db5d994d386fc46c3694228916c7422,46859858178
20181218,"PAYMENT RECEIVED",1268173305,0,12640b35a624b0979e3bc000636988c575a1d3705393afa42a9ca449949a640f,45598197605
20181218,"PAYMENT RECEIVED",1273744075,0,0a3967a05160821edb102191d8f8ffb797760ac756ad47a9f9106a3b9827971f,44330024300
20181218,"PAYMENT RECEIVED",1278515223,0,713b4619b565108fbd8c6b26ccb89627cc20c3231ecedd58ff7f30d41f8e3b32,43056280225
20181218,"PAYMENT RECEIVED",1283802130,0,d6145c43db20313c8795c742ae3df5ccc5ab9c46d1e56ac69a703a8157fec4fd,41777765002
20181218,"PAYMENT RECEIVED",1273797876,0,e826d9319579fc44d6279cf006ffc493eeff31673b1963cc2ebbc98b565d3ec2,40493962872
20181218,"PAYMENT RECEIVED",1291536141,0,a4332dee985c780437676286cb1c7a956c366b04edf5ae2562a5cc34dcfe3d02,39220164996
20181218,"PAYMENT RECEIVED",1296292589,0,e5741e64526ff0293abd898a17f65012a88403a4add78153a487988121a37931,37928628855
20181218,"PAYMENT RECEIVED",1271349756,0,d56fb4c5fa845d224dbc22e2d136881c2a6f7d6379b7b60853ccfe6189af0424,36632336266
20181218,"PAYMENT RECEIVED",1261693121,0,1fd56aa878e25f788db27ed97ee38384e44d708fef04f956008fda12b8c90abf,35360986510
20181218,"PAYMENT RECEIVED",1313987526,0,8fe871480a517f91b3b1dce924107b61989381683bd9b3d09e8604125205d8b0,34099293389
20181218,"PAYMENT RECEIVED",1259994524,0,de4ef5e6b9945fd03b888192f73ab921b814b9b441205a58b7eaf2f6cd22a536,32785305863
20181218,"PAYMENT RECEIVED",1257510280,0,b2aee28a89bdde3deedbcfef7c0595feaef7dc7a8b6abb346be09c186f076be6,31525311339
20181217,"PAYMENT RECEIVED",1252986235,0,77994955623556ba6a18030ee339f85e989961fa50a016a27412bade0d210c68,30267801059
20181217,"PAYMENT RECEIVED",1255092058,0,62f44704ff9ae902d9a95fe41bfd208cceb4f045f1ab33dc9511ab1e7655daf7,29014814824
20181217,"PAYMENT RECEIVED",1268511048,0,5d28618132cbf21ad13d7813d745c6bbf7ff77642e6f95b0868a5a074a22a963,27759722766
20181217,"PAYMENT RECEIVED",1290570399,0,8f49fc33cb2475d8322e3dfcf5e802cef639e061f7dee2e88eaa6161c6b31875,26491211718
20181217,"PAYMENT RECEIVED",1264808218,0,6e66ffebf3d6ddb9af45594ba273db9e7cd20ac5fc0d9fb84c43cc4111f12449,25200641319
20181217,"PAYMENT SENT",0,-49380449207,6effba0002e3795cf721a38a29393bd5df34d3ebc77febd04b9a7214c4352f87,23935833101
20181217,"PAYMENT RECEIVED",1260445430,0,ca5c90cd9a6d0425f1c22ea7321aab9aea0bad32eb1e325c6dc009bbbeffac81,73316282308
20181217,"PAYMENT RECEIVED",1256829795,0,e3a8dd3926846a651c8bf82a0c10858b2757015b837775855726060ae74161a6,72055836878
20181217,"PAYMENT RECEIVED",1253149611,0,ee990a297348d075c733a8f2168dab6c59a93c41cbe66d396cc31a2527a7b90d,70799007083
20181217,"PAYMENT RECEIVED",1259664943,0,9c2eac3613d667e3d28bad5098f25a7d845de06904cbb32b8a90977082cb4cac,69545857472
20181217,"PAYMENT RECEIVED",1263902663,0,0d02c1bf122b6aedd9cb3400c7ec5d66f44bc5206d500c291080d0b2e4bf0ce6,68286192529
20181217,"PAYMENT RECEIVED",1257150771,0,13402de5f94fe6e70dc7f989f0a8d7ffe5481f02a430809151d81650f67bf43a,67022289866
20181217,"PAYMENT RECEIVED",1256828966,0,bdc64702c5d6beacf4d06b528530f6740a384efc39d01a18e498fdb7499e9cb6,65765139095
20181217,"PAYMENT RECEIVED",1276772985,0,bd63dd0558ee85c75723aed81dae7e642535231c0bd522865bab587506c79ac5,64508310129
20181217,"PAYMENT RECEIVED",1257950459,0,e815908697f0072b4e66fc9c1b82601f12818feee390c0589b722df63e1f6fc7,63231537144
20181217,"PAYMENT RECEIVED",1254503003,0,641839b95ad3de5507e758731331f22b07abade0cfdf0d84c7cbd97be34dad96,61973586685
20181216,"PAYMENT RECEIVED",1253083293,0,a6a12e149078971dc253102173075a5cb92152d08f8a5cce16b11cb0996ae79d,60719083682
20181216,"PAYMENT RECEIVED",1264347987,0,8a145aff8e93240eed3540689157094874964f1476898a0c8a8e4af6418f8b7a,59466000389
20181216,"PAYMENT RECEIVED",1254940075,0,d720efd3864bc1f74467b0a4d45fbb66817a0bd93b1aeb100c9853fab14a94aa,58201652402
20181216,"PAYMENT RECEIVED",1250191336,0,b1e0af1a20d996855c33e6a2aae4daa25db75dfcd17ceb0563805502e266690a,56946712327
20181216,"PAYMENT RECEIVED",1261212055,0,f516e5c634cefd7c5d63161d1555ec83a71d3bb210594438f9bf906f097fb563,55696520991
20181216,"PAYMENT RECEIVED",1264345791,0,4667ed447a42227074ad53a937440e055029d2d1dee9dc4fb24fc451770a5979,54435308936
20181216,"PAYMENT RECEIVED",1251341372,0,dba8c78b7794efce7e7bb4eb1147db53fc8d14eb768e5eba5403bd960186cc14,53170963145
20181216,"PAYMENT RECEIVED",1265854570,0,7142d036101bb896082ae51ca7e1a99a51520867fefd12d0cfed67861574cb53,51919621773
20181216,"PAYMENT RECEIVED",1253635047,0,9172f3b414d551369b08eed34599a5733f9cf61e135d2f39f16ae85aa1b04551,50653767203
20181216,"PAYMENT RECEIVED",1261495475,0,0389113f45d56b662acb755d9741acd737543bd6fc77606e030528428b713913,49400132156
20181216,"PAYMENT RECEIVED",1291112260,0,25a65fc3029b52e4d40c0c60a26937ca243c44a807c6daf775e4710ce1708e6c,48138636681
20181215,"PAYMENT RECEIVED",1261233994,0,09adbe998fe85a64121822ef5eff490e1bd7e22b72369541c7cea345a02103ee,46847524421
20181215,"PAYMENT RECEIVED",1257610028,0,a334ea52df42d114be56c012dff4ccfaaeabfa32bc371ad92b7c6aaa1892a40c,45586290427
20181215,"PAYMENT RECEIVED",1260842264,0,847e46f7d2348d5a811d20b1c2af4532cf9506a162817fa84be1fb88c563a5ee,44328680399
20181215,"PAYMENT RECEIVED",1250452088,0,b6a82599e2a4683d7364a921e95c90684ec3c97a1444e3e6b772e8f548d2c305,43067838135
20181215,"PAYMENT RECEIVED",1274249010,0,fc13178278728962b8024b5aeda436b4b33fed79665e5b709181178ce0e2283e,41817386047
20181215,"PAYMENT RECEIVED",1300412113,0,4192c32b2ca4e6da10c9fdb2a65c63631290e1235da752c50374c8800e480782,40543137037
20181215,"PAYMENT RECEIVED",1275417741,0,8785be4eddc0d313bd9fb072d29f1aac8c2fdf7bf517b4904ae19fa7147e886c,39242724924
20181215,"PAYMENT RECEIVED",1267367765,0,72155889a286e8eabf9c4b5a4cc5f0e06c4055affdfc53713f797ef0d7ac6f31,37967307183
20181215,"PAYMENT RECEIVED",1260184625,0,80487217b7e9cac0becfdac03a71e90b9678efb15181ee5a89bf7beabd4d5eb2,36699939418
20181215,"PAYMENT RECEIVED",1267733098,0,36273458405d96c67ce8b10363f212fff559cc35474495284df49de39f04033d,35439754793
20181215,"PAYMENT RECEIVED",1280893158,0,295c673769bbbb024b2022e0cace383ce078ac54514459730c46cfafbbbe90b9,34172021695
20181215,"PAYMENT RECEIVED",1257198628,0,07a732f54ddec4541bcaf41796c99780805d72c40145ba5826ce9a98a0b6ffc9,32891128537
20181215,"PAYMENT RECEIVED",1250505136,0,7a6e59fef9001481c7549ed02211b6a684154ab7c1813e7e2a587ec5676d3891,31633929909
20181215,"PAYMENT RECEIVED",1252745235,0,555ae7225473fca2612270a315dc305f6018da14fa2cab1c57bac67cc9f35959,30383424773
20181215,"PAYMENT RECEIVED",1264521824,0,571237943cbb0188510b9f3fcc1d660939318a5dab9386c8127d9752a3bab299,29130679538
20181215,"PAYMENT SENT",0,-50781500363,1a4e32fc45f6d25810900537d6c839eef7cb625b0710c9a4549fb4c0dbc4336d,27866157714
20181215,"PAYMENT RECEIVED",1255003344,0,16121ca61c5dfa7aa86c419ad65f72fc6dfca7f5f9f8e8ea6161df30867eabab,78647658077
20181215,"PAYMENT RECEIVED",1261893531,0,ec39d89ae2470efd607503e4852565c146cdfe2ab501787339fc8ead3e50957b,77392654733
20181215,"PAYMENT RECEIVED",1261392625,0,c0b2ced689db056af25f0e627ee60b462b235ab8e7b4791ed11ba63e130888a6,76130761202
20181214,"PAYMENT RECEIVED",1256553232,0,018ce73a6c0ad9e2cf0619ee423042a21ec8d61fef47c48b89d6cef2e51f8783,74869368577
20181214,"PAYMENT RECEIVED",1281230733,0,40147ad3e42612bddd5d304ba12eec9342d50a8ae747201eb2761bf532024f2f,73612815345
20181214,"PAYMENT RECEIVED",1255732783,0,a30b8969d90ba6e2b47b8cf6e05b57ffd4ad9188cf5729f97aec2dc86457a366,72331584612
20181214,"PAYMENT RECEIVED",1253177473,0,c8a2481c408152a2c94521e2d7c2af80ec8cd692483206b21f9d6707dd3176b7,71075851829
20181214,"PAYMENT RECEIVED",1268348787,0,00f8541f2250f6bb351422e5739cee983bae938ab902c4f1b57175a6d4f15743,69822674356
20181214,"PAYMENT RECEIVED",1278018745,0,f80f8d306dd3359edf938647f8baba34302e9223cdb0a7dfe264e195b312a04e,68554325569
20181214,"PAYMENT RECEIVED",1264542681,0,97c441140cc0d8b91591dc609b91594f84a97310589c5bb516b4d469073dc6bc,67276306824
20181214,"PAYMENT RECEIVED",1264127278,0,84808824de56fb5c159caef9239de4d4e2bee7ea9139eebd1297f8b61b4f31e3,66011764143
20181214,"PAYMENT RECEIVED",1283641635,0,e37dcb0694df985c3417e2363d9f41621b40b5199338ed739094c9b19ddf6e86,64747636865
20181214,"PAYMENT RECEIVED",1262841733,0,d4eab0d3e6fece68d94ce21254a5792f65e741ff07cfd4b900fa18170890ccea,63463995230
20181214,"PAYMENT RECEIVED",1274012707,0,b410d34415fc87f29cdaae974235f7da303be9c6cf63a71bb807053491175cb0,62201153497
20181214,"PAYMENT RECEIVED",1250702507,0,8eb4f590f8805c2d71b32067dd39e6cc49aaea3582221ac80f7d03a88ec94d3b,60927140790
20181214,"PAYMENT RECEIVED",1250005141,0,2d4cdcd29d0004c762790b579bc2541da788f042031fa87fc27e402244080394,59676438283
20181214,"PAYMENT RECEIVED",1260987360,0,755a5e4daaf8717beaaf075de70cf4ab82b5676fdbe440e8334753309422db6e,58426433142
20181213,"PAYMENT RECEIVED",1271336009,0,28f408ab147278b483797c8482bdab8715b7315ed93f5f423c8f7aa69b3e1c0a,57165445782
20181213,"PAYMENT RECEIVED",1258004058,0,5928cba8e8e74c79b2a8d43d0bf973703cb200ef542bfbcaf3885b6a36f945ad,55894109773
20181213,"PAYMENT RECEIVED",1260403460,0,4d98c33dddcfa47bfea4f7e9ad2d19b4a0bc315bcafb1a7516cb86e69041590d,54636105715
20181213,"PAYMENT RECEIVED",1283710231,0,86750358b97ada6a2284c258f28d5856ff46f2b22c47f637e8865bf5c878e6ad,53375702255
20181213,"PAYMENT RECEIVED",1264768829,0,5f2437ebf3e1014252cd731113fe18a03634b5fc6eb6bbfcc418e1c26338ea5c,52091992024
20181213,"PAYMENT RECEIVED",1271309459,0,a901b640677163e1b1422e69b62d92dce50ce857bdd0426b46abd5dc5a7bc72a,50827223195
20181213,"PAYMENT RECEIVED",1277649961,0,e240c1d069ba38b4af5cd85f16467b340c084cf6659394f02d789b467a8ce253,49555913736
20181213,"PAYMENT RECEIVED",1291362506,0,669db9ad6f5e3da252131782a3abd000c99b13888733d2c7b842f1aab6655b6f,48278263775
20181213,"PAYMENT RECEIVED",1301910803,0,aeff625cba0a5c7b3cec2ecd90539b419ec7932709fa4a276d2994b0e9b53f90,46986901269
20181213,"PAYMENT RECEIVED",1268262116,0,ada884923fa23e57b6cbffec7b919e12db139c7426490dda69d8f8902fb8a0be,45684990466
20181213,"PAYMENT RECEIVED",1257235373,0,0032a73e2f677ae0365ddb073c73ce320fe18a5b060ee014bda99b241295a413,44416728350
20181213,"PAYMENT RECEIVED",1285377369,0,9b9a44d842dbbbe9f3e64c7c5cc14a292afb264632c90ee8de0fbbe7d0164763,43159492977
20181213,"PAYMENT RECEIVED",1254471895,0,d84480179a0b83ebc32be0fd1cdcfc573a92deaa0a295ff72a278ddcf87a8652,41874115608
20181213,"PAYMENT RECEIVED",1256541461,0,fd7780e73a21b975d5ac93eb352effa85f95c7ce1582f60c0e05718440a3f4aa,40619643713
20181213,"PAYMENT RECEIVED",1253674730,0,1fd4966f470e34297816464cc7258d1cb5ad1a05d39cfd0c1341bb69e1cd9e03,39363102252
20181213,"PAYMENT RECEIVED",1274751984,0,5696f144ebe00445091088fff783f4a7ddf6817cb9bc28ab80f5eeec2f60f3df,38109427522
20181213,"PAYMENT RECEIVED",1282798619,0,028a4dea9db02a4b3cc28150b8c936c3f985e08d727430d4bae1223e1de335fb,36834675538
20181213,"PAYMENT RECEIVED",1281342384,0,a8edd922b806ced13f3e99b13e9f1e341d029a33c079fc17a0b4b99c2166fe83,35551876919
20181213,"PAYMENT RECEIVED",1262972950,0,7f65dedc5dbf06a5519ae73f79c1b8d87d7bb2adeb9e96ccadfdc7c7333b092f,34270534535
20181213,"PAYMENT RECEIVED",1255883530,0,35639dc2ca2bc73b44b1c0f5e7cee65f82430e9ea18a63abac58489d214fb059,33007561585
20181213,"PAYMENT RECEIVED",1262284897,0,71ac7754e3a0fc70320c5fd88b928f280c68075b2cc50c60a5e04ffb72a6a8cf,31751678055
20181213,"PAYMENT SENT",0,-39516478071,e40c875a9becf558867ac6df5174eaaefefd7deb48938952d91239e54417894f,30489393158
20181213,"PAYMENT RECEIVED",1253612848,0,165d1a23fa025154e8f2ddc8de3ede957db0ecddf6a29779a801088f7dce377c,70005871229
20181212,"PAYMENT RECEIVED",1255912958,0,24703c8ba27468e305ffe907987dd9dbd04ac58f02184a63599322fadfc8301f,68752258381
20181212,"PAYMENT RECEIVED",1253850883,0,9721bdf0869e6abd163a88a301df1875a21b9643fb2b315735ce1c1ae426b56f,67496345423
20181212,"PAYMENT RECEIVED",1263672483,0,cba1bd9ae9dfd0b99af71ac51f09654664883605f315d0c56247864d8c5ef63b,66242494540
20181212,"PAYMENT RECEIVED",1268728610,0,8f2767eb07b7a6f0021fd3e4e8ee690cfc15229d7eae7e83ffbd5f7a1d8333c0,64978822057
20181212,"PAYMENT RECEIVED",1290563161,0,74e6734e6012a0217ef6c83673098d1c07a17645bc509e63aa363355790cfda9,63710093447
20181212,"PAYMENT RECEIVED",1285321414,0,48d21affb8800e48fe751e6d9679ea9836b097cf7825040cb295f10fb9a32526,62419530286
20181212,"PAYMENT RECEIVED",1298280533,0,1af35d8215e1694ab40d319f8a71713d9b13035b0ec23e2772c67cd21d88e7d5,61134208872
20181212,"PAYMENT RECEIVED",1286617445,0,3db3ff9ffa30691318d17f1b9a937371a967e699e34f3cff3f346eaedd23fd54,59835928339
20181212,"PAYMENT RECEIVED",1281263707,0,b5bddcd89ba46e7c8645d00fc6ee3f756e6eb5738cd39e697611f37f5a523ff5,58549310894
20181212,"PAYMENT RECEIVED",1261032356,0,2e9bde7e2b03f5ae666e0a566186b4d1e6d0e36ab803549c75d608d1bb6fcccc,57268047187
20181212,"PAYMENT RECEIVED",1259834137,0,5ad20198234d5f88dbd06f07546b5940aa3de7e3f4c1552477c456e0450cc314,56007014831
20181212,"PAYMENT RECEIVED",1254810797,0,31398778362279558d4e398d0cfbd7bb9a04bdfbc3945d68e97df1dfabc362be,54747180694
20181212,"PAYMENT RECEIVED",1259085118,0,1d475340c7b61815016714e54f82771f988490424a504949f98aa942d00fe800,53492369897
20181212,"PAYMENT RECEIVED",1254992139,0,1ae503c189c9c8323d63ab093df7da697a60adae43d1b5606891da8440f8b63e,52233284779
20181212,"PAYMENT RECEIVED",1260178457,0,d5c7e04e830fd71e2e29d98a41a507e54ba1f46e7f6b7a2634480d6608184b48,50978292640
20181212,"PAYMENT RECEIVED",1277003026,0,e30ca96f522c8c7884e46793cd7a298886acf4aca70dc47673029bc321aa9efa,49718114183
20181212,"PAYMENT RECEIVED",1266116721,0,5956d45188cdc75d1d7a083771379b2350db64b64a750e5bf1a5cef2b375a2c1,48441111157
20181212,"PAYMENT RECEIVED",1253854692,0,976ede5f779ff730b5874125a17bc4d0bbcbd095f3e00f340fdfea423cedacb6,47174994436
20181211,"PAYMENT RECEIVED",1271891150,0,fbe94c2f0ac6e23b2cb7d092abe0f4bdca02fd78bbbd18c5ed97c19753e7d2be,45921139744
20181211,"PAYMENT RECEIVED",1263995312,0,cb0ebeefd2c9ab042bab04c8e7e45732b56ff80a7fbe8847e453a350a2b7ac0d,44649248594
20181211,"PAYMENT RECEIVED",1262090217,0,0d569a87117ec9753e0c6da01bf5b665f247db7dbb0251b3f96e34043165ed0b,43385253282
20181211,"PAYMENT RECEIVED",1269090209,0,d8acbfbee9f58f1a00e9ab269c853f8799c89a464085f534b56ff588da62c5cd,42123163065
20181211,"PAYMENT RECEIVED",1264472359,0,7dd75ac81c11c2afd6254329bbecfdd6696387aae1440daea12dd2fe8ade5116,40854072856
20181211,"PAYMENT RECEIVED",1287596873,0,c5f2e17eb1d2b422e018b0df8260f961d1c18e7ef5e5b5bfdd12e4fa3f5e9093,39589600497
20181211,"PAYMENT RECEIVED",1276012803,0,19b5f6b3b18889cb4429428f32e8ff910c792a6a9600b61ec9013cd173a78fa2,38302003624
20181211,"PAYMENT RECEIVED",1271766757,0,4b1d6007b43b37c30310e04bcaf380d9a4cab8b47fc760e8c00ef0c8953ec4bd,37025990821
20181211,"PAYMENT RECEIVED",1296571767,0,7b5e337d817d9d33a64e1f2cb3cfcdc0105dc64ba434c64cfd67dad3a159e7b8,35754224064
20181211,"PAYMENT RECEIVED",1271091057,0,13ea51cd21d5e0aeb8aaef6670e046831e09b1b6181f6453f028ae530a8669fb,34457652297
20181211,"PAYMENT SENT",0,-40548100627,1584aa93fcb95a2ab9f134a32178ed12bba997b3c65dcaf5c034f11a067196c5,33186561240
20181211,"PAYMENT RECEIVED",1274116838,0,f153369ddb3f0e79deea13b89851bc5f135e91c1ef8e1fce74db403e185de873,73734661867
20181211,"PAYMENT RECEIVED",1267139331,0,2deeca6d43019bd024433fc4846ed7e2238e6c12179a953012d2114e9dbf75f6,72460545029
20181211,"PAYMENT RECEIVED",1269281832,0,a294f89aa891af3b5204d51e900fa83a27d02d702009311cb3ebe01f08407a74,71193405698
20181211,"PAYMENT RECEIVED",1257002779,0,a9133c2d301373667c26d77630dd065da60a77eb6a3054b6daa43e792452c426,69924123866
20181210,"PAYMENT RECEIVED",1254573621,0,c471e3f51b6b02de031c1f039982a5b05a994cfbe60ac8426c88206fefe121c3,68667121087
20181210,"PAYMENT RECEIVED",16923,0,6fce9c4c551f8f3d869c2b6d76f71666e11ae153c5422d0f36f11d3700ec2ba6,67412547466
20181210,"PAYMENT RECEIVED",1264337059,0,e467ebfee834a97f1d9060d909c8834184f2fddc60273f88005664f7ce150225,67412530543
20181210,"PAYMENT RECEIVED",1267784753,0,e3ef6028f9aff05c4cafbb6d83d95ae9bd91c8503e4bfa2d9dde7c0a8bd82d67,66148193484
20181210,"PAYMENT RECEIVED",1311850700,0,b1fa4ab73284700a3a7b9baf6dfc417334fcbdfe74a48f7b878ff10df47f33f1,64880408731
20181210,"PAYMENT RECEIVED",1280160427,0,5fab0e3fd31fa364454754962ed5bf9b3bd070fa90ab8448323a670fe0267c12,63568558031
20181210,"PAYMENT RECEIVED",1296328174,0,dc3707dffb3636288a6e8ee4d9921dd55093ce78a114854921c5ca1d7a46216f,62288397604
20181210,"PAYMENT RECEIVED",1251875210,0,c9cac251821a7312e1116f8c8f7217011dfa62c8744dc0fc213e8b3588a77be7,60992069430
20181210,"PAYMENT RECEIVED",1282570393,0,155cd9c466a703cb3d3dca0c1f3979b474b7152df3edbe93efe54daba2eddd8f,59740194220
20181210,"PAYMENT RECEIVED",1286800723,0,a72efb891bc24cfeecf78d59a0a1672b593eaf486684e01a3883c7daa27d7684,58457623827
20181210,"PAYMENT RECEIVED",1265469555,0,ca755159bb8861a3e30b8ef34b88247d05cc3b004345c1e7b0543b139ea592b1,57170823104
20181209,"PAYMENT RECEIVED",1251053909,0,6ba6bf9cf0e1fc97f0a642547ecfbd62f421e486360cf4c9513c9cef81da1f96,55905353549
20181209,"PAYMENT RECEIVED",1277841061,0,98d385feb9ef0f1ecbce841cbf31637b5f730c64666c54ac98778c4117801370,54654299640
20181209,"PAYMENT RECEIVED",1263609954,0,c427b69805767ea44f5fa935e89da8027d3c4627c7ae38be69b4cbb8fbe82820,53376458579
20181209,"PAYMENT RECEIVED",1255725669,0,2ea3d8aef59c1899fcdbad13c6ab2b579cf7d3110dda47307f2e06e120b71374,52112848625
20181209,"PAYMENT RECEIVED",1268014803,0,05f569a69631a3aa8a66a8c7ebfad49a5c578a71c7c69e00f68d4431607366ea,50857122956
20181209,"PAYMENT RECEIVED",1257267687,0,f02317e62dcfc1f064e7222aa6bc709fee608262f6a3612913ced8f915e21d40,49589108153
20181209,"PAYMENT RECEIVED",1283178563,0,aa5eb10826ac848bfa19b2cb2e9b7f2bd213e18af520dbbaf3bd908e31621ce6,48331840466
20181209,"PAYMENT RECEIVED",1253535799,0,58017cd2972d0361bae8c87429fd4d18c2d993378e5a2eac00b095205095b3f9,47048661903
20181209,"PAYMENT RECEIVED",1263489080,0,cc032636491bef7cd3c07297fc46d2b09d92a9ab87c8fd500ea195b4c6dec6d5,45795126104
20181209,"PAYMENT RECEIVED",1294008118,0,ddad37c9b335765d8f6fe46c5d3c752f3c64b31de03585b230d135a37a8389bf,44531637024
20181209,"PAYMENT RECEIVED",1259722771,0,75976b9bbd11c7c214e838bba2db415aa38ccc060c11ec61ba8b373b0cf2bf1f,43237628906
20181209,"PAYMENT RECEIVED",1251702991,0,6639dce276b56ac39280b4178bd473c049d8c3a0d84c37014f0968f87e874611,41977906135
20181209,"PAYMENT RECEIVED",1266051220,0,cdde80a14acfeb78dc36e67520285fc238ade775096dab9db1586fc54e014735,40726203144
20181209,"PAYMENT RECEIVED",1252104316,0,a3c995db3ad52a771ea7de6a1aed3b935ae3b3eeace3d8095d785be351e947a7,39460151924
20181209,"PAYMENT SENT",0,-39371765714,c970641c81d92e96a11cfe19f82625caf86668bd19b9a8b222f4a897902547a6,38208047608
20181209,"PAYMENT RECEIVED",1263233989,0,b8df8f18a8a0f785625e86ae4b879f88d1b3fbd7ff88672995a8aef1a7cc3310,77579813322
20181209,"PAYMENT RECEIVED",575,0,166a8f50342d089c333d962973168aec78e4ddd273d52856d1a0aa5c82220934,76316579333
20181209,"PAYMENT RECEIVED",28792,0,8c44f9d311b30803735f18757d4c5c63a0111aaa3751a2e93587c0fb04af2e98,76316578758
20181209,"PAYMENT RECEIVED",1284978569,0,f915339167b726d6df554b9bb40f17a8bc170c37b9a6f512b1f4fc9cee591f15,76316549966
20181208,"PAYMENT RECEIVED",1271251894,0,e4a6fb5f1c23f699ea37f67183ed1f9b4ea5c7b11b2701e153f80243e6b40661,75031571397
20181208,"PAYMENT RECEIVED",1280497605,0,059e3aa231f6d077b2fd11e4eac8fd0f2e23ee25f4cf72a405cd2bb30e9a1d22,73760319503
20181208,"PAYMENT RECEIVED",1259748342,0,f3e9092db932609eae8038cb045e1464be8160a9a9bd3ea77ffdd4a02fea1dd7,72479821898
20181208,"PAYMENT RECEIVED",1253176848,0,dde281e3ef6a6cdfada58ebe65e65935cb6ba0419f581afb08a0ad3d9af36437,71220073556
20181208,"PAYMENT RECEIVED",1257599796,0,5ce33cb00bcbd011754ab81f6cfd5076f8a03676e435d72afae5acdf7d5b473f,69966896708
20181208,"PAYMENT RECEIVED",1261033954,0,28176f584c25ab76f3061130c7f2edc1685df4970d30f564e4b927f775e62d9b,68709296912
20181208,"PAYMENT RECEIVED",1261144818,0,ddb61bcd4ed4d632f31943b98ca810cc6cebe0ea7f21cc7520f3b3a9d52c1e14,67448262958
20181208,"PAYMENT RECEIVED",1263496433,0,1f9505758352c38443696660f5b99edd76cf620d49c3047ae8701e92fb8875e6,66187118140
20181208,"PAYMENT RECEIVED",1275797754,0,2be6dd7c22f62151c521da39adf9ac829a32c1db082f1fcb3ed19dc593bc7928,64923621707
20181208,"PAYMENT RECEIVED",1275563782,0,78b11c09618aac1f7ce162a8abf877e663decc137e4a54e1d1e56b37166d255f,63647823953
20181208,"PAYMENT RECEIVED",1260098606,0,833a521beee6631a556d1b738faff187d9ca0175bfed72b8c0d983efbdf8f421,62372260171
20181208,"PAYMENT RECEIVED",1253394585,0,97132f1d785ed402707200eba5e100e0cf521f76baccaec8f0df797da3cf4520,61112161565
20181208,"PAYMENT RECEIVED",1259670310,0,8b674abe846f66ed4f2dc5b6de569c94185084aeabf43d50d434d7a5224e8c51,59858766980
20181208,"PAYMENT RECEIVED",1260622005,0,52d298c574432fec788a15bd0d4168750ce448eeafc317510d36c90aafca9af8,58599096670
20181208,"PAYMENT RECEIVED",1269129137,0,a4dc29f00bf52b6b9388f7fc251b6391366d226ce8b4751b9ccf05d647cda784,57338474665
20181208,"PAYMENT RECEIVED",1260317494,0,290508063a77e01adebc8395402f3db6fccb4ade9d72458542786f3b0c501343,56069345528
20181208,"PAYMENT RECEIVED",1251627447,0,931d7d8fca0bc675cf006a5881346ade9534e188a23e3405645fb9051ab600fc,54809028034
20181208,"PAYMENT RECEIVED",1250646331,0,33c9a24190dfdd9c70ccfb89f22d861c5488d22db3772f4ee378f4959ce1f990,53557400587
20181208,"PAYMENT RECEIVED",1262969186,0,eb760c786bdac20fcff627578affc412dc9ffe58442276227c6729b808fa4458,52306754256
20181207,"PAYMENT RECEIVED",1255016752,0,fe8a6aa5c11d287c7f879eabd9eb47e8ffd504f38e0528afca53e3a7b3b3cbf1,51043785070
20181207,"PAYMENT RECEIVED",1271295310,0,bbd9d606eb5cee98d5660812a333038f5fe9e70405247b2bb5297ab41ce19b65,49788768318
20181207,"PAYMENT RECEIVED",1262629169,0,7219b76f0fbdb38aab72147fc1342bb2cb50768de7b512d7f6dedcd24b77e11e,48517473008
20181207,"PAYMENT RECEIVED",1297277446,0,e339a0d37cf8b71883369b4cbea5314d5d87d24f9baf6ab6dcb4499bc8931400,47254843839
20181207,"PAYMENT RECEIVED",1286875506,0,59c5dee2a8eb4f1e3b57f036d6a45f40b37529dba555e3dca039a25b77a63b5d,45957566393
20181207,"PAYMENT RECEIVED",1277321729,0,5670f9a5875e298d197065d9b7b58dfbbb55a1c58f9336b13f13b5b02b2cfdd3,44670690887
20181207,"PAYMENT RECEIVED",1286850139,0,0b65bc3652e05f55bb2041184987a583c933bc9deeba02fc1482a9a720f5063e,43393369158
20181207,"PAYMENT RECEIVED",1318471224,0,d195580d10154677104a8796d6c443303a2412a581863e1082bf05c67d50e3c4,42106519019
20181207,"PAYMENT RECEIVED",1260403126,0,7dee79e53dd73a75a075107ebadf00c3aee5d3e9587bc38e5276d890aa2306ee,40788047795
20181207,"PAYMENT RECEIVED",1274066730,0,513c11962befd08b257fb99e5dc4a7de9ca729d911aa91368ac339e764713844,39527644669
20181207,"PAYMENT RECEIVED",1258365180,0,42f499005e0661cad30aa357d37cd63992d43ce541546e01bf187c002f1424b1,38253577939
20181207,"PAYMENT RECEIVED",1263508074,0,a70a8fd89a9d40ddf1040b580ff28b663549dc8bfa4aa8504e96335df45973df,36995212759
20181207,"PAYMENT RECEIVED",1299010335,0,70ebebb28c6ca02ea53495c7d499dc11f718e9a9ba7919fcbd66a868a0bd6897,35731704685
20181207,"PAYMENT SENT",0,-40628409899,37d0d623e9f7fff758d55d6a3c87104212df7d384f13deb26f2a1065478c9fdc,34432694350
20181207,"PAYMENT RECEIVED",1252565597,0,3b2db52cf126752feda86fe768d9407d762f9d4492dc1323618197e424fdee89,75061104249
20181207,"PAYMENT RECEIVED",1274823256,0,7f8cf06793801b6a24d92c24bd37d333d339c1730b027b4d7ff7e190f6f91654,73808538652
20181207,"PAYMENT RECEIVED",1289799332,0,26e4c84ac48a1ca28e9646936187dc6d0be7b9b58df10c7a124da5217ec18ff8,72533715396
20181206,"PAYMENT RECEIVED",1253803905,0,d5a5482483a5e18ff5ce0e460761007deb468d122f397965cbe435fcff380acc,71243916064
20181206,"PAYMENT RECEIVED",1284954744,0,93d73c0571d73290645b2740812f9ee182af493120d9f88b33546e5c9506f347,69990112159
20181206,"PAYMENT RECEIVED",1262894872,0,64437833dc46a565b4e4bd6bc6ca7729249580402476988b6a2e886f35226e61,68705157415
20181206,"PAYMENT RECEIVED",1297344845,0,faf225d878fc82d52254cf83136a6a8d4eb5f99756763685d4c4d83562b4265c,67442262543
20181206,"PAYMENT RECEIVED",1270166743,0,870f44742ed169042251514a56414fd83271a2bf91e8b9d15cb3c73c2e368631,66144917698
20181206,"PAYMENT RECEIVED",1277544226,0,c864f755711a023cf14d5abf15a1c02f366827fbcb5656ccd9320ff2b4bf0d88,64874750955
20181206,"PAYMENT RECEIVED",1279163923,0,deb743c053f961f38dc609e87b23d9c7c7ce08fd2b3f707ff4946a24e22a297c,63597206729
20181206,"PAYMENT RECEIVED",1276922418,0,10ffa870a4c945c9c6031051019a36c7fe44e661ffa9d5048dd65c1d2502b4cf,62318042806
20181206,"PAYMENT RECEIVED",1277057638,0,e7962a82f4bf139ec0454451ff5b356bb9cbbbe21643c80b279fdc5de72049ab,61041120388
20181206,"PAYMENT RECEIVED",1272271478,0,d26731468751ce6eb466eb114e442184a9775e3ab28781ffb68a666c3c547ef4,59764062750
20181206,"PAYMENT RECEIVED",1259324155,0,7222e3a704c3896cd00bec51b98ab70650adda56dc37bff8191384ea452b7a9c,58491791272
20181206,"PAYMENT RECEIVED",1264600024,0,5a40808be0c77ad05ec320e4d04b1ff7a081c32766cd1d1c6fae6c416b53be13,57232467117
20181206,"PAYMENT RECEIVED",1274078138,0,4b08f39754ffeeadcf3aa413ce2cf8cf31bcb30cb5e49f5519d52b51db64affc,55967867093
20181206,"PAYMENT RECEIVED",1269740364,0,bf2e04737a7c37d73e7bd89a802ac05cce376d79b736d7b435a9a011ec3fd618,54693788955
20181206,"PAYMENT RECEIVED",1307291922,0,b48ed632495162ab2574cff934b54eba0eca31ddf9d22af5a2822711047ddfd6,53424048591
20181206,"PAYMENT RECEIVED",1275200771,0,66457e46e5fc2b1892d3acb0c52e724cfed3a0144802ca1412dfefc7a7aab52a,52116756669
20181206,"PAYMENT RECEIVED",1269853257,0,11ad8a1cb92494ea454e3df63f912208a820efe80c6273fd55b8037fd7504f87,50841555898
20181206,"PAYMENT RECEIVED",1281439161,0,ded7d29da3137aeb43cb0b71a44f017e49be403bb5720c19cbeb1fd65d829f79,49571702641
20181206,"PAYMENT RECEIVED",1286292488,0,050395e9cbb895f79c5f24780aed9aa9149e40b42192f6852fb0869036672a53,48290263480
20181205,"PAYMENT RECEIVED",1260587831,0,599db8ec99deb2e09ddf194b9b5a3b27921bd2a98e90654f75efa4c82ff29536,47003970992
20181205,"PAYMENT RECEIVED",1289692345,0,2bdb087cca4ab0e20e08eb67c97b39e55484ba14ea1eee8dac4fd134ba10d02f,45743383161
20181205,"PAYMENT RECEIVED",1290457606,0,01c897074d1eabb2f35cdf7ff7e94cc597007ba8cffa3f57eaec7e3589738d73,44453690816
20181205,"PAYMENT RECEIVED",1256736057,0,575871760f1e8109141b45629e5916eccf1a0708349b3fe9ec8b5a0fa84ca8c8,43163233210
20181205,"PAYMENT RECEIVED",1262455518,0,6d012f0b1283e1aa6e80384b52844acfd9583c600148de13500bf31a8a3bf052,41906497153
20181205,"PAYMENT RECEIVED",1263110069,0,c90fe5c494fe8b2f75673aa8e0e654ca00319a627463eb71793b628cbfceb747,40644041635
20181205,"PAYMENT RECEIVED",1271992746,0,6bbca4a004a598325c4c8383fd95c2bf3fbf3e06cbbae353e2b9e7b2747ecbf2,39380931566
20181205,"PAYMENT RECEIVED",1279022342,0,aeb0b95a8e03763e5bb98e2e37a6118a989cee3778e2af507aab8bb46c8664af,38108938820
20181205,"PAYMENT RECEIVED",1267360393,0,fece9b8bb068d8918edc1268604214bbc94dbc37222a9536929444467647936f,36829916478
20181205,"PAYMENT RECEIVED",1276895019,0,5866e217c4b6f7f458bb920a0e384cb28aeb2b71d44e1bad68cd0ced0cd84ee0,35562556085
20181205,"PAYMENT RECEIVED",1276459938,0,36a248a318352acf5488d53e900aabd98fee9900d98db89960f0798c6acf8e85,34285661066
20181205,"PAYMENT RECEIVED",1285823631,0,3f457a618ae8ece5fd4c52e3d92207e8f1b0c1b05f8b7d94b810127dbe103843,33009201128
20181205,"PAYMENT RECEIVED",1266968292,0,e17d11c895a884be04ca9e99dfefeaeab2e0b9e97f4df9bd287bccfa7ff453f3,31723377497
20181205,"PAYMENT SENT",0,-39716221631,c15b7e9584376b1b3719dd586e22be029d4961117c4c5504bc2a46b3d6a82e92,30456409205
20181205,"PAYMENT RECEIVED",546,0,b325177fd9de6b8efa4706ae88f8fcb30e1ee9aa317d363302cf862cd33454f5,70172630836
20181205,"PAYMENT RECEIVED",1286973297,0,4bbe709cb1df953913c2d4482e756d6aced6331095b0e0b082eefccb81b824af,70172630290
20181204,"PAYMENT RECEIVED",1261552962,0,ee6776513ff7fcbe12f7cdef31739068ac96ef61ba8f58493dea7c8a71abbee9,68885656993
20181204,"PAYMENT RECEIVED",1263391729,0,7796beb786958164dc68523e7c33890a37ebca666436ca1825dcc49d431fe10a,67624104031
20181204,"PAYMENT RECEIVED",1275851460,0,ccfcd87ce8e8fb4ecb0bb15a0024902f45ab934cf485f274ae76d01ce73358b8,66360712302
20181204,"PAYMENT RECEIVED",1283805351,0,e13dd266370b667810c60c3994f8e4564983e941742e3e100360305b1af13d5b,65084860842
20181204,"PAYMENT RECEIVED",1257179800,0,1e3b6af1897caec467211f55a7d275fb5f70f97daa68c23acd5f0318748dd3d8,63801055491
20181204,"PAYMENT RECEIVED",1265736491,0,02f0e6ec5f8da431edfa692c53d6b382e22f3caaa197a5e35ef2ca12e96539dd,62543875691
20181204,"PAYMENT RECEIVED",1265209654,0,1e819ef0a16871325007d4028a7db894045c3cb04dded52dacc5c46188a465ec,61278139200
20181204,"PAYMENT RECEIVED",1276329920,0,80f3cbb7a300ecec1ab3b5d6ffcf74a971fb22b1c152cf4c271c8803b40dd164,60012929546
20181204,"PAYMENT RECEIVED",1264077792,0,eec16e5e5905620459b09c8fc2ac8791978200731e36954b119c3ec97ed109a7,58736599626
20181204,"PAYMENT RECEIVED",1286197854,0,d9e6340fc65baac99f018de3b0e9e3decffb3992201861d45082c5a269c71a24,57472521834
20181204,"PAYMENT RECEIVED",1288440013,0,f3ce2130ebd10ad74c8dd9465ea7f1871660239024d994035d35a0254dab1ff6,56186323980
20181204,"PAYMENT RECEIVED",1320235962,0,0f99d4364efbe8e8793bad817b38bf89c8341f179862c036ffbae2c57f3a5a16,54897883967
20181204,"PAYMENT RECEIVED",1264886383,0,830386f5992323a4e0da9ac07d444b9e0ef199e43da6a68085f295be14887ead,53577648005
20181204,"PAYMENT RECEIVED",1351508,0,222c8791d1cc1eed61376dd35053ca25c0d12530cedb6411aee83a9e1e7677d1,52312761622
20181204,"PAYMENT RECEIVED",1279495394,0,64d88a9faaf5363084a37bd56f5fab704dea4b3be7c680aa816b3b1fdc7bd65a,52311410114
20181204,"PAYMENT RECEIVED",1318810015,0,99bbc30a485044cdf754d207b000394460a9f137b02e12f0239751c7b04ff7d9,51031914720
20181204,"PAYMENT RECEIVED",1253471840,0,f80e21ef07e48d08b7099b9282af6d43cdb2c5a1be2ab60fc67c38aa6d4787c5,49713104705
20181204,"PAYMENT RECEIVED",1250416004,0,3c0b0afeb6302cca941e3c07f444cb1b1b39adc58438d93134128c7433daf1f7,48459632865
20181204,"PAYMENT RECEIVED",1258226397,0,3ea73f5ba78226a1b4ae42eaf3a3db53d60291f5cb3f1dd99ae4356fc531cb42,47209216861
20181204,"PAYMENT RECEIVED",1297533262,0,c2c187393c4528d47356aed240f888ca0657b6767cf3fbe55312124f69fc61dd,45950990464
20181203,"PAYMENT RECEIVED",1292251351,0,2260119d0f5b70ee53a2c46cbdd5e70877f4b87ebc9c9eeb9ad8f226b3203b39,44653457202
20181203,"PAYMENT RECEIVED",1272466916,0,c228bc53507141ef158dce5ac2814ce67f090c1a4fe62d617085c16752348432,43361205851
20181203,"PAYMENT RECEIVED",1292151278,0,9fac409580fbf85b9d0e50b88a4dc8159a3ec4498704a34be0f322c567c549ea,42088738935
20181203,"PAYMENT RECEIVED",1285670497,0,2f6259f785819ab036caca39ab36446c7a195ee3f31f2acdb5ce8b99a5d84e66,40796587657
20181203,"PAYMENT RECEIVED",1292994276,0,a535dd264745b54985bfaa5aae6c681dfe0e206b8d142b02d0f9554424c9995d,39510917160
20181203,"PAYMENT RECEIVED",1292978910,0,9211f811dd077915d0add1bf4dd59348d55bea0ca89248f9926584fe8a08dfa7,38217922884
20181203,"PAYMENT RECEIVED",1301328897,0,13355b9b21e75dd8bd3f9a1f55caceaced5295590a5e35d833e5edb07a06cb8e,36924943974
20181203,"PAYMENT RECEIVED",1286213023,0,3837b9f887621cf5afd09ad7151b7f3b61959e9dbee91a900f2d0796c7b1fb5b,35623615077
20181203,"PAYMENT RECEIVED",1293121934,0,8080cd2273971630adaff3523e99d2df9e9a71eabbe1649bac902f4a084f2fbe,34337402054
20181203,"PAYMENT RECEIVED",1279340846,0,ecde59e84d85c075b470bf8e71a833aa9e8e212c7e30001f94a06df17be66802,33044280120
20181203,"PAYMENT RECEIVED",1273610140,0,f5cef10735e385ece5bad0156dfb60c849ab18c1537456725db71cf109d854f5,31764939274
20181203,"PAYMENT RECEIVED",1260658129,0,fb7bf0f9d629d99d90f1bd9b4ecb6212c357af1458810d61b0f5b36944522995,30491329134
20181203,"PAYMENT RECEIVED",1259000941,0,8fabe25c696791cc69565b2f5cb878db230c2528775f8a165fdc9008ee12dcb5,29230671005
20181203,"PAYMENT RECEIVED",1262448982,0,d1a070e3989cf8297cecb835d8f864fd9b32e8db97fafc6b4cf27039d3f4b985,27971670064
20181203,"PAYMENT RECEIVED",1284762654,0,36466646fbce50e278835e91b5776fc9e7e5b0bb25dc9227e89bd94b953fc9d0,26709221082
20181203,"PAYMENT RECEIVED",1266447928,0,2dbc5b60d417ae5f090b88d499df5998f5fa3f30c885483e6dd96f60f59782b4,25424458428
20181203,"PAYMENT SENT",0,-39840290397,8a35e05e6468eca0225bf726cfe90e5453f6499873882a917dad58b1b2f29307,34226052856
20181203,"PAYMENT SENT",0,-10068042356,1c750fab16ccf4ed6cbbbb38e354dd861d2e40be61305f491fd68f1fb07947b3,24158010500
20181203,"PAYMENT RECEIVED",1273815902,0,8463e7219c59b97d2c85a2b344c209673193259e9608e35962e872f7a0b2fa21,74066343253
20181202,"PAYMENT RECEIVED",1262594367,0,c4e2ec81884d0b3ebfe98bcbb1e1aaccceed4eb1ace8bf6fbcfcd823363f72e3,72792527351
20181202,"PAYMENT RECEIVED",1257558918,0,89515b2f755dc9e6f5530071c0c42843d1ba3eb73d6ed193c6a0232aec93e4ae,71529932984
20181202,"PAYMENT RECEIVED",1260758598,0,518fae8b54831ff4f8171609f1e3a1c440a88c72350d035ec3886a541e0f6420,70272374066
20181202,"PAYMENT RECEIVED",1251910233,0,b2a8da76b85b20efaf59706ebfe832e2e3a01b93aa3a04a7da5257d2e2814cb3,69011615468
20181202,"PAYMENT RECEIVED",1281632952,0,331a9fb9b59119ea06671efb896e0cc665051a53111f30cbba61c9684a8fe0a7,67759705235
20181202,"PAYMENT RECEIVED",1277141948,0,dde37240ce120d38e1384f2bac2509c31e84fb05762a9d313c4bf9a258696a69,66478072283
20181202,"PAYMENT RECEIVED",1288481736,0,91f4f22e8a41f21c3249df26e993c578756c97dae1803cc7bc713372c4b4b00a,65200930335
20181202,"PAYMENT RECEIVED",1280801549,0,ba162e32663dc20ab2cd4868d50bb8a555eca5d8ac1eadd500b3b679f6401b6e,63912448599
20181202,"PAYMENT RECEIVED",1253498642,0,d8c3417890226cf35eeaa9d4f58774206c79fd31585bbdfb7516c52243c08158,62631647050
20181202,"PAYMENT RECEIVED",1274502968,0,6da4b5f2b36abe74c1065ebfd0cdf03e6f564a6c1365875477f1cde8d243c5ec,61378148408
20181202,"PAYMENT RECEIVED",1265770607,0,496ef8dd168ac09c5142953ecaade33fc881ac464be19e82e8b6bf538aa1eb7a,60103645440
20181202,"PAYMENT RECEIVED",1252661380,0,2059ab4bb4a2dfce9e938dbe8c2b4385f2966b51b81d66c260cab17b2e57b771,58837874833
20181202,"PAYMENT RECEIVED",1281333139,0,1d499520b3c4ba5bfa2c8f4197806189d52138420da2afa7cb575f4a1fe3b0bd,57585213453
20181202,"PAYMENT RECEIVED",1268100399,0,18fa3f53b5b0405e437eeb17ab824ce0b0eeb605f5daedbc55b21ae61b64e804,56303880314
20181202,"PAYMENT RECEIVED",1265057506,0,5e87f73a9bbc7d0840935654d0aa8d1a2bef37521c97bc0a6ef5cb75357f71e9,55035779915
20181202,"PAYMENT RECEIVED",1274797160,0,05e234396ef13df45aca282a0f3092afe4be0dff42dc3b9a0391c08e9be8d8fe,53770722409
20181201,"PAYMENT RECEIVED",1270252629,0,72edeb7d9bf9fa3f919f654cc832a2f498e226ba1a320ec2e77821860b762eac,52495925249
20181201,"PAYMENT RECEIVED",1258497615,0,f92676065ace33c8bedb15d86ea541bb7c9a912c4ae482a001376e71f3097811,51225672620
20181201,"PAYMENT RECEIVED",1253995369,0,84c09158085ddfda1e003e818c167e2cdefaa655b8fb2930bbee46d9fece13c1,49967175005
20181201,"PAYMENT RECEIVED",1259249770,0,04b5aad09b853b6ecfd35bd08baaa0837705b9901daaeb486dd2dc5c510c34ce,48713179636
20181201,"PAYMENT RECEIVED",1289921882,0,3f5fe63b9063558e1eb30e4d8828918b3a18bb6bcdd630edc59f2c0cb42801d0,47453929866
20181201,"PAYMENT RECEIVED",1297440792,0,502127bb055080dc0323080348375f9a3130aa0e6471a8dd3c98476411cfa923,46164007984
20181201,"PAYMENT RECEIVED",1250966529,0,b274392ba264d7763856907e22ef7730f6a04af7e21691917085539788711a00,44866567192
20181201,"PAYMENT RECEIVED",1310330224,0,b0733499d713034966919ecbddda3225edb80b42721d97339e810345ccfad06f,43615600663
20181201,"PAYMENT RECEIVED",1251952800,0,10fdc9d814e6807d072ecd767e35ebabc576f8c1952c7eb96713494bc44bcb6f,42305270439
20181201,"PAYMENT RECEIVED",1256778704,0,85c263de65c8b007b0b10f8cf1d33a9624ab9e980da7d5fa5179fb948d7302c6,41053317639
20181201,"PAYMENT RECEIVED",1251441665,0,8d9a8d67330d13adda5a005730ceea3e020a04cf975c129dd29304ee0c471d7a,39796538935
20181201,"PAYMENT RECEIVED",1312725355,0,13b941f3cd10cdd6550b9044a003e346b1fa67fa380d93fbf28d8223eb73b37a,38545097270
20181201,"PAYMENT RECEIVED",1293032573,0,d41384ad9627b4f4a55c4bb3cfc3eec8ac92331f619934d690d6afd6a94efb94,37232371915
20181201,"PAYMENT RECEIVED",1254110436,0,024dfadd0757611995fcaedd3d9ce16bd1191d147bbadb0e17f58470813243f6,35939339342
20181201,"PAYMENT RECEIVED",1272906329,0,82e4574b8c36b3f2bebf2733c3d27ebc284d9ee55d574a7a9eaf5cd5de95bfb6,34685228906
20181201,"PAYMENT RECEIVED",1252830355,0,3a9f4a82e5a0f30f35ed3666ba0232eb8f6579b317cb15893cbcd1d6eb3fbbe6,33412322577
20181201,"PAYMENT RECEIVED",1295054595,0,a12ab5dd6f7a9d218dd4dcb68d75682571cbca5957bca9de2bd39ad1ec5854dc,32159492222
20181130,"PAYMENT RECEIVED",1286740405,0,7decd76e766307674b7d70d9048c3fa4118174650e23fb19a7170130e01259ed,30864437627
20181130,"PAYMENT RECEIVED",1314854340,0,27f7a4d3c9b50b43a50fe924f228f4c80c8ce9a93c42dd22a230884678c31fd3,29577697222
20181130,"PAYMENT RECEIVED",1314251791,0,2f9367563512693ecaa59b5642fcedef2a27b3d404f516a985fda323cb9d306c,28262842882
20181130,"PAYMENT RECEIVED",1306559829,0,9c9789f752b90e29e685eeca529b82a3b665530a37c2facf91e0638160b7b4f4,26948591091
20181130,"PAYMENT RECEIVED",1299551118,0,4f8c258d5bd9bbe3be2abeff86e19b972c13b1309529faa0cc91179729d34ce1,25642031262
20181130,"PAYMENT RECEIVED",1326522549,0,e223209d694b26889201bd191319ed52645e8d5654c4f273bb9f521d58067fc5,24342480144
20181130,"PAYMENT RECEIVED",1309577518,0,948e683af5f228278962625ae643b5d874dbcaaca8e7fec1e929dc3b2fe7aee5,23015957595
20181130,"PAYMENT RECEIVED",1263648164,0,aed193f906fce3e7fdd04b9a0c2b64784e5b2537b11a9b4e2ca7b1710dad2dbb,21706380077
20181130,"PAYMENT RECEIVED",1272488614,0,a73d6abe97d7e4df3f9d3d3cb259a953951ec590c471e0da2a84b9e76a15c1e2,20442731913
20181130,"PAYMENT RECEIVED",1297279385,0,7297309b989a78119e1cdd9e2fefad962640886477732fab7592b6e92fa2171c,19170243299
20181130,"PAYMENT RECEIVED",1262252287,0,9fe4a04204a5bd2140894505c73e2599f749578815c5dff9d7b2a8c47e8a0271,17872963914
20181130,"PAYMENT SENT",0,-39686373537,45c7533cbde86cbefd71525d485477202f6a4c5140f5e1c366d2567f3f6d7760,16610711627
20181130,"PAYMENT RECEIVED",1306787699,0,3ce7344d835df648cf7c0b8be0152993ed41d9fc530b2ecb298e4184f1fcf98b,56297085164
20181130,"PAYMENT RECEIVED",1273768313,0,029c29f30c7f482cf5330373f7714c86a8acba0afd48dbefb38b2487db2fd5ba,54990297465
20181130,"PAYMENT RECEIVED",1272712249,0,0d2bc845b20386bbc85c0830551955973d0a24b86545702b6e6fe50675951909,53716529152
20181130,"PAYMENT RECEIVED",1270068122,0,2ce2b7c3cea08bf0ece17a7e6ba08632e1ed08e436503091a0d21539050034df,52443816903
20181130,"PAYMENT RECEIVED",1312489966,0,c4ce95384e06c41b71aaf32c7507d6b2e6bc46c6690cba845264b3ed1a7b3334,51173748781
20181130,"PAYMENT RECEIVED",1252466515,0,e6e8bd8db0a680f3de258466e3dcf3575a3fed7db4ede382188684361d77cbfb,49861258815
20181130,"PAYMENT RECEIVED",1253764853,0,a50b82d4429531100e9982f577423393cc05f5c83b5e28985c0aa2596fd3d091,48608792300
20181129,"PAYMENT RECEIVED",1255085556,0,887e8adfc06c654749eed8ae2c0bbb1f57ef919364dc70123aa195489ed7faaa,47355027447
20181129,"PAYMENT RECEIVED",1255793618,0,de9d9270bc2d5e692ca1aab15a4505337f015080d4d0be51612a97b09e1eeb4e,46099941891
20181129,"PAYMENT RECEIVED",1297258240,0,82d9add247d17eb97f4c0dc2ff08665b09850a473c3ce1bc1b9dfa5aaad45aa6,44844148273
20181129,"PAYMENT RECEIVED",1292707860,0,5ad61087da1060b377c2c84ec3dac3bc1ae8b7f7ad1037237bef12ffb1c30cf3,43546890033
20181129,"PAYMENT RECEIVED",1293788644,0,b800f0c52189de4a7703d38bb1409e3e2d00a4524be6f712a9a77e523d254177,42254182173
20181129,"PAYMENT RECEIVED",1262133409,0,da3116eda39b84382da24406e1ef6aaeb2ec6981d439dda6e8bf30515017a020,40960393529
20181129,"PAYMENT RECEIVED",1304123132,0,7c6aaecd8a1a19a99c857c350a52e4ca0eeb1ea07eb97ab3c85b31aa57cb8587,39698260120
20181128,"PAYMENT RECEIVED",1289210727,0,b9367fa88867a4b7076461f3474bb183dcbe771fab52320e76972cc66af3fa32,38394136988
20181128,"PAYMENT RECEIVED",1290276448,0,579c3099ef3e2f56926163d0cc278aeeb688e7e4a4b7af255f41a306d7bd1121,37104926261
20181128,"PAYMENT RECEIVED",1304560989,0,a9de4c5a57eff6740c3cc177fa2c9925558decb7fe97961fffb33146d43a0721,35814649813
20181128,"PAYMENT RECEIVED",1320500216,0,1bf8d100420a6857334f07df575316711219c65701db68e74506d6db7f4c7df3,34510088824
20181128,"PAYMENT RECEIVED",1281696367,0,7a7f29173acb4ed81c5cf3d983097d9e2c902c1b3e82af8d9a04e1c4a2c68db3,33189588608
20181128,"PAYMENT RECEIVED",1297307252,0,c08504bfb5eb6779632422c072aed6f56868b3f88a15372ee5fee2c6cc1162bf,31907892241
20181128,"PAYMENT RECEIVED",1279387261,0,61593ccb85e8c000729ec53ccfd6b9d43304d7c169bb8afa610cfd7f88cf7ae2,30610584989
20181128,"PAYMENT RECEIVED",1288851599,0,3f728e94753afff7fe87f9e90b04b5b0a2ce1b36e0ba40b96542db39bf2348ad,29331197728
20181128,"PAYMENT RECEIVED",1299534612,0,b49845013f073646f88ae6a201d9952281b03877bcd6d4f3d853944ccf30c5c6,28042346129
20181128,"PAYMENT RECEIVED",1295876886,0,b2c04ba9d055a2c1eb3c8046a530089cd326ad601d59a10f0a6f56c3cf36a649,26742811517
20181128,"PAYMENT RECEIVED",1263635279,0,25111ea3d4be23623e1f5f78ed5936bc4b3d501f93fb742f1249718158e8dfe9,25446934631
20181128,"PAYMENT RECEIVED",1269095423,0,6d14acfe7c4177760474e7a19dcdf89d7944f78a6f8aec0157dbce4fad8242c6,24183299352
20181128,"PAYMENT RECEIVED",1251006935,0,1ee010c53cbfee48ac604960994e0153ef802c59ddb3a0d791e92c4f23f92df8,22914203929
20181128,"PAYMENT RECEIVED",1255522490,0,ad00103789734f25f4aee4be35d553d5833a2f8dc9a22dab77da42e6b6907021,21663196994
20181128,"PAYMENT RECEIVED",1278258037,0,150e65530e18e793282bba303503384800a5d9f669d11aa5305c92bf6929bed6,20407674504
20181128,"PAYMENT RECEIVED",1274019992,0,b55d39bdee7ebfd77b1ae77c1633f7d285f9f6fd8d3e7404cd33d95d0d0b32c1,19129416467
20181128,"PAYMENT RECEIVED",1269426800,0,b09266143d5cba6d7cedf08e028b6779fc94739682688509514583ca6c570e51,17855396475
20181128,"PAYMENT RECEIVED",1285121011,0,27a4452f529bd679040dbce3fdf30736593c2a7b23391e2e516b16f220e493ae,16585969675
20181128,"PAYMENT RECEIVED",1284911206,0,2a513e972db3aeb7da949db11d4a31cfc94ad933e7258fef85d5447c607aca37,15300848664
20181128,"PAYMENT RECEIVED",1254620373,0,084363593dd051bcd49b24f37ba9c32ade8ff3d8c09ddeaf882322197eab4c70,14015937458
20181128,"PAYMENT RECEIVED",1253102428,0,64c4e6a96df8530e5b1275220a60d49f74f2d3fc81fe8fe93eab317b7d2471a2,12761317085
20181128,"PAYMENT SENT",0,-39657586368,626204aa949966073742434ef9be58b4e7342646a72061a73e9dea6056e4ed77,11508214657
20181128,"PAYMENT RECEIVED",1277122711,0,204592b805135f5c21ffbf3373a9b34d6c7effdf349f2f81aa237732a833a483,51165801025
20181128,"PAYMENT RECEIVED",1257523759,0,15e9f243a21a5a9cea17d97d209cddd7b116b0653a7a2da94a44990b628eb324,49888678314
20181127,"PAYMENT RECEIVED",1251084104,0,83796ada82ba4bab12c8d16dbec73ef6223eca7d192c790d0b1bb99aa5f7ca91,48631154555
20181127,"PAYMENT RECEIVED",1270639199,0,91e32a46af1e13a5161017176f55fb64a6d3a139578e233e0d15418486b7009b,47380070451
20181127,"PAYMENT RECEIVED",1289854134,0,10a5d2cc07d069bf3c609f6d8316c1a49f18c0aa1fc6ac6cbcb992d54638d641,46109431252
20181127,"PAYMENT RECEIVED",1314220473,0,ca3d28b2f8fe38e03cbffdb34e8dacf5c410fcaa3e4a9d243caa40dfe836daf6,44819577118
20181127,"PAYMENT RECEIVED",1297261777,0,a2131af5990762f5f40c2c3a924e2ea5c2abf0f100e471b893d1c57dae88dbaa,43505356645
20181127,"PAYMENT RECEIVED",1292676646,0,e7cfe5ad5b6bbcc9b61d3b83305a88199883685df91d048bb83500a47076fa85,42208094868
20181127,"PAYMENT RECEIVED",1257831854,0,bbe24d8b5906e187ced016d9a8165dd640a916b1bf8046a7b903696570adc36b,40915418222
20181127,"PAYMENT RECEIVED",1287674914,0,a8a612cd1a0c5998f53aa0f8ac709ad1205d1bbc6166baf0a4adcac011440e13,39657586368
20181127,"PAYMENT RECEIVED",1272624083,0,fcaa0d6b9782f75227587f41609733c4aaa63d1cbbc42f2a7f1a2279035fcc7a,38369911454
20181126,"PAYMENT RECEIVED",1259019888,0,c2ccc6755213853497b04a9e21a16ffc29251721404208bf96e35b6454e14c47,37097287371
20181126,"PAYMENT RECEIVED",1274208058,0,9d4b070cc398e14948e5d2ecf0a3f7338b688e9b20bb1a7d96c9d863479c73c5,35838267483
20181126,"PAYMENT RECEIVED",1286673895,0,1d544e27838aa6e63d05c0674172f833d7b69169ffbfb52e0683bbb6e6d6551a,34564059425
20181126,"PAYMENT RECEIVED",1292549884,0,7cf6a06797dad954b168c7557434066c3f50847e376120046770e3656d295fcb,33277385530
20181126,"PAYMENT RECEIVED",1288390550,0,6db4f0f9517fed23e7f94db4a7da7d548e6542f30a96af30e5ee1c0ea6ecb7b4,31984835646
20181126,"PAYMENT RECEIVED",1304817381,0,9d9459a97d152abfe3aac1f75b14a8e5ab7e858ade65087500b65d0c607c2094,30696445096
20181126,"PAYMENT RECEIVED",1297874294,0,29a8e13b3760f0f3bca95d59aefa4f3a4ee1fd3a0b46480f10d3272f4f571c18,29391627715
20181126,"PAYMENT RECEIVED",1311974004,0,06daf2421126dd8fda1952e00c50c5a6e6c4029295f11fa986ec3d4de371836c,28093753421
20181126,"PAYMENT RECEIVED",1269454447,0,83bdc98ef9f3c49b7472ccd236a4e3faf80e0a4daab5144e50f8870b3c8cb149,26781779417
20181126,"PAYMENT RECEIVED",1280399651,0,31c43fe812479054bc168f28f336c31fcf19451b1ba956bbde512e811f142149,25512324970
20181126,"PAYMENT RECEIVED",1276131400,0,2c65f882350a09ff374ed9adcd75193236b242140a64eefd09224381c6735a38,24231925319
20181126,"PAYMENT RECEIVED",1305167900,0,6d4ab4dc914aba1a06a7f2ce21dc1378338c3cf3881f9a7f79f2afe4793e7839,22955793919
20181126,"PAYMENT RECEIVED",1285193367,0,709b3bf3121798dcf70b887cf233527077e272e35c209d6703196707a14b8239,21650626019
20181126,"PAYMENT SENT",0,-50001024459,51d326df868c413389e06d381e2022b38c4c6ea889fccd9f91dfd2b2cc1b3bc2,20365432652
20181126,"PAYMENT RECEIVED",1265724080,0,396e1cf849498b2fae7729c01736ef96e9e4f27d2a88ce8328044bb8c7e28862,70366457111
20181126,"PAYMENT RECEIVED",1277160075,0,efa28a02b10598a0dff7edd72921967d3fb17f7dd9b4690f1ab77caf8a3f4cc1,69100733031
20181126,"PAYMENT RECEIVED",1322110401,0,62c548468023b2dda7e857b8565a8cc1868a010bcbd0325097e9968df3f1e9e3,67823572956
20181125,"PAYMENT RECEIVED",1269254705,0,b1944987bb845b0c160db362151083e7003c62798c817869afc28c3d788d1544,66501462555
20181125,"PAYMENT RECEIVED",1274746813,0,54ec8354672f6279e09a4e10c0ece5850c96bf17f2e9e9a4d7eca417c4ff4940,65232207850
20181125,"PAYMENT RECEIVED",1294908450,0,da75c2f9dde08fae01e02e2969d2f854bbb2d58703be7bb57862d72c64a5db28,63957461037
20181125,"PAYMENT RECEIVED",1291715153,0,a54fdc2dd76de7ae7cedf47a53411f842539d5b4cf9860d000a954b3ed407567,62662552587
20181125,"PAYMENT RECEIVED",1303031818,0,925348c726835bf65ac0dcd49afe378fd79319ca89ba36ab14db76ee3e4b882a,61370837434
20181125,"PAYMENT RECEIVED",1289049573,0,d2b5ad5a74eb8c0dd7b422b61afb7c30d3ace0b2c46cf4f1e27241ba9073c8e4,60067805616
20181125,"PAYMENT RECEIVED",1252763665,0,60daacb63823276705f200f7277f1d34300e39290ea12d2889624acf09f4b481,58778756043
20181125,"PAYMENT RECEIVED",1252270505,0,cb1135dd035c7aacb1eaaf7d7e055303f74c3fdadfd644e103d9ed429e173d2e,57525992378
20181125,"PAYMENT RECEIVED",1320948030,0,94ad00e6ae9a7a68e14b73e087fb84b3185d8074bb0aedd92828a639ee3c99c4,56273721873
20181125,"PAYMENT RECEIVED",1287115067,0,6b83470dce3cdb2659c9708228e052731658dcb7e0f1cbcbe934097c912a81b7,54952773843
20181125,"PAYMENT RECEIVED",1257807530,0,718511b74a9fb587f5d3bd022790245b760969ab94366e025037bb7dc353355c,53665658776
20181125,"PAYMENT RECEIVED",1267729733,0,18fc97a5c3c2e73fde7700f1e48c25697707b050834d407a0fb18aafa3ae0242,52407851246
20181125,"PAYMENT RECEIVED",1252910933,0,f88e06c766b77ac619b4e1af48e456eacf46465e8430c0e7f888399c1440db3c,51140121513
20181125,"PAYMENT RECEIVED",1278414965,0,0a4e78263a15f0b3db2e0dd173bbec58817135f4558a574a642567e06d716ed9,49887210580
20181124,"PAYMENT RECEIVED",1255842216,0,3f01fbbc86c811c947a587d2b6b747a7aef537c0c264964541c8ff504e1f6f66,48608795615
20181124,"PAYMENT RECEIVED",1277078067,0,d3c29709a27911b2b06c11de9c077a3df388605a4d175f6aa3c655796a44ff0a,47352953399
20181124,"PAYMENT RECEIVED",1274124774,0,1f6d992e1e7b633e52bdb3a3408415b25ccad6f075aec37b38d6b256a37e7d9d,46075875332
20181124,"PAYMENT RECEIVED",1278695498,0,788b911f5504b44fb25bf3c6da2ff3d02106c4b27413461fe667f6ab737892bc,44801750558
20181124,"PAYMENT RECEIVED",1298170798,0,df57b94e095adca1b8d90fa32c1e0a0cfd526ae03f544f2334514d3d4c4bd47d,43523055060
20181124,"PAYMENT RECEIVED",1250233483,0,83601312f2bfc57f5bc0d1c22404759e337cd59731b4cb071723b7f1a72e13ec,42224884262
20181124,"PAYMENT RECEIVED",1268311129,0,2e9d2ca34126aa0f0397bb670b35a0c85dfb80839faf21d80b59288bbe4fdb58,40974650779
20181124,"PAYMENT RECEIVED",1287329368,0,97c73fa2f5831f3033a30984f64c93df8fcc215a4fabaee8410fb2c1ed420ddd,39706339650
20181124,"PAYMENT RECEIVED",1254410333,0,d96f3272677567e49092a1fe605b30a110b3fae3a77858f81a73d48ab166fc30,38419010282
20181124,"PAYMENT RECEIVED",1261448543,0,c9618cade86602a86a3ff8062a7d62bd61c482b9576cfdaa3588b1407adb4663,37164599949
20181124,"PAYMENT RECEIVED",1255689897,0,209764c97892848eaa7f0060fd25e57934aa42cd26bfa13d4dbb471dfd7997ed,35903151406
20181124,"PAYMENT RECEIVED",1252630700,0,a2e029ae9052d4b79022eff802d037d3077ba2f9cf99d81af4fb1cb51d85f8d9,34647461509
20181124,"PAYMENT RECEIVED",1298250425,0,729f735788ed764910bb4cbaa1e6eef3f1f54d0f96c9968bc239f9ecad831986,33394830809
20181124,"PAYMENT RECEIVED",1252859453,0,6e4bf60a5cc2165d728fb81eec09cbf53bdb3d4f8fb0dd44bf9b835217d0ad3f,32096580384
20181124,"PAYMENT RECEIVED",1260336360,0,a63db070dff5bf5f6e9c4b7c29fe2b2fe133105ae5c3da83383910ff2ce2c971,30843720931
20181124,"PAYMENT RECEIVED",1271884772,0,fa227485ba35cdff88e7c59622978c934a8f4900dd72d01bc13e3157d13cc9b1,29583384571
20181124,"PAYMENT SENT",0,-40010972569,e870f7b2cef35e48cbf67570111daf86ec06a183e8ce6b3a6f4c9782b8818a7f,28311499799
20181124,"PAYMENT RECEIVED",1296278770,0,7e9cfaf239accb354c959d566ccdc24a23657f2a4d51ac6ffb4581a25ab01916,68322472368
20181124,"PAYMENT RECEIVED",1256210855,0,d32c23cc6d229c6dad7652657ae018f443296bdd31a138600bef935f1ad1348c,67026193598
20181123,"PAYMENT RECEIVED",1253535320,0,bd7f4930e06ff43d9e02c5d3ba7a02cdd2c71634ba83d6aa89c98df81b8da4c0,65769982743
20181123,"PAYMENT RECEIVED",1266732688,0,12d4bee511ef1f1fcc0e882b35a197cb022a5fd90deb5504890bbead20034bed,64516447423
20181123,"PAYMENT RECEIVED",1310116798,0,dbdbb6ca622a598f525b5a0ffc46de488bd0f0c810a81a3bf2d5b1438849e831,63249714735
20181123,"PAYMENT RECEIVED",1283760118,0,622c389bd497782776d08f907261d03b29e6b6add268c6e1e2f9d47e9db119cd,61939597937
20181123,"PAYMENT RECEIVED",1320192536,0,20d4853463b34d5dbe3424c0f72a0155e5011f03a3fec02f2bfd268d95e5c848,60655837819
20181123,"PAYMENT RECEIVED",1299525549,0,daf4ff28f8606b137e164c1f9d0d49c05f8842acc42810f00561a06de43a10a8,59335645283
20181123,"PAYMENT RECEIVED",1286691982,0,6c112e25e8f4fa25054d333a21667e7fb57c7907404670b1a257ed893d721d6a,58036119734
20181123,"PAYMENT RECEIVED",1301285196,0,4c128bdabf4ec02197d89dd988bbdb2fbf6a3112267b2c101657be68c5dbe106,56749427752
20181123,"PAYMENT RECEIVED",1305874148,0,d339fa7a9a1464e885a3bc637830d0d8208a87d7f43d1a7a008d34439c1ac56b,55448142556
20181123,"PAYMENT RECEIVED",1255683617,0,e31710b272b21cb8cac8f0cd54caec89b03550e23bdd8c3ca5752082ab60879c,54142268408
20181123,"PAYMENT RECEIVED",1289256107,0,e0b9477af5ec7667eed77f7630e7d3f59cf60a1a3e8743ee7967dcfa6987e250,52886584791
20181123,"PAYMENT RECEIVED",1304781377,0,d14a1662df417d2b590e2dfe36674e76d3220e6cc96663ed129a27c77f73b657,51597328684
20181123,"PAYMENT RECEIVED",1252333159,0,9357f0d369c1f88f3f0122f2a63684c2b32253ef7b1d59006dc54a490b4cbfb4,50292547307
20181123,"PAYMENT RECEIVED",1290226935,0,b1c5d389bea7fe7927293b606b4bd5e92fe6bd2b7bdf4ac8e5203c7bad60bd31,49040214148
20181123,"PAYMENT RECEIVED",1260716953,0,720894af13724f257f4c72c018906a524c19b85f57ad2c6a6d3f03a0f66e7470,47749987213
20181122,"PAYMENT RECEIVED",1279900860,0,09255539c514101fde2938fe5d4ad3ffead4d0c07a3ae5d9c462f29f3a43d48b,46489270260
20181122,"PAYMENT RECEIVED",1300923178,0,f7bdaac79778a9d29d54eafe2b77fe2cc664ff26233ea73d2ba2d9402143556e,45209369400
20181122,"PAYMENT RECEIVED",1267503984,0,3c57bd56a63a6be0863414582cca020a751fd7b9ecad331aca36bff901b35675,43908446222
20181122,"PAYMENT RECEIVED",1286770695,0,fa8b4466cc5bb9f85e3f80f0d803e77942ec0ae4ba85c18941558e89ac3ad381,42640942238
20181122,"PAYMENT RECEIVED",1303534468,0,76f4156ac63435fe02e2fc97e92a83761bcf46a1941a08e83dfdf69723b45aab,41354171543
20181122,"PAYMENT RECEIVED",1271370591,0,2f83b2522474f92c288f7bfe1fddb974f1d1934d85acbd6d73eddb3f2d11bf39,40050637075
20181122,"PAYMENT RECEIVED",1290757515,0,1e00b59a7f39b6db22ef119f87c8256cba8c5f30921d2981f16740ee371cc194,38779266484
20181122,"PAYMENT RECEIVED",1301276260,0,4a562ea92d811c57dd903ca2724e4bb6cdd1ddcb3a8f2bfa089eae9fe0f2c99d,37488508969
20181122,"PAYMENT RECEIVED",1320042815,0,56e40bf23193aeb24c2566bb45d5ba70b01858b3de0051a625d1574466b18949,36187232709
20181122,"PAYMENT RECEIVED",1279935614,0,c113d0195dd29aeae1e1ad571eeac60094ed0fef17472d8d00918ac676b492b7,34867189894
20181122,"PAYMENT RECEIVED",1291738924,0,03c03b03a74316c14f8095e447c4dd8a79e1650065cb081d21b6af7d98e88a3e,33587254280
20181122,"PAYMENT RECEIVED",1302110541,0,b1b9a89eb618557365b7b814a53fd3a363690565b27bdc1bd7b796675d3cc656,32295515356
20181122,"PAYMENT RECEIVED",1252297643,0,4dd168c3819bba74587fa28e5bc557b7a7a260730d1e5018c2a8cd95dd8be271,30993404815
20181122,"PAYMENT RECEIVED",1258258011,0,e1162c804a9684c014d4a40d585b6bcfa5c2ad072cca0f3dccb6f554be60a7cd,29741107172
20181122,"PAYMENT RECEIVED",1267933023,0,117d9492fba2e8a26fec651b33a230bde5e2f84559e2d68dac0232511e618390,28482849161
20181122,"PAYMENT RECEIVED",1272692326,0,020fa45fa93e7b87534478e56189cad6019973aa8eb943172585ab8da657b73b,27214916138
20181122,"PAYMENT RECEIVED",1264147034,0,eb30519ffabebb9bf57eb52b762e8ba3b4b53f41c9b4f19c72e8ec41a1a9ed7f,25942223812
20181122,"PAYMENT RECEIVED",1269278783,0,35a9c2ae1352bc30406786daf856365f994d8b8e76bbb191c81f03c2c81d805c,24678076778
20181122,"PAYMENT SENT",0,-25856578335,83063f115d18ef0baddb91722d46a9643306d4bc8eaffdb2049dcc9f70b825fb,23408797995
20181122,"PAYMENT RECEIVED",1257604703,0,4986d3130d5c2de3d217f5a26eaeba31905078aba509ca25b4aa8d2352fea392,49265376330
20181122,"PAYMENT RECEIVED",1275140704,0,86fd28151addc18d1be160bad056cf8e803f2932701e24588401a9ea16406ff7,48007771627
20181122,"PAYMENT RECEIVED",1263391307,0,bd3407c5edbe4d7daf3c8fdcf574ee978fec1fcffc0db8a66ee356fd1c96cfe9,46732630923
20181121,"PAYMENT RECEIVED",1304173784,0,1a7a0eaf807deb8d2f33992552a1609715e6e817264f1fda6ad2150c415b5c10,45469239616
20181121,"PAYMENT RECEIVED",1328815830,0,37ebeea09781fe0110aee00d86dd8748533c9000eafd30b2a911cb34a337b582,44165065832
20181121,"PAYMENT RECEIVED",1332870059,0,b8ea26ac26deedd9d44d1b08d477f6b177b9e72df1835cc2b1b964262a9f2916,42836250002
20181121,"PAYMENT RECEIVED",1271257350,0,ff41ba984d7a7c7805acfced12aaa716cb6de6d316133922f9b67dcc6028e7ee,41503379943
20181121,"PAYMENT RECEIVED",1285967031,0,859db4ff15034ed6683b987776582fad312f9549b8c6556ad73032c81237b395,40232122593
20181121,"PAYMENT RECEIVED",1322729547,0,d6db073e1a30d2881f85d5ed37f925407bfb9e3733c165fbeb06a08f33badcc2,38946155562
20181121,"PAYMENT RECEIVED",1289523149,0,36141aea56519d8ca653d45c2faa075fdd05739f36d6f3850ec2d90a0d400cf8,37623426015
20181121,"PAYMENT RECEIVED",1304619116,0,5cf6ef33454fd78c60932288a976c643014cd5163d11b03cffed730b9f66e5e7,36333902866
20181121,"PAYMENT RECEIVED",1327366583,0,220c30fd8dbc309907bfae6b8d43ad2f97a5da39c4d7ed3bceaad1142def2b25,35029283750
20181121,"PAYMENT RECEIVED",1302260503,0,de4db789b6ebb667bedc267c70fb756a53f9eb362ba1c7add19980795b8bb348,33701917167
20181121,"PAYMENT RECEIVED",1304990988,0,256c440a1668f069aae3c69ced3ee5548fce14031f53ea3aeaa7671dd503c01d,32399656664
20181121,"PAYMENT RECEIVED",1301196756,0,3668885b6d8bbc4494905484c755e3fafd23a685e65138f6233ceccac8438c8f,31094665676
20181121,"PAYMENT RECEIVED",1275479828,0,e1317578820a99d39827bb5c4aeb8761c838c35b35f531e04e1420db82f7218c,29793468920
20181121,"PAYMENT RECEIVED",1264760584,0,e0e0f70bb049ebc0c982d5b1b867b92ea7f0cf61fee8e6bbfea090cfa6957cfa,28517989092
20181121,"PAYMENT RECEIVED",1279140392,0,672b17b86401e913ab0a2560bbca65ac606dcb30344e614fda3fe7d5dd9f791f,27253228508
20181121,"PAYMENT RECEIVED",1334223084,0,a28b29cbbd739f95a2886ae529bc5ba248d47494c085f450e5491baa2f8a7a08,25974088116
20181121,"PAYMENT RECEIVED",1313838854,0,4856c6c6c61eba7b563b71bdcf413ed170dc51b3e9ea18205f287408140a6373,24639865032
20181121,"PAYMENT SENT",0,-24197685482,f7809d20b3b4077471d926b199cbf9c85f637ecffa9b3769f373eca796fa7c61,23326026178
20181121,"PAYMENT RECEIVED",1310209115,0,f756f0d0f06ed67d72b05f9aaad1d94442cf6ee2f80ada408d138376906a6dd7,47523711660
20181121,"PAYMENT RECEIVED",1312233478,0,e922c3aa9ae8557c0fb4f99377790ae240b609efe3b9a421664e4e87472eb81d,46213502545
20181120,"PAYMENT RECEIVED",1290547772,0,fc7e784ff4758e4f3f95f905682e02d8016c7ba318e7830e58d83fcbe526159f,44901269067
20181120,"PAYMENT RECEIVED",1296805365,0,be6f7f95429990abd272b1987dc9c9d82cd43e4f19dc8bdbed00a2a0e6f3d01d,43610721295
20181120,"PAYMENT RECEIVED",1312842616,0,e0f98115a5e51ab5ade3ad2b65c07c7a7d85ef7ea5a2ead2664006b6d8677f45,42313915930
20181120,"PAYMENT RECEIVED",1330163335,0,d478566fcf1cffcdeacd7536b2ac4e02851fddb50908c62ff0d9ad266931ca57,41001073314
20181120,"PAYMENT RECEIVED",1316136429,0,eda6dd2e19d07333ac84a502445fd8058217218981a2fabd3be7735dc440dcdf,39670909979
20181120,"PAYMENT RECEIVED",1313865853,0,caa668bc347831029449435fbaafcdaba09e0379fb31b45567f4d05b86270b33,38354773550
20181120,"PAYMENT RECEIVED",1291397134,0,4cd46bd61555282bf8cf5b7be829e8f4fe370315692e0c020bd40312abc2f458,37040907697
20181120,"PAYMENT RECEIVED",1306067414,0,48f2e495aa1ad9f15612ec939ae97364387bc4f5168d49f0b01ee11c1a0e7092,35749510563
20181120,"PAYMENT RECEIVED",1301644730,0,fba2e162a6110462461d5e36bac168834f72d3397a411cecd55aa0c5978817af,34443443149
20181120,"PAYMENT RECEIVED",1317075729,0,b196f662bf7ac671df3350e5e9a20f4e64a0c1005c3cbd7391ee0855e25d28e1,33141798419
20181120,"PAYMENT RECEIVED",1272012981,0,35de8869406c9d4250906608383814ae205145ca5e37a42bed5dd18b8187cd4d,31824722690
20181120,"PAYMENT RECEIVED",1310276152,0,2365d8a7dad0e07d7881593a514042bc4ce6b6aab52b8d14987fbb5df7717c58,30552709709
20181120,"PAYMENT RECEIVED",1292017814,0,e687c84fe18c2ce4ae327be14eea74a9a34226c645d116f0dcf7e4fc0524cfcf,29242433557
20181120,"PAYMENT RECEIVED",1286175674,0,8f8effb429f706105911a7ad5e8217f4ce9474aa564b3d1e4b5936d5a5553be1,27950415743
20181119,"PAYMENT RECEIVED",1305591196,0,17f2791598748d0496a249f994c133b987d77ec3ac811a2960111ec7041994d9,26664240069
20181119,"PAYMENT RECEIVED",1339100758,0,09ed9d39d5dab626b8d55dd0b36e63eaf15d7e19b34fa8effaae2cba8381d43c,25358648873
20181119,"PAYMENT RECEIVED",1269461286,0,4ab307ca9856b28b1729b5055c47f1fcc544c2155c15a1f4f00bf6bd5cf852d9,24019548115
20181119,"PAYMENT SENT",0,-40443216283,e8998dd1714eb77b8df821914f4d912387bc346f8e9d72865b725d4554a81a92,22750086829
20181119,"PAYMENT RECEIVED",1280217980,0,c9a53d5491abe0a9b139e6921fe0274b188513f3b5c9cfa47ce80427c3e60f2a,63193303112
20181119,"PAYMENT RECEIVED",1289441985,0,6ed92d9ccc5f8d07c7b4b40c2d82585d3b67f4dd8a86a8670d934eef412b6ecb,61913085132
20181119,"PAYMENT RECEIVED",1253737570,0,46e093748c88fff25121ae7756f41aaa4c6f832c05cf851fb14cd6ef0437d790,60623643147
20181119,"PAYMENT RECEIVED",1250554660,0,02d4bf033a8140c004b391b58f14de91f2f2b9d4f1fe1b9b0abfc0ea6a5a88fd,59369905577
20181119,"PAYMENT RECEIVED",1263564697,0,886128ab7b35e749a70d692e086d520d41c29c4b5b74bb08f35b581a3c6ce354,58119350917
20181119,"PAYMENT RECEIVED",1258340669,0,60d00f770f83c99e128c07a6fd6648b50b19fab3dff78cdd370d3152e1cd03e0,56855786220
20181118,"PAYMENT RECEIVED",1253344156,0,beb25a61da935e9478184c5a5d0b560e3064d67bd3aab7156f1ce45ff53ec366,55597445551
20181118,"PAYMENT RECEIVED",1258185825,0,df8c53869f24682cd0308b7538af21c77bbe500734f8ed1f634c73c6885d42e3,54344101395
20181118,"PAYMENT RECEIVED",1267596380,0,7324313382f1ce6e01bb9880b37e539ed102a04494eff1f2b3374065826ae230,53085915570
20181118,"PAYMENT RECEIVED",1278403787,0,ccb82176af7d5e97b7345215d0df83a5eaf45fbe58449db894085565eab8975d,51818319190
20181118,"PAYMENT RECEIVED",1262159460,0,2fc3bf5dac8f0655f6b03db0144b28f57223431f59360f55a9869ce275679faf,50539915403
20181118,"PAYMENT RECEIVED",1269543048,0,94cd3ed997b866d88060c6f3718d529def4e6d3f20f5c79c5892339f9983804e,49277755943
20181118,"PAYMENT RECEIVED",1253778319,0,a1c1c19346e46a59e067f9c1d38222dbadf3014fe66147f986f1d7b21dba1575,48008212895
20181118,"PAYMENT RECEIVED",1254710733,0,bdf14bccbd2b4a672a9ed01e5c238f1da6b2d9d1d46655c020474158cd6b4d79,46754434576
20181118,"PAYMENT RECEIVED",1250343129,0,1f6d61a5a3938592bc0445e7c71b9e01a107d036ce02b6961aecff57af9b1b55,45499723843
20181118,"PAYMENT RECEIVED",1277261208,0,22fb73c5df4948ba8d25d0f87ef8a88193179c733be168ec4670402aa72d8e6c,44249380714
20181118,"PAYMENT RECEIVED",1272703389,0,95db6e6784d1a28f65615d92c71309c63955b409a81c0980e8558e09a2bc6e6f,42972119506
20181118,"PAYMENT RECEIVED",1257230608,0,9ae57efda5b0d30e02d668e5bc351a03d7aba9c1496118b26fc806807d4e8947,41699416117
20181118,"PAYMENT RECEIVED",1260451686,0,8f518edd20c120accbd1be0b6f080ddec5a7364f6aa32d029fb088700e7ee353,40442185509
20181118,"PAYMENT RECEIVED",1257665112,0,b5183009703bd0a1eca9ba41650bc5026148bb03f2d9bf98744bcb09de927c32,39181733823
20181118,"PAYMENT RECEIVED",1263033522,0,4885a443e9031b15061f9237d569a9f5e8f8c6c011d7d94faedec455f0627c8c,37924068711
20181118,"PAYMENT RECEIVED",1251118333,0,a61e4d701533cfaed9793d90db4667dc50f7bef4deec19b3dcfa7a8e702bb3a7,36661035189
20181117,"PAYMENT RECEIVED",1253424397,0,566c8e47ccda1c987dd56051d5fac9119376169a8d1018e8dd56d7f9b62f3e40,35409916856
20181117,"PAYMENT RECEIVED",1251752205,0,526b10c47483e66338ec52520bd9ee5a7ccb0294330ca9352195b9a2e868ea03,34156492459
20181117,"PAYMENT RECEIVED",1266457405,0,6f016290bf726a59e8c136f76970ee657c32030e52fd56c31dcc4958bf96a6a2,32904740254
20181117,"PAYMENT RECEIVED",1262460074,0,a80ef4c98483ab08af93921a0af00bbd882429e833dbbaa45aabd49565733c08,31638282849
20181117,"PAYMENT RECEIVED",1284170690,0,7c8d8e881821f56cf39797cbc5f160acf4135e1cdc4e3a92db86bcf526a9a6b4,30375822775
20181117,"PAYMENT RECEIVED",1256134838,0,ab2b5b0e721cf1ee4500d2ecbbed328534094aa4efc69b374032d9afc277b13e,29091652085
20181117,"PAYMENT RECEIVED",1250076461,0,8300da79ab8e1858e546c59b53680f9c5c39b6e1f552164b13f34e838cb2897a,27835517247
20181117,"PAYMENT RECEIVED",1291631987,0,b98f006ca5a99516b7f538fa4ba96be19537fac99f29554073313cac0761b443,26585440786
20181117,"PAYMENT RECEIVED",1293636096,0,3d8ee85f04c496ad33e8e2f77bba76dd6961c6f60428ddea13042c93f6a13763,25293808799
20181117,"PAYMENT RECEIVED",1250070658,0,04537512273dadb87a3db1f0896f7367aa4763588e06a4c881e4b322aa1e17f0,24000172703
20181117,"PAYMENT RECEIVED",1279167922,0,411f20e424a74b0fa8b4568daf7943baf1f2209accc68423249c6e5efcb9ded0,22750102045
20181117,"PAYMENT RECEIVED",1257071323,0,2c8ecce2dad84bdb1fcc30eac5c48ec70edf7436aa9eb432a708e7c5cb712664,21470934123
20181117,"PAYMENT SENT",0,-38253089016,7e0e6630fa0b0d634cfa2e52ea0c609d1aea33af4cf0d167e389561325246fc9,20213862800
20181117,"PAYMENT RECEIVED",1255145600,0,d40b1639b4c797ab039a4e8ef813a99a34f4eef0880491020ce9c36df41245aa,58466951816
20181117,"PAYMENT RECEIVED",1252306244,0,4a0faea4291bda55463c6ec1250188716a4acc47b002163d40323308250471e1,57211806216
20181117,"PAYMENT RECEIVED",1258401051,0,9c47ed8775230cb01d228597562e99b9798a94edc771a110b39e09a7211893b6,55959499972
20181117,"PAYMENT RECEIVED",1261402309,0,a66e91bf62204adf9576ee72602884d8c3d85f1a56a5145b67aed9cc04be4e08,54701098921
20181116,"PAYMENT RECEIVED",1270681002,0,0435120bece7ce0c05d19b9e73a4902f68b1b13c8ca4cb638e3aebb83b570dfa,53439696612
20181116,"PAYMENT RECEIVED",1260713990,0,f8bdc50801e9f081cfdc75cac889f8489d576c0b623dc01c9bdefc7bec900131,52169015610
20181116,"PAYMENT RECEIVED",1284285067,0,75d3c08b3a99913f86322e2cbc6b34e83954ce25a6efdea651da02e4c965e523,50908301620
20181116,"PAYMENT RECEIVED",1251437888,0,3e612bbce15fb0741ea8ac617cde7ad1dd0611e81cc94056ae4c1fceda4ef259,49624016553
20181116,"PAYMENT RECEIVED",1250082905,0,caf12ab0d4fa187764963b2c393b1904d3789dee3243b90f8ab0aea6feb7aebd,48372578665
20181116,"PAYMENT RECEIVED",1273728352,0,e4f937a566edfdb731134b53ae47490be9e66017f2b8bedf72aa7dd8ff0db759,47122495760
20181116,"PAYMENT RECEIVED",1297152438,0,e1fcb273c337f71f9224fe7332f8fb561a156c33ff7ce4a7ebed3e9e02bfaec5,45848767408
20181116,"PAYMENT RECEIVED",1263483999,0,683bec3a987273f548f247769560e5365496a80dc5c408138156d792725060ee,44551614970
20181116,"PAYMENT RECEIVED",1294710045,0,89f1344c867b4eedef3ea55c6c58ffea5b0c774259a9c88744f34977fdf4fb47,43288130971
20181116,"PAYMENT RECEIVED",1283234579,0,34e96db4318205816498fa7497b01df68df326a8116e4ae9510eba61b4d51378,41993420926
20181116,"PAYMENT RECEIVED",1308544682,0,55172996a83393b79f27d6648e814eb2e65ed2a44c99cfec59e22a376ca3a759,40710186347
20181116,"PAYMENT RECEIVED",1288358619,0,369c7713b3bdfb95b8f00b135782fac61ae74daacdbbbebf28fee23514846f2a,39401641665
20181116,"PAYMENT RECEIVED",1270258536,0,4bdaaa11181994f93b3804072a235a934e43eb60ef4e1cb20165d4eeb2ea2a79,38113283046
20181116,"PAYMENT RECEIVED",1263061760,0,bf1a47474055f01910d7ca035785112d0771069375f554e273485ae9df95635f,36843024510
20181116,"PAYMENT RECEIVED",1256864425,0,9aed860d6aa677e255a8f9fe41cfe4177592ae3ba148e1dd124eb92a290d359c,35579962750
20181116,"PAYMENT RECEIVED",1255369980,0,fde7bb75a3845841e71a9354a7cb3392ac628f9bb4f8ee4d08b61e75f9c7a8a7,34323098325
20181116,"PAYMENT RECEIVED",1285645138,0,4133c73652476ccbe956eaa79f40e08294012ae091ed9c175da61fad9df3d6a4,33067728345
20181116,"PAYMENT RECEIVED",1295616244,0,64a960559d16b351b0fc1a2ef8dededa2fc484dfcacc9c7e3bbae6476f2fee27,31782083207
20181116,"PAYMENT RECEIVED",1281497977,0,adcc22a19d5cc4221278f4024cf372e60630f64099b92c5a1128d66e0feb3047,30486466963
20181116,"PAYMENT RECEIVED",1272560749,0,879e8b10418a73272116c0f1542e02ec3a007ed6fbd85b5713314949865b465b,29204968986
20181116,"PAYMENT RECEIVED",1276295340,0,22e9ba539bb57797d8a09f34b37f245c581849ba3dbef59c8e8c066879977832,27932408237
20181116,"PAYMENT RECEIVED",1260341152,0,6389e9b2d436c66771ff06cd29789da22f8595fa1d14082ba9c697145bc7ca54,26656112897
20181116,"PAYMENT RECEIVED",1279532257,0,ca711f8680828662196c01dc7f85b6eeee822f5a9193129367b658d08d78188f,25395771745
20181115,"PAYMENT RECEIVED",1278762872,0,3734539cbb2b9f499dbf10f69870f984d05102acbeff89a65655b62275d074dc,24116239488
20181115,"PAYMENT RECEIVED",1272846437,0,74c01c850b85c8e47a30511b6bb9b7e08655dfc095318471bc87e8a7cd03d301,22837476616
20181115,"PAYMENT RECEIVED",1283542092,0,9f8212ac4a99cb58a48a0251be8e5c659d27973d9199e6e3c129df51fa026838,21564630179
20181115,"PAYMENT RECEIVED",1297892234,0,24617a272551f941ca2379c57824b531cfeece3027bafb3007833cde85668b28,20281088087
20181115,"PAYMENT RECEIVED",1273925887,0,a08448ba1ae1bbe2b1717e2c385f103154ea7d7b8d2408620be68d948cb27830,18983195853
20181115,"PAYMENT SENT",0,-49323214059,2a66c36005909de4883d43f85b2558fc57838ba9ad9e6dece18f88c7397a58f3,17709269966
20181115,"PAYMENT RECEIVED",1264544728,0,1be796631553a2a5440b16130e175ef4a136b9881db933b1b3000970837f3aa0,67032484025
20181115,"PAYMENT RECEIVED",1258734635,0,0100a2e1fade72fc064ff04fe42b3ca0c757fa7214cebe3c8c5b5505c6d0c824,65767939297
20181115,"PAYMENT RECEIVED",1279981724,0,c19a7206600729915b4b242fcd4b10ec0e154234f369b74d5d605d20ed58453e,64509204662
20181114,"PAYMENT RECEIVED",1274943630,0,3d773d7e8f56ce07b59affb5060a9c2cd73434eaf4fb3bdf158e9a8d55b7e3d0,63229222938
20181114,"PAYMENT RECEIVED",1287016204,0,5be554d8139c793cc2274891584aee6208b87bb891af53e9e6ce7aad0a5f392f,61954279308
20181114,"PAYMENT RECEIVED",1284200036,0,1dfd45b9ae231215ff079008d7f9b5c25d6baf8eac31eb3f2a8ec8cd7bf6f2e9,60667263104
20181114,"PAYMENT RECEIVED",1262170996,0,8006f430cbf57d666b3267eb922d73d6abe4178ab65690709a3c29598d5f85e4,59383063068
20181114,"PAYMENT RECEIVED",1271741157,0,b01a3924af798a2348be4862a2af66e94bbcbecc5cea31bc9f4ef73ad5d4ddfa,58120892072
20181114,"PAYMENT RECEIVED",1314993756,0,d21944b9e2e62c148d1a40ba763a2f01cf6c5a0b40670a714451c36b49dfad0c,56849150915
20181114,"PAYMENT RECEIVED",1271679828,0,cab33a9ac6fdc77dc34342a15b6c5839fd516767f573262595fcad02e70b3e4f,55534157159
20181114,"PAYMENT RECEIVED",1265039280,0,62879ff064425cf299f58503f70d4734461f5d78ef245d97ed462154a5c12ffc,54262477331
20181114,"PAYMENT RECEIVED",1256131894,0,66f4a564daecb7d126e943423ad3efc569ee487b88c15daf7fa077cd38163201,52997438051
20181114,"PAYMENT RECEIVED",1253953264,0,928be772aaeca0d11e396f6fa00d16d2114e59e7623765d3a9eddae97e1a5544,51741306157
20181114,"PAYMENT RECEIVED",1257575152,0,5bbbadecbbca892b31faac900aa7a5967937c07b9c2e253290739f7f33525047,50487352893
20181114,"PAYMENT RECEIVED",1260335517,0,47b259f76de080a2901faf0e3cfc161aa1afed5e56060888324c107ebfc3f061,49229777741
20181114,"PAYMENT RECEIVED",1250898300,0,71c997b4e61618e9f2b13efd39ea8ae7e4ac22fbc1eaba45ca182d8f873c3d2f,47969442224
20181114,"PAYMENT RECEIVED",1259959487,0,77fb19d58ef7ed859ae1f87e8e17701ece70da1f6bf587812a334d96890c710b,46718543924
20181113,"PAYMENT RECEIVED",1269177176,0,6c9e170397d46bd783de0ad3600b41eda9e44a4122a1ca4e3b3ed60f39373909,45458584437
20181113,"PAYMENT RECEIVED",1266533026,0,b7300d2d465916280865d3bf2bd0f5c2c2b7ce77746c01585db3b8768cae1d03,44189407261
20181113,"PAYMENT RECEIVED",1266230889,0,a31fd22d8808d2a807cadd9068dcf2d2503335904926d866a17740d888a5c056,42922874235
20181113,"PAYMENT RECEIVED",1250909062,0,34203b8bb2b0f2008ff49f7a0fb6389a556e98eb0383fa7e37445e50b0ecb4d1,41656643346
20181113,"PAYMENT RECEIVED",1250693612,0,d524ad79106e9195662633b8df39e3718299ea0e0d2398df797f1dd68ca64675,40405734284
20181113,"PAYMENT RECEIVED",1259150814,0,6c6ab5a3850857766f866d54d98cd3b62f1ca15d86bf7b68ea5a544088a5bdab,39155040672
20181113,"PAYMENT RECEIVED",1253089238,0,7f58172a866f1061ddec1cd18e599be5daa7199492d9f0a4331282d2d895e971,37895889858
20181113,"PAYMENT RECEIVED",1250291830,0,df00cae73ccf00a874594abb2774d2073431a9c5a000c18c0632acd4bd0fc7f3,36642800620
20181113,"PAYMENT SENT",0,-20118406057,7880b9ec207a9b9fa2153834e1c0bbffec95573fd612a4995e05d98b6f7b0731,35392508790
20181113,"PAYMENT RECEIVED",1256602139,0,00ae958d1e74b8bb90cf4bfcabe987f5b6b74dcfe96fb0f4d838dc424ead7d58,55510914847
20181113,"PAYMENT RECEIVED",1264130049,0,d59a686cae6294a131c9dbd2f3c574a5a1984d272ce4465b9b534ef02b5934e4,54254312708
20181113,"PAYMENT RECEIVED",1253729460,0,a31df0143597bd536787768c6bac38a28c684e7341e6ed1f31d3d00f406fdca6,52990182659
20181113,"PAYMENT RECEIVED",1258564576,0,692335c5b390f1a53d3f45d53f8f375eef5e7dcb1fd92564f1434712acf86ffd,51736453199
20181113,"PAYMENT RECEIVED",1280477267,0,75bf3ec1b66972ec6f92347952bdcb0a5c866c901eb63174f5f5dcefd608089a,50477888623
20181112,"PAYMENT RECEIVED",1252237185,0,5f2a20d11f895570c9c308d5e55359321232f22f1b7ba9ae284e4a0f74b49b7e,49197411356
20181112,"PAYMENT RECEIVED",1252016758,0,49d01dbb27cf373971216c9aaa6f91cfce21aed477b30e9f559912d0382675d9,47945174171
20181112,"PAYMENT RECEIVED",1269852480,0,2d0d14db720235200e13caa7a0e9543beb11f1be63ba55eec0ba401501106d22,46693157413
20181112,"PAYMENT RECEIVED",1256305951,0,8691c5b09962890615a4af984afc5111b91a1b855facb53b2deca1a770a1fa56,45423304933
20181112,"PAYMENT RECEIVED",1264437869,0,27dd648b71e0ba9fecdc50035c70525d35bdbedf484dbad139f8f4bfb0ee14b1,44166998982
20181112,"PAYMENT RECEIVED",1269304503,0,d05bf0d6f5e900cb1dea5949416b3ceb023b5c812ee996e7df9acb5d5e62e709,42902561113
20181112,"PAYMENT RECEIVED",1267869962,0,1acb885be6be311cdfbb10aa4a6590679a7c411927e9dd54d5c226a306515b87,41633256610
20181112,"PAYMENT RECEIVED",1272041610,0,940a9045431a399e49ea8a4de54715234556de8c15818f4479f64b51b0a0ef58,40365386648
20181112,"PAYMENT RECEIVED",1270588988,0,b5eee5e8e0e6645be27fded59e4b3dba9d6be23e4064d0ae16bfc877c65399a2,39093345038
20181112,"PAYMENT RECEIVED",1266971914,0,7e7d424eed214cddf0dab7bc18ccf03975095fdbf08a013fc6fff44c6d29c519,37822756050
20181112,"PAYMENT RECEIVED",1251593989,0,998ce8cb5a44be646ec1f41b67aa72769034960797c42c132c7511c4c8e816a9,36555784136
20181112,"PAYMENT RECEIVED",1252083545,0,f03cc2deeacb35a43e3a82f5ebb54ab6c2325da9eb1ba86f81ead6c0b4f9253c,35304190147
20181112,"PAYMENT RECEIVED",1264929662,0,81e79155a64559f88813cab990c8288ee7654f3953554a056a799d0e1573f731,34052106602
20181112,"PAYMENT RECEIVED",1256856751,0,cc1c730670ac1f53dc8eeece34478afc126f2088e8b817f76e023e1618f42a05,32787176940
20181112,"PAYMENT SENT",0,-48130442662,7d7f2dd391ef345d6564af7a4cede15b0d0035ec9b1c5ac8eb726c26346c8b5d,31530320189
20181112,"PAYMENT RECEIVED",1262748027,0,494bdf7ca53ad0ee7bb38cf403f0d640e15a85c18538a63584faf2e20638e820,79660762851
20181112,"PAYMENT RECEIVED",1273274451,0,30d6dddfdeab1b145a9edd6f8c37ba28a1e68b027df7501400ddb0d5c605bb41,78398014824
20181112,"PAYMENT RECEIVED",1251088928,0,e370afc64055fd8121dedcd5a8283a8e345bcdb53acf7f41bc7662190d72a2af,77124740373
20181112,"PAYMENT RECEIVED",1261301678,0,94ca16481892f55c1f0daf3c2c4cf11558fbc4442b845b3fe668e0dbe6bad139,75873651445
20181112,"PAYMENT RECEIVED",1255839185,0,bbf7156793ea20cdcb347e9cf73b0b90f3b567317dbc908d3b6532215a80102e,74612349767
20181112,"PAYMENT RECEIVED",1275118707,0,3b2dea1d5e05a510732c133ea021aa5d36d60cb92c28f5eb6ea8c3ef567c12d6,73356510582
20181112,"PAYMENT RECEIVED",1264763601,0,742193b57a68d6211538821f2b725a83f6866dad3222e622c1815ddf22cecce1,72081391875
20181111,"PAYMENT RECEIVED",1251277906,0,6cfee6981a38914c71c196d6f10ec36be7c983c89a7ee3ba1f4ec2de63dacec6,70816628274
20181111,"PAYMENT RECEIVED",1267762227,0,6a4ce3178a3dadfcf7982509b7a92871e103bf3f373421b2f473c5bbd8c2cfe7,69565350368
20181111,"PAYMENT RECEIVED",1270822623,0,d15239d6c725a2830eceeee73bb34227b896023968e4e91517554c34e87b04a5,68297588141
20181111,"PAYMENT RECEIVED",1260020159,0,e7eee01cecd8d96399b7cc6c9cb2697f134522c3620f464763c06e36be7cc6ef,67026765518
20181111,"PAYMENT RECEIVED",1254682807,0,33b756c7f54fde751d543bfb2ac77102bc5b1f584fa333cc0ec7e852adfcfce2,65766745359
20181111,"PAYMENT RECEIVED",1264831343,0,bf630d40a5b651cf2bdb697933c92454c6e2eee3496c4514bd1928225ae0b066,64512062552
20181111,"PAYMENT RECEIVED",1253450871,0,d55d2dd1c08d5f9f10f07f619983d5ad7479d0a1150c9a30455d2a474ef61502,63247231209
20181111,"PAYMENT RECEIVED",1258368887,0,f7609f5524a5d7acbb9c6f8914b090c232719969c9b9c96e48062432eb4c0c3f,61993780338
20181111,"PAYMENT RECEIVED",1256036386,0,df62d100b7ac9a739cd89326a04741617497b0269e697362ae2165b16c7dcbc6,60735411451
20181111,"PAYMENT RECEIVED",1252270399,0,eeb43a4f571d43690fb7f211040c7ef1f75f901c8ebeb003ebe52ab61c8a89a7,59479375065
20181111,"PAYMENT RECEIVED",1253562583,0,fbec4b65aad9f4f0bdb31dd71ecb4859f1268818e98f43baa1220143749ad79c,58227104666
20181111,"PAYMENT RECEIVED",1259420379,0,2def334fcf144953727c1ec1c5d2f59e98dc136683217f71bbbe275adbef3c64,56973542083
20181111,"PAYMENT RECEIVED",1262744324,0,b6d628dbd5b59d3c8620a466c74fb65fed036422a8cfe26a5ec39c16c838683f,55714121704
20181110,"PAYMENT RECEIVED",1256055432,0,9187663ae3fdc63b32c91cdd7c50d906a0519f6472e88bae8976a6d3c945ab9d,54451377380
20181110,"PAYMENT RECEIVED",1263535701,0,3e1ddeecedc12a29002af7475d4f4db1250497448a5aec8912dd5a3b3185d606,53195321948
20181110,"PAYMENT RECEIVED",1261195892,0,962fed82fbcc401465a25c51661a059fae9e61f5f8c0f04f91e98b637ce730a4,51931786247
20181110,"PAYMENT RECEIVED",1273099384,0,0afdb0eef34bb483a8a735ca34e35f044b4a736acb679ca34656c3998610152c,50670590355
20181110,"PAYMENT RECEIVED",1264681021,0,c5cf6f9e27e3c77e0d1aa7eef79b23c044d5ec535bae8a649dce88f9173e1f39,49397490971
20181110,"PAYMENT RECEIVED",1264804351,0,047f007a23bb7c0c4acef44891d30c6d395b76390107f82f06d40290d5061f16,48132809950
20181110,"PAYMENT RECEIVED",1276538358,0,6b4ddb43bf0b63f58d8bcb8967cd503b8f41b98d0d5566186819e26307f71bea,46868005599
20181110,"PAYMENT RECEIVED",1271905534,0,5346708f25168762c43bd2faf2e5b128b85c9df2c7c91d1c82d3f5ff874c80cf,45591467241
20181110,"PAYMENT RECEIVED",1276864823,0,d986f9fd4b2fa1edea36689d2330051546deae674a9d204ceb6009e9a21330e8,44319561707
20181110,"PAYMENT RECEIVED",1253731045,0,7fd4da68143e615fdcba30fcf61ba7e2f9dd6c411680b2f7c5675e459ea7a699,43042696884
20181110,"PAYMENT RECEIVED",1259716321,0,838bccf8cc1ba4b58732462812d53a29d6f22d2714d9103ddb277b7a99aa7ecf,41788965839
20181110,"PAYMENT RECEIVED",1266132626,0,0ec6c2f6947672164715ff3bbcd130a4eb98e3e9b1e747a1705dfa75515f9800,40529249518
20181110,"PAYMENT RECEIVED",1257344166,0,4a20ceaaa31d8227c434ee201c28fb1727153932964622fc30205a1328b9e776,39263116892
20181109,"PAYMENT RECEIVED",1251463653,0,3bcd2bfdb17fc563c24ddf6e2865ab11c8f0e629b0d68d6f344eb13ed6ff9dbf,38005772726
20181109,"PAYMENT RECEIVED",1267486788,0,8247c018b6542d74c45fc9932407a38fa769abdec63ff08de4e9461fff698faf,36754309073
20181109,"PAYMENT RECEIVED",1261799635,0,2f81a3fdb7fe34181f2227ef5e9501e630fedb9561278e0ad167a88302921387,35486822285
20181109,"PAYMENT RECEIVED",1252255608,0,01ae0c59662618f3edbc4946c1713606e3e1560832f0c98888f4ddeeeb0edf97,34225022650
20181109,"PAYMENT RECEIVED",1258799860,0,ba470273dc070428f7ae8568effce98de9f61973030daf2a33ec419492f947f4,32972767042
20181109,"PAYMENT RECEIVED",1256845440,0,6cb80c5f6ceaff10e40795ceb87acb0b4ebce666bf047b543dd1db6d4a173654,31713967182
20181109,"PAYMENT RECEIVED",1272181140,0,80aa70beab92195602c03fe87d91c2f3d70b852ac4d304efa3e3994830979cdc,30457121742
20181109,"PAYMENT RECEIVED",1297451896,0,9c82301ceda6eb211676c747deeb77a78cc663febd752a02671450e46d66681c,29184940602
20181109,"PAYMENT RECEIVED",1288377300,0,910c8047936c8f5a350781e6640658ff799a6b270d13a91573efe5330a5cc680,27887488706
20181109,"PAYMENT RECEIVED",1271682295,0,20481dba4ca5d0c7c6f24ac45475557824eb367bd5e7e89909bb81c1561078e7,26599111406
20181109,"PAYMENT RECEIVED",1262983270,0,4a8eb1372b6b776ea16dfeb542ef543d1cda25f63ed620dac7918d7c808d9871,25327429111
20181109,"PAYMENT RECEIVED",1259204349,0,ebc02b88aeaa0f1d0c725067f316d27c8a70e4f879d30fd417c3004dfc63b4ed,24064445841
20181109,"PAYMENT RECEIVED",1278016977,0,dc68807ff3e70ed9366b68a61d9286677e22d3d360f5f98fc63e68ce5cd549cc,22805241492
20181109,"PAYMENT RECEIVED",1264787782,0,1774bcbdee29a0536499eb46ee7e52f4704c0b4a8693cadbfe95bb504fb3067e,21527224515
20181109,"PAYMENT RECEIVED",1263813903,0,013cff7f7b632c7f5db7d5b58b51025a399d4d554957e609d9dd1a6da39a1808,20262436733
20181109,"PAYMENT RECEIVED",1264361844,0,5dc99101383a916930cc9ad7d944aceeb23b7263f20b7ed8275b90630769b0b4,18998622830
20181109,"PAYMENT SENT",0,-50603004139,cb3afdd8cd2546af8975dd75f4a0656f44176a4aafb60295236051cf2bb37bcc,17734260986
20181109,"PAYMENT RECEIVED",1260387000,0,e34c87c053da28393e31ec625fd16dc3f85ee14a05a1630acf08f8996abd49a8,68337265125
20181109,"PAYMENT RECEIVED",1252275699,0,c2a399e2ec78fd909006de7f9a4ddf82f7a09093e44b87d09a7bf4cdfc9249a6,67076878125
20181109,"PAYMENT RECEIVED",1262252024,0,9b41be351d32701f721f9073f944eaacb91218e569ae15a17b7cfeaf95907fdd,65824602426
20181109,"PAYMENT RECEIVED",1265257066,0,289b042ce0199330aaf44957608778f2c2dd2ad344e398eec1e9747af8c1607a,64562350402
20181108,"PAYMENT RECEIVED",1279312499,0,a62091aa3efadfd65faa9476f0ee776431291f83a7638bef7f188ac1e27923a7,63297093336
20181108,"PAYMENT RECEIVED",1262188817,0,4e7ae85bce13067be4ca133e711b607346c62676c649fc3c0e8d7947e80573a6,62017780837
20181108,"PAYMENT RECEIVED",1264712683,0,dd4596bb3e5699db8890a8bb6d9e542258798221018dcfd7cae4d3ebec68de66,60755592020
20181108,"PAYMENT RECEIVED",1267712322,0,f2a44f81159a2ca38ad7fcc9f0e13660056e1c7455b73f3f91b23247bb0d5519,59490879337
20181108,"PAYMENT RECEIVED",1262667957,0,55b4fc2babd622b775d7b49203d9aeacbf47b5f05231a134987553cee682eaeb,58223167015
20181108,"PAYMENT RECEIVED",1267559879,0,c5a3f649e57d668c9e6016c47bc811a3d8e2944899daa61450c578b267f51dc9,56960499058
20181108,"PAYMENT RECEIVED",1274075175,0,71911625f56e7cf8109b782973ab4276589b9f8ba5d7083735463cff3ae04275,55692939179
20181108,"PAYMENT RECEIVED",1286777812,0,ecca226527d35c445ee4facaeddbb9076b5419509abb0b0feb6322dd33eee161,54418864004
20181108,"PAYMENT RECEIVED",1273724201,0,72ffdb9fbe53249cb8f2c3ac81badbef6406d3139556f9948942142461093265,53132086192
20181108,"PAYMENT RECEIVED",1255356964,0,1ee7d30b2ead4f84c4a6965f970c45602598340aa35a89bcfd253032d789f250,51858361991
20181108,"PAYMENT RECEIVED",1278330538,0,98b15bbb800ea6cbdd302d9e95cadd101e93a4b28bbbcc3c97fd85ffe011ffb2,50603005027
20181108,"PAYMENT RECEIVED",1271572151,0,875e1e4bdb6fa36d9f6ef1a8604520e98c078d870c2a8a705015e9c41c5f2e33,49324674489
20181108,"PAYMENT RECEIVED",1260382006,0,92e10870094acf2c086abcf7fb2bb069842b0a5c5aee7f2c5d07d55f1dd495b6,48053102338
20181108,"PAYMENT RECEIVED",1250016083,0,d8f6f349369956ef96dbe0280e22c5dc59bd3ad08727fa6fa40aaba6e0eaaa30,46792720332
20181108,"PAYMENT RECEIVED",1259231539,0,eab21b35209058441400a7322b9add29e5047c418445ae64eea351e865e42b35,45542704249
20181108,"PAYMENT RECEIVED",1267450685,0,1c1ff93fab400ccced05d46ff7d8c5bad1da09e05e468db459a0cb92a5617014,44283472710
20181108,"PAYMENT RECEIVED",1252978576,0,69e88394e06a7cedc99dcf9052c4ca719bd2380ea66af08077bea5cfe81fe0f1,43016022025
20181108,"PAYMENT RECEIVED",1266549582,0,0f953fc83f6057cd14024fd416f924ea4112e03a64914fbaf5083d46c2046720,41763043449
20181108,"PAYMENT RECEIVED",1256581166,0,767e061b69ca13d63296e24ffcb4b29232535933e8ad342bcd87909ea939d28b,40496493867
20181108,"PAYMENT RECEIVED",1256509841,0,69ff92c08f571bff75410422569b2627c92bff8d0f3bd3bae83110ea7fcf9745,39239912701
20181107,"PAYMENT RECEIVED",1279997799,0,c7d97694d4d25c23d2ff5c8eb292f2b6a59730b21de6929e62d72d8536e98ac3,37983402860
20181107,"PAYMENT RECEIVED",1260229309,0,72176c34d809e7801054b33755375d5e65e40ed5d737d8c8c2122392df956cec,36703405061
20181107,"PAYMENT RECEIVED",1255675466,0,4d0140853d1e5cca4f795631167a165bfd6a83c50a9f435905589eca0decbe0b,35443175752
20181107,"PAYMENT RECEIVED",1267280366,0,f137c8598882801839daa2961b931d1166dc0b0a47a05f8102980509d660fd03,34187500286
20181107,"PAYMENT RECEIVED",1277852429,0,e0799357d0e11a3149d1b757b977e5f936622f717ba5058e182fd3d1801efbd6,32920219920
20181107,"PAYMENT RECEIVED",1291377624,0,41250815afdb9cfc427ec6dfb8c0600623b3247f46daed029e830ea11c25fd71,31642367491
20181107,"PAYMENT RECEIVED",1263988552,0,bb7cb59247bcc13faf5a63918491173a5e66aea0d5d54883bf3d62ccaa39f39e,30350989867
20181107,"PAYMENT RECEIVED",1264795894,0,500fcf8ca4ad02a30c1093f2907647fe4874e4dd92e190702a0435f5d6c45a3d,29087001315
20181107,"PAYMENT RECEIVED",1253816170,0,c9ad19381ed23780ef6acc55482b493c39dbe7e24a762a76810eec81c8e9edd6,27822205421
20181107,"PAYMENT RECEIVED",1266737609,0,1dcc87f1276e85d8f1fdc72614e0435734e985a9e167251202e1955911bfd73c,26568389251
20181107,"PAYMENT RECEIVED",1253244838,0,fafef1068b7bff6b13d53f241996259d302c80127d551acf26179cfc1b698f05,25301651642
20181107,"PAYMENT RECEIVED",1263710419,0,67a4edbf6c5aee20a7f6cb4a4c1e0db9f52c4a30eca73db2d42f5f3cdcaa0ab2,24048406804
20181107,"PAYMENT RECEIVED",1254700164,0,b688c8098fa3b9ff57d68f6285621c840d888d950e1af1c66b5a689370069293,22784696385
20181107,"PAYMENT SENT",0,-25162749037,d0d26792ead6fce4e5db33ee08a379f64f694e0008c518927b009b9021eef3f7,21529996221
20181107,"PAYMENT RECEIVED",1262031337,0,976dd88af0974348d5a74897b6b8db77f5e1646226a2b82ccb4bbb34c5dc3c21,46692745258
20181107,"PAYMENT RECEIVED",1252709613,0,7965a032d4a0803b75fe6b6cd026fb63b67b16fc3f4da6146d7a4cd4b41be5c0,45430713921
20181107,"PAYMENT RECEIVED",1252824877,0,f5e6df48be12eb9ea239a4b64e317ed91856651874455e7d6f365510e003e415,44178004308
20181106,"PAYMENT RECEIVED",1263089096,0,1cba75913849de8edf988da76c83e081c23a7223b8d94f3f71bdff82c29076ca,42925179431
20181106,"PAYMENT RECEIVED",1275716665,0,623564770f50cfb7dbd31f5e995d77aaa6b97cbc53b441bc53d09cec29b9bda5,41662090335
20181106,"PAYMENT RECEIVED",1256496111,0,cbaff9c1cf3c8a73aaa29c6a2b69bac9f618348c43adde311c5cc5a2850a857d,40386373670
20181106,"PAYMENT RECEIVED",1267548716,0,2e7fb3b1867fb9a203e1d6c6a05345e8f74f58b7a6aaccb00cad21dad473282b,39129877559
20181106,"PAYMENT RECEIVED",1267588479,0,408fd26d59754ea6cdda7ad0fb9ec76c14b15204c52658ef15caa06fffc32f1d,37862328843
20181106,"PAYMENT RECEIVED",1258815258,0,8984177da56ac246843fd68aab0c1f67b2a95d9597de7ecada466de05afd89ea,36594740364
20181106,"PAYMENT RECEIVED",1267357701,0,b19ad99b822806bf42e2f5f3dbd13ba167d23d2d25e154f5de3a719bd555dfdd,35335925106
20181106,"PAYMENT RECEIVED",1265676032,0,ae63a0f93a899ad70c68a682c2390fceab6f91c86e0f0bce8d337c0b0271a571,34068567405
20181106,"PAYMENT RECEIVED",1271340065,0,764549e380fde24a85f901af5cfd4519974008faf9d2f61977538596abb1fd92,32802891373
20181106,"PAYMENT RECEIVED",1280902330,0,f7f75af18703c41eec8aa5ca6a6c5bf50b931aac3ed005a715f8c189e88f7805,31531551308
20181106,"PAYMENT RECEIVED",1291385009,0,e9468760cf2db9ed00f24a8cac08ce699471a014d761d397b179172aeafaed0f,30250648978
20181106,"PAYMENT RECEIVED",1272824315,0,008a796a5c83d7ad5a57c2f4f931a5c96402f75224d27f0b8a006ff9968e7582,28959263969
20181106,"PAYMENT RECEIVED",1264095486,0,adbe05ec29140c007254714ce61accc1d6f50c0a1a69616d7d43c182e98cc060,27686439654
20181106,"PAYMENT RECEIVED",1270801300,0,380a603127412a21969e5a4abb09e9068aa3719adee6512b83f377119e6ddb50,26422344168
20181106,"PAYMENT RECEIVED",1255759509,0,abe73662e18c93e4a9ad3d63938643d368e15611bd468a298dfed9725f34519f,25151542868
20181106,"PAYMENT RECEIVED",1256032516,0,c45346af8a3cd9c93d700801be89c3b70bbcd77cbf13b7d5c488177b4cddb423,23895783359
20181106,"PAYMENT RECEIVED",1253446016,0,440b547c6457c95e445e73050a3fb0b8e82f681f2c67e44f96dab10c29ce2768,22639750843
20181106,"PAYMENT SENT",0,-47860644297,9cdd5a092ca75b256fe16f1d06f626d6e5c4e8d754fb4d330be8c1716fdc9db4,21386304827
20181106,"PAYMENT RECEIVED",1260626077,0,f6b40ec769efd089d42fb58119b1fbf3e0388fc64f845035ab1aefcfeb7d81be,69246949124
20181106,"PAYMENT RECEIVED",1251862551,0,a1eb4b77833cd19e32f99e96172b6bcdfb600bb720c3b8fd1dbd9fde96bf5e24,67986323047
20181106,"PAYMENT RECEIVED",1257105436,0,d3be4960ea751c2463b28100f78dfb08608621ae6630b7b0cab2c6399882a1cf,66734460496
20181105,"PAYMENT RECEIVED",1261148009,0,c936e2871fa898ef0d5c644fda4fe9842c788a288b64234144937280988656e2,65477355060
20181105,"PAYMENT RECEIVED",1256150184,0,e13511656108b013e4871fa9e7135b3e18695cfc99f9c76e7ffbfa35350927f1,64216207051
20181105,"PAYMENT RECEIVED",1263294325,0,682d13396c7d569ccf0485dd0f599fe3086d66fb41a0dab14b5316db33db5455,62960056867
20181105,"PAYMENT RECEIVED",1252876687,0,38eba8899515877cc8243749a56beb5454cd4dbfb71667a5c77edd8e798b0daf,61696762542
20181105,"PAYMENT RECEIVED",1261193422,0,d6a02bbe1e9378bfb6c1c3641af0987199d715fe77401bdd1d137bf28cf40468,60443885855
20181105,"PAYMENT RECEIVED",1257150886,0,0d0c6ec11dfd30dd33b82ee0f0fcde4876e73bd412ef7dec0b257c582c45cb5f,59182692433
20181105,"PAYMENT RECEIVED",1265494363,0,48d42f17eacac14db52af351089000606f117caba76c3ca736436f2d90d1790f,57925541547
20181105,"PAYMENT RECEIVED",1258996762,0,60628f36f5444819e9a5a577581ff7a8769d62d952d23f153f30eebdcd66e05e,56660047184
20181105,"PAYMENT RECEIVED",1255017441,0,edda6ff84c6a5f1324da57ca96d98033010a5654d7c607911678203334f8eb71,55401050422
20181105,"PAYMENT RECEIVED",1259594243,0,747d6adc77e074c78504e5617415414fe765d88eff7093a6f381f6e2c28fc4a9,54146032981
20181105,"PAYMENT RECEIVED",1257576936,0,99a5c17fc411c1045e5c323e2a796a43ea8086e675d6d745af2c0033da3e95c8,52886438738
20181105,"PAYMENT RECEIVED",1260458803,0,53c9194d17f233fb7a03b0eee777904394c3558603fb612b10655cb304ae0cca,51628861802
20181105,"PAYMENT RECEIVED",1292529140,0,8f0ca9b63909bdf79edb7663a548b31d763959c7d0cc1b97ca2f2d69237953e0,50368402999
20181105,"PAYMENT RECEIVED",1267291429,0,1f8425e9db5921299924282140d2a280ccafab949a00dfca0d84b99dafec9a24,49075873859
20181105,"PAYMENT RECEIVED",1274054365,0,db1451ff1b77945032cfc47f2a38e058d57b1fd874d63e55b16b6c2d9431d597,47808582430
20181105,"PAYMENT RECEIVED",1280347151,0,8f641f40d18ef44ff69f0a77adc07bba2ea604770cdd483d12baa07c4ca5c7f1,46534528065
20181105,"PAYMENT RECEIVED",1250195505,0,d9cfed9b2c60c61bd75148280617a39efc56fab114046b786fbcb16b3f1cfa7d,45254180914
20181105,"PAYMENT RECEIVED",1264591160,0,019faa677d43edc95d1ebc5a9c9a88f40d1b0e273eed839a7d311cd066ac58cd,44003985409
20181104,"PAYMENT RECEIVED",1251871420,0,099762be607c2cdd00c3b043fae57083d3a9c003bc2219a3ee735f0d8def19b2,42739394249
20181104,"PAYMENT RECEIVED",1259908596,0,169c693c013403ff4c2a496f63deb540c24ba19ef3baa1cc9cbf66eb59e554bc,41487522829
20181104,"PAYMENT RECEIVED",1256916035,0,7761a1a06aae642810c4f3c7569fb2b869cb79ce072df3fe68c34cffcd9e68f6,40227614233
20181104,"PAYMENT RECEIVED",1257819309,0,08f9568db3bdd68bd33ddf8c1f784113caf4578060121e84c407a7b5bcaaad2c,38970698198
20181104,"PAYMENT RECEIVED",1261073205,0,a9b835f00771f5d96f5060be17c54aac3ad908c05ba209e19d9e37ca7d09684b,37712878889
20181104,"PAYMENT RECEIVED",1259385676,0,e3214e13151bbf3fbe0222fdad23f4f655cceefe598bb2549e2068a5777ff142,36451805684
20181104,"PAYMENT RECEIVED",1261205442,0,2c723e33f5b70dbe40babde50747469e8a5e7f9add5f1aeafeb8f57283bae1d1,35192420008
20181104,"PAYMENT RECEIVED",1259714888,0,2d95a15c893107018b4eb192f2f950490f99a0ff5fc6fedc2b6e44e8eeb07870,33931214566
20181104,"PAYMENT RECEIVED",1250311670,0,b53c340fd4a91824c871543c5d3b2c37462bf7f1c3a974f2f12afc061cbf7aed,32671499678
20181104,"PAYMENT RECEIVED",1254304614,0,9444cbad37e8532a07f38a90dbd889e84b0e85885b6d34b3286694986da527a5,31421188008
20181104,"PAYMENT RECEIVED",1250016421,0,8021c3b9e323d830e9556b1ba6abfeb3c7149509f196dd09a5381c9da1dcc18d,30166883394
20181104,"PAYMENT RECEIVED",1258424786,0,1f727d8ab199f3969b9c473cb3c7ac16dd547d14cf3211327ad1f2bafeec253a,28916866973
20181103,"PAYMENT RECEIVED",1252721416,0,c42d884974c530bc42c6547426293cd96b817ec230abd748a68975a31875ddca,27658442187
20181103,"PAYMENT RECEIVED",1252157456,0,8d8bdd5e26b658c072584d0aa42fd3da5895c75d3cf3dc31dcb3524b77eda6f8,26405720771
20181103,"PAYMENT RECEIVED",1254606891,0,be81232046f745e07339e31c58543afdbc21b97de0282c23971ba1938e191278,25153563315
20181103,"PAYMENT RECEIVED",1266481742,0,a30a1b45b0c92318cf0ff308570a1946b43d272cccbc9f875007754928e6f39c,23898956424
20181103,"PAYMENT RECEIVED",1256849956,0,4adb499705c93dbed66bd5b6c8dbeabebe9ec08fdbe6b58aefe8fbf283eea510,22632474682
20181103,"PAYMENT RECEIVED",1255976149,0,d53bdb2125f83048929caba1c56166fdb755d6f7ec692b05b486243702ba7521,21375624726
20181103,"PAYMENT RECEIVED",1255347262,0,7ba3862771669e47d038f60a3616192d1dbb43455f3d750ba1ff8dbbd54b4596,20119648577
20181103,"PAYMENT RECEIVED",1260752481,0,69c359954c25abe1db76f246b6ee030c4ed885b10d3b201f75597a4da6076011,18864301315
20181103,"PAYMENT RECEIVED",1256194663,0,45abdbaf59eb02b3fbd3f18e342f03427300725e9518f5de20bc89aed85efa0c,17603548834
20181103,"PAYMENT RECEIVED",1266861272,0,35ac07b5f04bc38ea0c65467ddf3708ec3aac38ca65d2d9ca7c6b5e20c7cfdd9,16347354171
20181103,"PAYMENT RECEIVED",1265092287,0,350f84b3c3a35088c2c7ce39aafff2f663eb9af4644805c6a86b776ea78b39db,15080492899
20181103,"PAYMENT RECEIVED",1251421796,0,d0cea60af2a5f27643e32fb208d7434cf7601b270d22c49f11af1606ec252fbf,13815400612
20181103,"PAYMENT SENT",0,-38046692821,57f983b04838d6b054b69a3374f069c127735b619de3f494efcf95be873cdfff,12563978816
20181103,"PAYMENT RECEIVED",1255612683,0,0123d9babe68d851b7eafe7672f815699847781946e09dc5664344de41ee8995,50610671637
20181103,"PAYMENT SENT",0,-47717568428,7992098d36f722392587ed429daa11c3f54e854c348472271488685427a135da,49355058954
20181103,"PAYMENT SENT",0,-50240391161,b5b90a3c95f73c5b80c265b3fe52176b33475da22954cec9b2846908009e65da,98322627382
20181103,"PAYMENT SENT",0,-1250000000,9b930a13fe945b5444d21df0a1e8310225c95fda0e496c7666e4cef3981584d2,97072627382
20181103,"PAYMENT RECEIVED",1266317073,0,be2dd8c37a1251ea1b29eda870d3b41ef8bd225f3ce434aa4a694cc1d72579ec,148563018543
20181103,"PAYMENT RECEIVED",1250156708,0,54f476c4d95810e97caf8b1eff3c1a996790ac095d96d0213d14c02849c07628,147296701470
20181103,"PAYMENT RECEIVED",1254525078,0,bc7ea4d070858d315348b9b32533ffd1c4dc34ce27308390de71ceb4b937f157,146046544762
20181103,"PAYMENT RECEIVED",1254116547,0,0e5e51140a7af45bcf15d4ec2ed44081dfa0a4ce312a176daaacb3888af2fd52,144792019684
20181103,"PAYMENT RECEIVED",1254900516,0,adfcf554bbc8d7a3a5aaefa5164dff3d8c5eb5acc7890696f4d3d79250fcb6b6,143537903137
20181102,"PAYMENT RECEIVED",1263201485,0,dcf2536078252c4b41a45afd61fa06f039c89aa49a05d09f1d8f3b1957e7a8ee,142283002621
20181102,"PAYMENT RECEIVED",1260058977,0,1b23efa8a1a44df316cc90420fc88544f2c7fab176fd7195bab6b687bb36fb90,141019801136
20181102,"PAYMENT RECEIVED",1269175837,0,bfa1f302ef424470322103c13d97fb7b1047a42ccb85ee91022ae03f54127063,139759742159
20181102,"PAYMENT RECEIVED",1273263772,0,ddc6e0573b1aaad49cbcc52208ec084758afce1d8c00b8def70544897d5e9b94,138490566322
20181102,"PAYMENT RECEIVED",1261709826,0,922ead78ca746c580500a1147379480c96463db4b4ad921cbde1e63e05176410,137217302550
20181102,"PAYMENT RECEIVED",1277399667,0,8134c80d5c5e42f4493d5af8ce323dca4e8a0b07be921656b13694b42bb85c01,135955592724
20181102,"PAYMENT RECEIVED",1251566146,0,e5d163fec2d00736267292362d6ade4e2110fcfb3f9b3dc1308148401ebd12be,134678193057
20181102,"PAYMENT RECEIVED",1266284998,0,8832ae23e4470e85126d8141874d98790d8155a21e1ef20b0e16f11375883d41,133426626911
20181102,"PAYMENT RECEIVED",1254586859,0,42bcc482c1b01679d032620baac8d02e3b8cf6172d2d6e5b2fe9b81388f899ac,132160341913
20181102,"PAYMENT RECEIVED",1257548831,0,3ba3e7ec441cb45fc0c70013f34037506e74278ab1742229c4f796ae320ffdba,130905755054
20181102,"PAYMENT RECEIVED",1254130883,0,9a69955d59002f0220a52a70d8e6cecc3f68386ab7f37a6195e0e9be60f49543,129648206223
20181102,"PAYMENT RECEIVED",1254788222,0,b1b02c0b78b080b6101d9e8f44c3a944b3c4e0cdb3b1b1d7f4d2403cf030cd15,128394075340
20181102,"PAYMENT RECEIVED",1257216728,0,4cf328f9ed0343155a7ad6928c5f0758a619929f7933b4eac93adc8a3e2c85c0,127139287118
20181101,"PAYMENT RECEIVED",1251563871,0,cf33dd079b8828ef7fb372632547cc35570839435f8450d8d91642be63ee4cd7,125882070390
20181101,"PAYMENT RECEIVED",1251314951,0,7ca9b82c7302e4b087fec27d4961e51052c4f9b9b0fe480d23f11dc49282f448,124630506519
20181101,"PAYMENT RECEIVED",1253071421,0,a0542b06c6fb1c8f22d0ef786e1d456a0553e7e08ea50b709ad4a2156b1c12c5,123379191568
20181101,"PAYMENT RECEIVED",1268730633,0,1a48d0e9343e11ecc5a84262d2e40836b8349b7d70fa7ab7754a5725e4861ec6,122126120147
20181101,"PAYMENT RECEIVED",1269634373,0,3556d2b8732823143b9b11177f1f5dd5d263011b058c77d599c9d198672ddc62,120857389514
20181101,"PAYMENT RECEIVED",1257465915,0,a81e0c568cf183c0127fb2abaf1b8d2825f3c605684da1a5d4674f21b4831a02,119587755141
20181101,"PAYMENT RECEIVED",1298509649,0,fdd2b2b27819ed92807260b2cdf7fa0dad5c79f8b50c5435e3392d46e34c3c2c,118330289226
20181101,"PAYMENT RECEIVED",1261323763,0,739d420a582baa7aeb45d8829c207486a5f5f19c2b42204c05a2f02ece64b262,117031779577
20181101,"PAYMENT RECEIVED",1254923981,0,c28bdb7fcc34d1c932899240afe6754ecb91847a903ceae48f6ea9345554b427,115770455814
20181101,"PAYMENT RECEIVED",1253051164,0,08831a06f78d90c85da43cd4f8ccdc49dc531bfe6632ec07111436fa808f1c35,114515531833
20181101,"PAYMENT RECEIVED",1253492095,0,2ca681833114a1f268693581d7b0f7989c6c8eb866265c2e20568ae2a6bdef15,113262480669
20181101,"PAYMENT RECEIVED",1250020956,0,ee5c15023e0cae455fa39e840029cad89941394aff252e22f5b856de9ae77fb7,112008988574
20181101,"PAYMENT RECEIVED",1257817681,0,ea5b50d2dd2428af8145f9b4acd98d9034e5786697ba898bd890a97d0db40332,110758967618
20181101,"PAYMENT RECEIVED",1252411446,0,5a20f820d28e3c4cf67a252b270deed643a76c62bc92318d3a1b248d037533da,109501149937
20181101,"PAYMENT RECEIVED",1272742755,0,0953e5a1a69092e05952b3410c70d6bb3f3926537894cbd52f5eee9ec6db1c24,108248738491
20181101,"PAYMENT RECEIVED",1250105653,0,f75926776c088cc3ea7e27acadde9ed0106362273d5caaf126e677eb62ef49aa,106975995736
20181101,"PAYMENT RECEIVED",1257574488,0,fbb3139dc8721d3ee1fb47eebc6f6ae8919b69b30423d9799ac1249ec0e0c9a7,105725890083
20181101,"PAYMENT RECEIVED",1251074089,0,6f8e692a1ae54fedecad4f8022150258df6b13cc3438d161fddeba62d8918ec2,104468315595
20181101,"PAYMENT RECEIVED",1250388282,0,56a0e2142947557d68ba69bcb66c5dca7b092b9a769a552071d41727bd7b895b,103217241506
20181101,"PAYMENT RECEIVED",1258295771,0,787218d9f0969703f68ec24957d5fc7eb5cebaf8b3ff00ff8a85b73b0744265b,101966853224
20181101,"PAYMENT RECEIVED",1251556241,0,ae072669e632971a3e6d0c4a6830ef28681301fdfc1e445dc72bf34966325f23,100708557453
20181031,"PAYMENT RECEIVED",1250007136,0,c6eafbc6bc8a0751dc417312e54811134b2f3050f5d520c76834b0e1e748a0eb,99457001212
20181031,"PAYMENT RECEIVED",1256793534,0,31c6efed4ac810a706478cc00534bb0ff096f96d0c17f2271e186d75f9790319,98206994076
20181031,"PAYMENT RECEIVED",1256617383,0,4c5589c9c378febb8dc3dbe4baf23e19f6ce0e0161338cb96a09a4a264dfeee4,96950200542
20181031,"PAYMENT RECEIVED",1250981469,0,09127b87d5d0b177378692cca851ce96b3a892a08ac7e48a7261ce4582e13c54,95693583159
20181031,"PAYMENT RECEIVED",1250904870,0,51b64ede76d4572065f56903a8d1e6896dffeea251edce3128e849fd03024457,94442601690
20181031,"PAYMENT RECEIVED",1254840385,0,356a1e0bb9d77f806f2364277db3678b5526258036cfd7b0acb5916351ba9ca1,93191696820
20181031,"PAYMENT RECEIVED",1252505938,0,bcf6d8b64e3868510effdcb0708525638e7e1628f3e466bb769df5227854cc92,91936856435
20181031,"PAYMENT RECEIVED",1275008694,0,b3f815062d2b136db304e5f60e93b6b065b40c9b4eb67dbbad13c78218776610,90684350497
20181031,"PAYMENT RECEIVED",1253227790,0,5252e9ca65f8932bf8c152d24f08fd7b72396321f1f4b03029d718ad7aff73d9,89409341803
20181031,"PAYMENT RECEIVED",1255627583,0,1259884e135694d34fde038fe23c374860ae1c53671dd97908c10eda7a5e4202,88156114013
20181031,"PAYMENT RECEIVED",1251151501,0,298fa774beb562c13d37fc967b95cde2b580528991d29cc69d35e6043b7a00de,86900486430
20181031,"PAYMENT RECEIVED",1250096500,0,9d91f5fdfe81fe8b6002b00d4b1e2043ba17397ba7e4bbeeb00ba3ce25595484,85649334929
20181031,"PAYMENT RECEIVED",1255956811,0,d219a5de1ac2c5cf5d1f6786897935a4c0f791a0002c45a9a40c07d981888946,84399238429
20181031,"PAYMENT RECEIVED",1258026499,0,4c6eaf09ebd48f9bd50cc6f7253403e129a1f2b85c7cbb30f5f50e8e710ef15a,83143281618
20181031,"PAYMENT RECEIVED",1255528610,0,7b27d77e00f3280980b99ba37785d11978165330d75a70cbd25011e5d7eb3866,81885255119
20181031,"PAYMENT RECEIVED",1254069633,0,f2acc9c707137ff06c13f2c0ff83c39d71458a2b6a9e40c33cc142eddd275173,80629726509
20181031,"PAYMENT RECEIVED",1257231793,0,40582fdc1e0177df580eb4566073fb9ecc35c6f32c34c61585ae2959111151db,79375656876
20181031,"PAYMENT RECEIVED",1252072360,0,5825e8f1f4e2b5748c927fb4f15cb510e7df21c132af52f51415a75ce941e921,78118425083
20181031,"PAYMENT SENT",0,-47960547917,0a9a7f26cd6be8472dc5f136c278c4530260aa53b5b10c2ea0d7ced7f40b42b3,76866352723
20181031,"PAYMENT RECEIVED",1257422829,0,5d87218e0b39893c3d5e4b9daf2d8ab33d1b16c3d08f3c5c2b8b7d728c0ea397,124826900640
20181031,"PAYMENT RECEIVED",1262317259,0,109ad7236ad54d4c571c5afe973546c65d151c2ecdb30fd732bde24338eab704,123569477811
20181031,"PAYMENT RECEIVED",1256408317,0,c90bd4872caada50eec69815b9c8d496c456d662d72c939e3c3979ed613da597,122307160552
20181030,"PAYMENT RECEIVED",1250647884,0,c12d98414d5ed5eada1d092629dc9032220f3346a801764497c5e27af7a03347,121050752235
20181030,"PAYMENT RECEIVED",1252365362,0,d67babcad373550cbc35d28d503fc85e170f0d3ec879c63d10e4c78a24389530,119800104351
20181030,"PAYMENT RECEIVED",1253451424,0,d0a050e4873820b8a37f11788af21cc9843d8025c94230de207676567bb55c14,118547738989
20181030,"PAYMENT RECEIVED",1256358725,0,fe81cc7eecbea996038d8b88ab83eb851591142bfb9d3d21d4119d4f3298c36e,117294287565
20181030,"PAYMENT RECEIVED",1254085490,0,9bceb7d17172a35b2a708c6051d556fa558887e0093482d33b7f9e2b4bb6feec,116037928840
20181030,"PAYMENT RECEIVED",1252370793,0,06b6d31c6b4c875c179475d50bd2e550e60d348a56c2226d7072f83c1d84309a,114783843350
20181030,"PAYMENT RECEIVED",1250203083,0,06827546adb061ecbccc7398c9a90a3ebae029ea1d3a9306e0b0f6c44a6898cc,113531472557
20181030,"PAYMENT RECEIVED",1257356343,0,5e09eb4d8e12f91f660b643fbc1524378bef17d00b8420029e34e00fbf8f1b10,112281269474
20181030,"PAYMENT RECEIVED",1264434400,0,119bed559ebd2eeedf9b5ba04fd7d5f9afed4566591c42edc2637f82bb610305,111023913131
20181030,"PAYMENT RECEIVED",1250605880,0,90de1910753a5173d822f5e5ecedd5b286433c3211d95876fb74aaaa5150cbfa,109759478731
20181030,"PAYMENT RECEIVED",1256474144,0,1b78698c40c7ca13f50c81681aa855d1e74a14384904fbd0434793d0d31ce468,108508872851
20181030,"PAYMENT RECEIVED",1267476441,0,3f9678f5733b9406e3875fd3af368261b64167d71e1390ba3e94f9b796e144c3,107252398707
20181030,"PAYMENT RECEIVED",1254162850,0,4d6195ef4b1789443b64c62ba7709b6c25fa0495a2d9fbcc3df3a06135f23480,105984922266
20181030,"PAYMENT RECEIVED",1259905965,0,8f721e26bff1799d9b4d006d3c381192acba7711a6ade6d443608a389d98dabb,104730759416
20181030,"PAYMENT RECEIVED",1268311700,0,8b30d336f45b9d938a12f565983e9c88624cc4461183b0358f8837691a15e280,103470853451
20181030,"PAYMENT RECEIVED",1262150788,0,f0306a1224e2d757039f558cdd841c6c91f1a454c6ae94792f26e8062e248c9a,102202541751
20181030,"PAYMENT RECEIVED",1254791940,0,5792442faf869b9d45abd39fb8dc50e4ded5f1c847ea97206d638d754ff0dd78,100940390963
20181030,"PAYMENT RECEIVED",1250022151,0,6a54a690737ddd86a19adf5b08487d08e365fc491ba5c626c813dd1461faa75f,99685599023
20181030,"PAYMENT RECEIVED",1252172734,0,1891fc50d35108f67499b4d7da9645e240a10cd32168a01e0ada4f2f9165c5c9,98435576872
20181030,"PAYMENT RECEIVED",1250738878,0,fca4846327d28d5dc5755c375f990ca13971375cb9eee0c9eb1c6950b5fbabfe,97183404138
20181030,"PAYMENT RECEIVED",1260477093,0,dff3e231ef3adf17e2ecf6ed4237e673dc420fe165bdf2680196c6de52e04112,95932665260
20181030,"PAYMENT RECEIVED",1266235493,0,7cc37392482ba8807943d0e0b2ddc269046559f6c65e477281aa2c3b50c0f19e,94672188167
20181030,"PAYMENT RECEIVED",1251522636,0,5ed102a63e185c791d8472d440e4f7ac8835e083a7ecb1ad656ea686380eb3ef,93405952674
20181029,"PAYMENT RECEIVED",1252599555,0,e3d1d2c7616d0c65589a50b998b4d5ce6814ac952dcba37043d6df3d56a7d352,92154430038
20181029,"PAYMENT RECEIVED",1252259727,0,7846715579d08802bcd8bd2207b6ce8b96856f1548de211881da9457e91c017d,90901830483
20181029,"PAYMENT RECEIVED",1268338817,0,b29f29034fc9672a2202e317d587aa7618a983a977e79fda10c48c7e453effdb,89649570756
20181029,"PAYMENT RECEIVED",1259246870,0,0b2a6e76dc5df3d62f0555515c0f038fc43dca148b0c05aabdbd5d32bd43175b,88381231939
20181029,"PAYMENT RECEIVED",1257024719,0,a42ccb38404a56293ac2c91648a56e2a91e2032a2e052e353082457352e0061f,87121985069
20181029,"PAYMENT RECEIVED",1256027977,0,67a0f73dbc2cd957cd5ab939ef3adafd75459b2b11a1df7b3138291bee54e488,85864960350
20181029,"PAYMENT SENT",0,-50242669046,1659f23d214ece7f6eff295f46fd281b3838c11fca59a879616cc35d2d82c265,84608932373
20181029,"PAYMENT RECEIVED",1266163169,0,8f76cb9c65af0a7c17305a6d92b9e8ff36204494672653d7ed3a0c756a8b1cda,134851601419
20181029,"PAYMENT RECEIVED",1258924152,0,c0460bdcb9bac7af7c931b99e5a167ca9a75544a67a61d9431a0f17e40254306,133585438250
20181029,"PAYMENT RECEIVED",1280728271,0,a7f682d1192e012442265f911e8d3e5f1f33eb0134265798503eb5ba5898e5a5,132326514098
20181029,"PAYMENT RECEIVED",1272596487,0,d95bc268b601b366bdf9e37cb83dcaa1b861989c9fd2f623ad7ac033874972c9,131045785827
20181029,"PAYMENT RECEIVED",1265597805,0,e3691bc7e5ece64c9082a0f29b9446b4253217edb26b5d16d20d4851ef709f67,129773189340
20181029,"PAYMENT RECEIVED",1275875001,0,7855866fdf7793a1f0f7e98a05471c12ec3288112cebc62c9cb9f8593ae67c92,128507591535
20181029,"PAYMENT RECEIVED",1276695121,0,1036e3b499364f153394fcb87fc63f72d0a43696f3b0e26f3caaa32006e4c665,127231716534
20181029,"PAYMENT RECEIVED",1251553242,0,e2f5830acdd9e1c496b3bd06309459072528142be0d8db4aab82f93e8b36aa47,125955021413
20181029,"PAYMENT RECEIVED",1258676023,0,c17eeabc65b83cb59a6f8a4b21d70194999c31d70dce2e4ced72febe74fa903f,124703468171
20181029,"PAYMENT RECEIVED",1250302107,0,41655e1bb44f150db0f6438b78dfedf1b44ef609be2c4eee628402935e1ac6bc,123444792148
20181029,"PAYMENT RECEIVED",1256003079,0,18458f68eac816f8b758c7e1970b11e245a9bb86df231d6f0a6c43de1bf95108,122194490041
20181029,"PAYMENT RECEIVED",1257233919,0,8be854a85774b31291eb65f9401b7b815c66e0b31d1870219c66f2726d99183e,120938486962
20181029,"PAYMENT RECEIVED",1262197372,0,1518fabc146fd58e7cf468a814191c7321183d928160241e79ddf99c66753364,119681253043
20181029,"PAYMENT RECEIVED",1253553650,0,76dcc7f949aa57f0d1a8229962f573528b471f2799e1f61669251c13eba23d2c,118419055671
20181029,"PAYMENT RECEIVED",1253139870,0,749b9e3c2fbfd0d153424e0508401761f705764394c04076f0501cd027b47208,117165502021
20181029,"PAYMENT RECEIVED",1251439725,0,25f7f6cbc8578f454fcebe1808f5959570ab3d14e05648078c52ff326fa2d064,115912362151
20181029,"PAYMENT RECEIVED",1252706508,0,bdaf34abf897fd1ce7956d4746156cfe86f406e90ff5e411b9c9bc3a20eb6079,114660922426
20181028,"PAYMENT RECEIVED",1251460609,0,e4cd2de0a31642361d60e0ec36222c55934a859b449554b7d4d37351811c08e1,113408215918
20181028,"PAYMENT RECEIVED",1250378914,0,90a3f14784d10bfbdbcf28de33c3c194bfc4752d864907784d036b30b9ca48df,112156755309
20181028,"PAYMENT RECEIVED",1250214659,0,47cb7a12dea80779655af769df66e22f85bb506f596ffd839be6ff796a292fa2,110906376395
20181028,"PAYMENT RECEIVED",1256858371,0,04bce22e4c64b34b37755d4ce9203a91cf1ec9e271a074374aad54f46dff825b,109656161736
20181028,"PAYMENT RECEIVED",1250097718,0,1b728467bcd31feb2ea7486c9facb72c56912f3a785ad834a8c8a614a086079e,108399303365
20181028,"PAYMENT RECEIVED",1255209738,0,7318a2b2d92a2f8eb36e1cbda4fa99f2850dbd9812a998f861646a25b948f476,107149205647
20181028,"PAYMENT RECEIVED",1250000000,0,a58cc7c6f7820b31c9d4a713b0fa1a924bdb1f9e6d2be3930617c74e21c4af58,105893995909
20181028,"PAYMENT RECEIVED",1257701758,0,1ea369cf9148fa0ce33bee308fd29017673ee1c6a152dfeea794ba5e5e827762,104643995909
20181028,"PAYMENT RECEIVED",1251804762,0,bd1017877d50e2fd2ab2a89c4b7e1c89a3f519e478ea20f33f2d99491945e2f9,103386294151
20181028,"PAYMENT RECEIVED",1251468705,0,25e34845eb1891c29cabf2b91d61104bbcb50405685f9747d20d33295d1ecefd,102134489389
20181028,"PAYMENT RECEIVED",1250809691,0,38200c1e7d7b777343c1ef177ee75c9afd35a073c1f2cb9f6a3e9e716b57cd78,100883020684
20181028,"PAYMENT RECEIVED",1257624919,0,f2d295b5544b07481a9cf971cf377bc44336194a6d2cdc46b51a0d0968a95f91,99632210993
20181028,"PAYMENT RECEIVED",1253167341,0,9f7af44d40f7b7790f215bf48ad43e2b283fcf8bdc18ca1932112b7935af206f,98374586074
20181028,"PAYMENT RECEIVED",1255414144,0,766c6f54f4740b52090bf612f1cdbdc31f37bb0de43448a2b923a0d9029b991c,97121418733
20181028,"PAYMENT RECEIVED",1437150430,0,df24bcb14b7d82994e3071a05afc9ea7d0efc0d77b606032a6a477d0121cb0f4,95866004589
20181028,"PAYMENT RECEIVED",1259229764,0,77f2e8ed1cfc96b54f6c6fe4feb1b24ed2f9c78b2896901a1b0dfc4ab8668048,94428854159
20181028,"PAYMENT RECEIVED",1250150304,0,4ecbfc0125886a1c8cbfe2ce37c5b08626799d72afced7fb66afde1cfd4b6a10,93169624395
20181028,"PAYMENT RECEIVED",1255311833,0,ed22a45285085fecb1578e3e864629f495f9cda3a026b2bc67b310599d43758f,91919474091
20181027,"PAYMENT RECEIVED",1263551738,0,345c5f894744d44b310f797f8910894f2e6107d2621d8b1e53d562424eafcf29,90664162258
20181027,"PAYMENT RECEIVED",1266747563,0,814cfb81937dc36b45380b7c2f8dc676a7f3c2cc4ffcfabfb7f40c88906c59ca,89400610520
20181027,"PAYMENT SENT",0,-48995504817,444b7872b6d5aa4bde52557d59f0853d4548ebc7524aabd677e8715f488ab38a,88133862957
20181027,"PAYMENT RECEIVED",1254072916,0,a5660bfe1890e111deebd2ce9fc304e74a54c32483b30d909a459b61ea85d1bf,137129367774
20181027,"PAYMENT RECEIVED",1263654493,0,e4e4529db2ff72ac49aff0afac31f0009b4d6ca3bc4715aa5b911b2f7625635a,135875294858
20181027,"PAYMENT RECEIVED",1263470897,0,54256f9b3a78c03dd64fd253f2855b40984fed9849f29e2621a97ae2a2552910,134611640365
20181027,"PAYMENT RECEIVED",1266162001,0,5605542592a9b2b63f75319b6279888d99e4762c5795d203f0a1f728960c2ab3,133348169468
20181027,"PAYMENT RECEIVED",1250637568,0,49359ad25b9de7a06e99df2253da0ca9244d96a839031956b544067f4c11988a,132082007467
20181027,"PAYMENT RECEIVED",1253685946,0,0bdf74c6571710f9b0bf5c6bc02165bdcc3b7442f2d073bb88e59c3d7fc6b6d3,130831369899
20181027,"PAYMENT RECEIVED",1257220491,0,8f9cffa7aaa7384127bfbb83c6d6d2f0c26ec349944557dd1b5a2ab043f7649e,129577683953
20181027,"PAYMENT RECEIVED",1254684093,0,2fda17a2b06e20565e169bc4f82f762918fef987324cf1337b1e57cee36da60b,128320463462
20181027,"PAYMENT RECEIVED",1257764299,0,fdfb38c251d35afd6994a55d9d56dd8fc110e485f53c8f50f0111f84531c81da,127065779369
20181027,"PAYMENT RECEIVED",1271065702,0,f3d918c44c5ec46dfbcbdc23ed2916b301f6b2bd2386bcaaaedbc52daa2ce882,125808015070
20181027,"PAYMENT RECEIVED",1259615860,0,1f0cace60a25a4ea6da668f8b6eca0803f1532901ea8a43c5540c35c9d0d2b06,124536949368
20181027,"PAYMENT RECEIVED",1251321354,0,ad7cb527c7d97ac8e281ae5ecafbdedae547990252f0921d89fdd731296b9c68,123277333508
20181027,"PAYMENT RECEIVED",1251727611,0,db58ddbd79c5ca8035d5963e55e6ec97c0bf61ae9210c269e7912dc3587cf037,122026012154
20181027,"PAYMENT RECEIVED",1250195502,0,0c75642321c2a28be7b1592c5da22c785677f9c68be952ebb34c31150f9146a8,120774284543
20181027,"PAYMENT RECEIVED",1250912182,0,74c131d26bf956a0317254b9878925508052e1058ffcf796f8e6d41387d3aaf9,119524089041
20181027,"PAYMENT RECEIVED",1252435609,0,56482b2719d0848ebf51e7b91909e4e26d89f512af7f7b68c414aeb7581f4cea,118273176859
20181027,"PAYMENT RECEIVED",1251738570,0,ac532fbe27b0f99e17550c9fee8818e53a1628fa27766f3fb618151122762925,117020741250
20181027,"PAYMENT RECEIVED",1256134339,0,1821f9b623d8f1fcc1ffd010d4580032ca1f5d42217e58b4dc82075ff48e5a90,115769002680
20181027,"PAYMENT RECEIVED",1254385477,0,bdf8552ab03dbc7ccac2335eda4b3a7425f9d7baf70d7a44e73e50a35f864d9b,114512868341
20181027,"PAYMENT RECEIVED",1256648920,0,521ab05dc022077525adb27ce7eb5bcdd2921a4e6281a428f66a54e28de42737,113258482864
20181027,"PAYMENT RECEIVED",1253843902,0,609c51b35de67642d86241a7412c6bd5effbe4a1cb09d613ba3e00e048d7d084,112001833944
20181026,"PAYMENT RECEIVED",1254739371,0,e0e2f5ac668dede51390956d7a58b380823962831c34c0a45134ab16891bd04d,110747990042
20181026,"PAYMENT RECEIVED",1251635661,0,5fd199bce5addb628e0189b4b39689162ed3148abd2a23aad94128cb2083da2c,109493250671
20181026,"PAYMENT RECEIVED",1255804545,0,7f217050f83ba52cb8e8a8afc26a287f15a1bdbf4e8db579a3e369b06dc8599a,108241615010
20181026,"PAYMENT RECEIVED",1252829139,0,d0ef94e571131218c625731a0ce5d026263b4d9a8c21bed9ec30dd3a761de915,106985810465
20181026,"PAYMENT RECEIVED",1250197370,0,f17c99ce5e10b1699d0d6a66fe8d981f63997e8853612b7048c1e6c9d09f0c2a,105732981326
20181026,"PAYMENT RECEIVED",1257648009,0,5656c7e56798eab2391ba7ae0249de7b759aabf19a70502b7646283242ed30a0,104482783956
20181026,"PAYMENT RECEIVED",1254304396,0,ed1cbea4abaa993b6808644d18d54f6d8d2701ed1618cc832f67665608079ba2,103225135947
20181026,"PAYMENT RECEIVED",1258931699,0,53ba1209f3c62f961ecc83c9d0e5352c57c294238f24f16b0d79717f92590005,101970831551
20181026,"PAYMENT RECEIVED",1260566756,0,62dbf696c506c50f9461bdf55a428248a65221eec6da78df651b02cd7b3f5a79,100711899852
20181026,"PAYMENT RECEIVED",1277177010,0,b5ad4df079e0fb8b687dc93b99ab6b5dd928c3514a6ed700382862e75b1a6814,99451333096
20181026,"PAYMENT RECEIVED",1250000000,0,5b018683c8a667868de0a4e9030037875093444adaeb3b39a02c438e94cd77fc,98174156086
20181026,"PAYMENT RECEIVED",1284041595,0,da6fef71523132061db00ad518bc57b4b21d5fdbbac24fb27a346143af35abf6,96924156086
20181026,"PAYMENT RECEIVED",1254581244,0,e8dcc8f8d26a07df85266d6550983e28ce109ec7fe30ef80702b0e5619a56a00,95640114491
20181026,"PAYMENT RECEIVED",1264519432,0,3bdc9a2a4951284f4049690f3a017b48502ee120164bda3ce36e9b87ec85de0c,94385533247
20181026,"PAYMENT RECEIVED",1257552631,0,fe56b3b84dfad449457e8313454e4f403491ff4682985d21e0483bdc66840996,93121013815
20181026,"PAYMENT RECEIVED",1254959489,0,f938671307da7e9f5bb1492dc238075f31ca64b91d8472a0dcfd08822040b0ae,91863461184
20181026,"PAYMENT RECEIVED",1255176526,0,7ff1ec3ac6d1931ebc1e3937584c65091801a39d7e55eea07366388723a110d0,90608501695
20181026,"PAYMENT RECEIVED",1251564388,0,770c2f5b23eb5fcbb6bc422dc3cc4a6da19b4f5539c9669ee9bf9f96b5d387f3,89353325169
20181026,"PAYMENT RECEIVED",1255990383,0,b8141e606e7ad3943d65d6ad51340e2b5c847796bfc463f68252ba30b34b4fc4,88101760781
20181026,"PAYMENT RECEIVED",1251639793,0,6fa2d3022a0581f1b5b19e0cec12cb117248896de1b3dac9ca419a1e6543c092,86845770398
20181026,"PAYMENT RECEIVED",1272402779,0,3c199d57995aeae45acc4d4a6ad5c942beb3aaa74ae275e9cb36debbf8c66de4,85594130605
20181026,"PAYMENT RECEIVED",1255897012,0,557a9e0a9020ca68784a8c54a3fbdb8deed07a8070d94dc2d3f91f4aaa9b0b38,84321727826
20181025,"PAYMENT RECEIVED",1255158737,0,0c33f0e066292c8d0ebe474af3f5ee2f193f3610f2f5d1453a10e0a252693f0c,83065830814
20181025,"PAYMENT RECEIVED",1262114768,0,72e915f6a867813c7418c87599673fab93ae91cf1adb10144d9789583e91806b,81810672077
20181025,"PAYMENT RECEIVED",1251335008,0,840c71546cc30292827d37a36941aac8172053404a3abdc52326609a2df40491,80548557309
20181025,"PAYMENT RECEIVED",1254186161,0,a48eee3ad32fd16df2bedcde7887857e59b63aabfd2b4a1e6ce1bf8ae0e9def1,79297222301
20181025,"PAYMENT RECEIVED",888,0,475f3d0e9f464f9828722d83d0cd2c04e27a70bd251dadbbdc740ff6fa4d4dee,78043036140
20181025,"PAYMENT RECEIVED",888,0,74dc787f2585ddf7116c4cf7b9fe797fa787db8368fbf06e0775fc4c5ce419b8,78043034364
20181025,"PAYMENT RECEIVED",888,0,b0f68a63e3d83e994af633152694c6ec3a219474febc21f49bae87f875d96905,78043035252
20181025,"PAYMENT RECEIVED",888,0,e9e982b32787295f386e53d413a827b6ee53e6e8fdd99a2dcb23086a6a09542e,78043033476
20181025,"PAYMENT RECEIVED",1265961522,0,2f5ecd039e63f8083b99d55a849127de27e4f55b5d264417c4e68b00f64abf17,78043032588
20181025,"PAYMENT RECEIVED",888,0,af51289cd144099fc329213520b1fc505847d4a7df77aea2b01adcae976b1c7b,76777071066
20181025,"PAYMENT RECEIVED",1254903228,0,9be035a96b1aa6dbd3c7ea6e62c69b370e695e9580254d2ef37993cd6047778e,76777070178
20181025,"PAYMENT RECEIVED",888,0,6c47f706a307832123092338ac71bc660e72891bb1dfe699ae75af89281875a8,75522166950
20181025,"PAYMENT RECEIVED",888,0,49663247ddbf2f075fb622f92260c509e6446fd7b402a76d0a58f0f77e4e72a9,75522166062
20181025,"PAYMENT RECEIVED",888,0,f39f63281e7df15f418e999bbd8e42c96fe7e06d7c6b7a96525fe45cdea40b2e,75522165174
20181025,"PAYMENT RECEIVED",1277016420,0,136a68f942f8ecdd7c4e29d8eee28e05fde78e9c21b5308a90ccb4561709dd79,75522164286
20181025,"PAYMENT RECEIVED",1271536603,0,55a0a0f71e4c84ccaee26471d6a7fff94666eacd8a81b8d8f7b3128464ca4e1a,74245147866
20181025,"PAYMENT RECEIVED",1290462111,0,0c064cf3982440a26edc104d1d00f0391da43beda45bee711c9731cc617696e6,72973611263
20181025,"PAYMENT RECEIVED",1264556987,0,91c0d09784ddbdf8a6082dcc9b8ec0aa79b37c0b5ab434897d3c85868e0e26ec,71683149152
20181025,"PAYMENT RECEIVED",888,0,6042546ef0857e7e2387be1f58cd98cb2139e3c5d7a182262914f8ecf051d0a0,70418592165
20181025,"PAYMENT RECEIVED",888,0,9b50b32ecd7c0df3814996db42b6b336defaea88db4f0f7a0f9f50aa84351a50,70418591277
20181025,"PAYMENT RECEIVED",1256946090,0,a5ff7448894bd803008eec5846d9ccc720423868a5a7b01769ce725ea2928ee7,70418590389
20181025,"PAYMENT RECEIVED",1262732835,0,e2bfdc79876a4079863ba769578aa9502e0e56b690109b0585e5b730261bb564,69161644299
20181025,"PAYMENT RECEIVED",1256649663,0,2b1f587448c789ef8035fe31c06dac6ee0748bdb330d020df0d81372011c6c75,67898911464
20181025,"PAYMENT RECEIVED",1254591149,0,c4d0de41e120a61c2f130d06804d746522fe7a0e7cdf140ee5c76715956d4611,66642261801
20181025,"PAYMENT RECEIVED",1257395226,0,139e76718140981c58ec2bf2c9fb46b1bc5bd5894a741d5e32a2d295e1609593,65387670652
20181025,"PAYMENT RECEIVED",1250279612,0,5205048eb57fe0b2b815d2deb2dd84bd6b8668aa92d58135da760995fca5e5dc,64130275426
20181025,"PAYMENT RECEIVED",1257532533,0,e4af648eb5b01a0b8624554f8d9b0cc73b871e8c2f6a31588cde16b5b5f60de1,62879995814
20181025,"PAYMENT RECEIVED",1258920254,0,3994696272eaed789ce86290045b2f59978e2dea0b8366e884cbc21486689657,61622463281
20181025,"PAYMENT RECEIVED",1251462346,0,d56e718d3b26abe77ec17781a964fa8261c14cbb6fa67fbf6907aecfe6a3fff6,60363543027
20181024,"PAYMENT RECEIVED",1257441203,0,59f2f7ecb96030122ec58ba8157428cf8d28fb96e3daa3fe07b329133d0ee8e6,59112080681
20181024,"PAYMENT RECEIVED",1250211517,0,2a71b0ff715c6d3bcfd99037a771985eff9b663df5a2ba408dd6bfe7bb3db0d4,57854639478
20181024,"PAYMENT RECEIVED",1251131708,0,069b09de7771381fabd103668b93f7febb49e997d943d47681d88c81eb7a7a32,56604427961
20181024,"PAYMENT RECEIVED",1256105249,0,459383ccc64dd1758ab1db3340efbbc6028bc4e3edb5af1e3093fc794e62f92c,55353296253
20181024,"PAYMENT RECEIVED",1262163237,0,ed0c49cb9b18496cd71507443be6d1d85a082839099d142bc84f903b39e6dfbe,54097191004
20181024,"PAYMENT RECEIVED",1267777876,0,bf3a059cfe063e75ff881040743df02e9dc28e83e80900db9b8fbada9328e6eb,52835027767
20181024,"PAYMENT RECEIVED",1264415143,0,644a4f5b3e7f0779b4103b2cfe5df3d6e086da27b3d0f6d12130d0dd0766565f,51567249891
20181024,"PAYMENT RECEIVED",1274002973,0,3f93288248b830448042888559c58c756846e0cf1da501fae6163c767c34c08e,50302834748
20181024,"PAYMENT RECEIVED",1251783603,0,3fb4ebc82138c4a230f7bf4640070a7fb26c8a1a711f30c362e00e576433448a,49028831775
20181024,"PAYMENT RECEIVED",1257788011,0,6254307b3b108ccfc65a4487ba9e901a638b0e0b721e2a177ee353bb63eca962,47777048172
20181024,"PAYMENT RECEIVED",1259789810,0,a5b2836e591964730611f3ce759d6359e13fe2ba6a04cf993e3d5fb5d5773782,46519260161
20181024,"PAYMENT RECEIVED",1265510986,0,c6bdc6574dcfd1af947f9e38fb6136022def6c9e2c1a1e045efe07e65c105d36,45259470351
20181024,"PAYMENT RECEIVED",1251285619,0,130ae27e5814469f870a71f6c8690b8f574948b93be943f7b06e61432a5d108f,43993959365
20181024,"PAYMENT RECEIVED",1270123349,0,367b2933d89c4c9db8d9dd515e92ae205e2e519e707157ed1e5fbd4a79d83094,42742673746
20181024,"PAYMENT RECEIVED",1257513796,0,da0cd8f60b5328c0da68ba60561e2cef6c6512b3f73dbae167b278d9328382e2,41472550397
20181024,"PAYMENT SENT",0,-48084472642,f53804645531b261d137d7765852360343cdd0b28712f41433e9449572ac792e,40215036601
20181024,"PAYMENT RECEIVED",1250570305,0,be8be1b7029313f246472dd6e1a738580e90770aba0e399797f9866c81f29648,88299509243
20181024,"PAYMENT RECEIVED",1259070654,0,2112d3136edfafdd0d290208ae0c8fe740705ee061a2559f16955ac48cb118ec,87048938938
20181024,"PAYMENT RECEIVED",1253872697,0,b876fc45ec92bcd1d66f5ed97e64e42f5578f6256714528618f12c29a250a417,85789868284
20181024,"PAYMENT RECEIVED",1271409546,0,4673a0daffcd80b0aae515588963130f9cd06f0b728a90050d454f0688116b39,84535995587
20181023,"PAYMENT RECEIVED",1256912558,0,0558d76eed461297daba2be0ff1a8d75ff9342ababfd783457914fa95a6c7cf9,83264586041
20181023,"PAYMENT RECEIVED",1256987366,0,5d438b7dd720a0520d281ecbeb9fd537c41668c2bcc405e01dd182dde7af177a,82007673483
20181023,"PAYMENT RECEIVED",1257077330,0,5653b960d556b3e58e3f11af9868fec069e44764120b3ce04de7f67a27893083,80750686117
20181023,"PAYMENT RECEIVED",1250319008,0,2a707b3f9846d666a579da50e2d56d98d01a85bbfc9707dfc8b79708882ff695,79493608787
20181023,"PAYMENT RECEIVED",1293086508,0,bb2f5e5b3383b1d6e13d5769e3cd98042eaa5b83b9a6ffb376686be72fa32ece,78243289779
20181023,"PAYMENT RECEIVED",888,0,1d6580dcd979951bd600252b741c22a3ea8e605e43168f8452c68915c3ea2bf3,76950203271
20181023,"PAYMENT RECEIVED",1279384086,0,48e08bc860fd4143affce7eb783bec5b8979a426f114c4bb2e207944f908adf3,76950202383
20181023,"PAYMENT RECEIVED",1251545111,0,c5b9e2513ae446eebb48dc71b67c1c50571f1ba1c3a1632cc0a609e679a21334,75670818297
20181023,"PAYMENT RECEIVED",1255946987,0,0ec5bb5fe64b3bd96d423ff74f64295a781ebfb86af945e256a8776848570556,74419273186
20181023,"PAYMENT RECEIVED",1252163705,0,0a746f1b97c2abf9a2e09f4b866116190c9674af4a0fbc14ff6d03ca6b44c32a,73163326199
20181023,"PAYMENT RECEIVED",1252968858,0,9ded1474cf949060340193021a1db3c22610dfaabc71ff73d91f249d8d57fe92,71911162494
20181023,"PAYMENT RECEIVED",1251731731,0,4126a83021aa43bb8388c29eab06ebb534739977bd7a6bd254c7851cfd3e6d6a,70658193636
20181022,"PAYMENT RECEIVED",1250268950,0,dc1272b1a917c128789e401c1601e20b71827f9323f9b57eff47189cb677a397,69406461905
20181022,"PAYMENT RECEIVED",1252329623,0,22d47f65626cf5efd845efe366ce6f404ca84455f628da44827cd1a9f6ad1992,68156192955
20181022,"PAYMENT RECEIVED",1250461735,0,b62cd16e0f067874b303b035005bc537d42ae910747a3cebd1cd18a89573d2c8,66903863332
20181022,"PAYMENT RECEIVED",1268657789,0,7cdff0724560f72bab0c5b963040969e6b9258186416fb91443d88126e600e6b,65653401597
20181022,"PAYMENT RECEIVED",1258822353,0,ebec2326e1ce7c864cb379cc0d86d98934db5ed2e1dccd066a0f3f309a4b0883,64384743808
20181022,"PAYMENT RECEIVED",1260383310,0,18e54cf1ce0245844b444a53c7341fd02ce785ce49ae375ad9e4d47f8c9b6387,63125921455
20181022,"PAYMENT RECEIVED",1266422335,0,dfd32f41581e2fba49184c038d0aff0f6b9cb4ab21b7da0107017ec462d362b6,61865538145
20181022,"PAYMENT RECEIVED",1264239802,0,f9705f90f817de3fe28c3487d3cfe3b5ce9395fc68685e4c2be6293cae9f9546,60599115810
20181022,"PAYMENT RECEIVED",1265410986,0,7b11c35ee72025151c83e4db4e894be1049b366843c8690d06133750874f510c,59334876008
20181022,"PAYMENT RECEIVED",1295769425,0,fc9fa16776bf5e5ad05af16b412855ae89c9bf3313270e905c54ff6144f6efcf,58069465022
20181022,"PAYMENT RECEIVED",1320292709,0,9dd2f19aef8020f7f8fd2113a215726ff62d2299a5017484f2c4bff97b9effc3,56773695597
20181022,"PAYMENT RECEIVED",1262366991,0,a8284923670080575cdea0d48796c67c403932ec594b711f8193bc8816349127,55453402888
20181022,"PAYMENT SENT",0,-47742190249,ac07769a510579c8dc1e67bc40adab9c615f8800f56e80b93ec5cb2d7cee2999,54191035897
20181022,"PAYMENT RECEIVED",1250352884,0,7bc3e7017c950f701e01c7ae9e0e13efb18b2164ee83e807adfbeb1090af7012,101933226146
20181022,"PAYMENT RECEIVED",1273797009,0,95b31dfbe6cbe3541ed9618a45ebb4718817998b68e12cf8b2d947c946568a17,100682873262
20181022,"PAYMENT RECEIVED",1250671506,0,55a12677ad60d617c07c8eec7d70cab4ce26ec6843cbbb177f95af80a67925c9,99409076253
20181022,"PAYMENT RECEIVED",1264480124,0,5b1da0a7bdaf9e9c63eecbfbccfeddd6da36e83c71f00a1a4f1a3000170e9806,98158404747
20181022,"PAYMENT RECEIVED",1265614208,0,12dcdca912473506301626c912f4e584c7d64edcd1d7d94446157e71ef9bb5d9,96893924623
20181022,"PAYMENT RECEIVED",1250356894,0,1715e34a13ed67a73962dd5ff8eb84598a5dfdefe7bfd42a25a6d4ba5c12f120,95628310415
20181022,"PAYMENT RECEIVED",1274452789,0,5901565ac89be8f4e946d1a991a74e62cbfdd9e4d028adf7299322570e8b7f6d,94377953521
20181022,"PAYMENT RECEIVED",1270239578,0,959eecdb7d1d7c2efdcc6fe6792379d74b7cb9e3782afe2a1e127187346ff5e3,93103500732
20181022,"PAYMENT RECEIVED",1251448088,0,aa4d480c3ace9a7e5ff6d8b7d8fb4b7952d596ab5eb8eaab4f32cdb6f2ad06f2,91833261154
20181022,"PAYMENT RECEIVED",1260937215,0,1da0154361b223dede35adec08889acf46e92ea3500ca18bdd53e089ccbe6ef8,90581813066
20181022,"PAYMENT RECEIVED",1251297058,0,704315cd8d7053627ddc1f63bd3d4098b3e49a88c07a8a9c5d0d00306a656c50,89320875851
20181022,"PAYMENT RECEIVED",1250001000,0,1322e175c1ab823b5642bc62e9279039fc73b116c1db40f662339c83fbd85b56,88069578793
20181021,"PAYMENT RECEIVED",1262976457,0,350eaca656cd348bb34827b0bfc04af9e14eeb1e904047e6f971af74c823ecff,86819577793
20181021,"PAYMENT RECEIVED",1256016313,0,b01136b12862c86c8656f248b5d8e03449ea6e3238896b10e39c7400cfcfc291,85556601336
20181021,"PAYMENT RECEIVED",1253803487,0,5148bd72046093723282c35bcfe3d036478b6ecdcf04a7d80cd2e4b62a3663f9,84300585023
20181021,"PAYMENT RECEIVED",1251618161,0,d1794c897da9f7bf845d547040712787be5581d7bd06ab99242e793db5b33cad,83046781536
20181021,"PAYMENT RECEIVED",1259944700,0,44741ae99e694fedaaffbe5e3ad8c3a76ecd484f88f4d81db8fbee8fa71a4483,81795163375
20181021,"PAYMENT RECEIVED",1250076978,0,257b010638777690ba6a31cb152fc8c14b31cb9f7d48e991b80942c232b57b4f,80535218675
20181021,"PAYMENT RECEIVED",666,0,59f144e3bace3268d7e1416c83c3f6d70fb9a0a46e525525f320bd72aed9cc3d,79285141697
20181021,"PAYMENT RECEIVED",1256384130,0,3fbd8967f9ccd2eebbda2cb2ae9c8e9a34fa166a4b433f7757acd786bc649be3,79285141031
20181021,"PAYMENT RECEIVED",1252922940,0,129f30376d296d8611ed8d2f214d7243d17012f2919cae0def17192dc9faadda,78028756901
20181021,"PAYMENT RECEIVED",1254185383,0,1b5bebf58a80b37a478efe6835a03b85233ede0cf9623f4894f30d1eab252ee7,76775833961
20181021,"PAYMENT RECEIVED",1254807167,0,6771b78b35180ad444276644b28c05136127b5fbafe31f1001180065ef5a6109,75521648578
20181021,"PAYMENT RECEIVED",1253050055,0,96d154b427d73e9e1200332e7f73aea5d576a4463bb03fa47da64b9ca6927503,74266841411
20181021,"PAYMENT RECEIVED",1256846819,0,64bc9c427d0a11eda93709bc5c81b409e0d29941f19b69e71d0c5abe7690025b,73013791356
20181021,"PAYMENT RECEIVED",1254003985,0,4f05ce01490f723ec5d16f9ce43a299bf215be2bbeb55d4c72d9bd391fc4cb70,71756944537
20181021,"PAYMENT RECEIVED",1250086582,0,f13333fc01129a37ebe9d1ad3a0d2178cf73618348a82c377753cc65f45171d1,70502940552
20181021,"PAYMENT RECEIVED",1256346209,0,e0fc7e9c3a1d31c8228e9ae498e3e69becb1eeacb0cd66117342f2aac9bc9c62,69252853970
20181021,"PAYMENT RECEIVED",1256506344,0,782f19d40cb9de17a0f3962df827e160a42263b0a3292e24bf096738aa380922,67996507761
20181021,"PAYMENT RECEIVED",1254895154,0,7650842bfb6286c369a084716d61755b9b767fd01dfea0f75739c6b5691c6f42,66740001417
20181021,"PAYMENT RECEIVED",1252251238,0,d60b8160c21ccc67fb42fa15a6bbcc2bade5d2ca9dcdd72a4ff359e5ce6c1691,65485106263
20181021,"PAYMENT RECEIVED",1251474131,0,18b13b078840cfd64d7c9fbbcaaddb510b8f67784b84736fb3d2c262e5dc80a3,64232855025
20181021,"PAYMENT RECEIVED",1266428345,0,4132dfaec465829994734bddfd7ca94727eb4af706e4371472ffae517c7ac0d6,62981380894
20181021,"PAYMENT RECEIVED",1264120503,0,0659a6e547f5f5084d836582f15461ef130ae28c051672bad01ca390aaa908e2,61714952549
20181020,"PAYMENT RECEIVED",1250659496,0,965d0c9db7585e40b998f3b585342d1861bf883b9bb12675558f3aac16e31527,60450832046
20181020,"PAYMENT RECEIVED",1250181322,0,24d0e11f8cda7868042496465adbe87e9019b3879adac22e5e95cb69c7f36081,59200172550
20181020,"PAYMENT RECEIVED",1256251711,0,c1f6965051849deb9350931cde902ab8c13ca7b07a9fd9c88f605ac2db961c62,57949991228
20181020,"PAYMENT RECEIVED",1251047827,0,2145c98995141558a44d373ad423236e77305a586ed5511bc6b6f0bde957f272,56693739517
20181020,"PAYMENT RECEIVED",1261633616,0,11839c313a3655be52f018f1aeb759557989f640b6ceac14afa3acc8fe5ecfaa,55442691690
20181020,"PAYMENT RECEIVED",1271029548,0,ebc2bd391b73da3c12a5d6b20f9dccea6417668f35febc9bb1e0363c2ddf268a,54181058074
20181020,"PAYMENT RECEIVED",1252551504,0,7774c5abd92a3e74539470dcb1c44a01bbef13bfc30075c59cbe6449ca342432,52910028526
20181020,"PAYMENT RECEIVED",1266115630,0,77c71cb3c0cfdb0dafb2e6ce29907bf3145de053772bf4eb991fc612b124caf0,51657477022
20181020,"PAYMENT RECEIVED",1257325020,0,9f21c2178e4c9f980119c6071c5bd57f27a12a8c6cfc7d55c0fac9f339efa278,50391361392
20181020,"PAYMENT RECEIVED",1250962497,0,6ba2ba2de3122b9694e8b04efc7eb20548a4f76ac918f8dbf169b94692d4ac23,49134036372
20181020,"PAYMENT RECEIVED",1271919688,0,5bee2b088931ad2243a5906dc3a5932ab0e4dd8f6e27ef5a1c783abb6903677f,47883073875
20181020,"PAYMENT RECEIVED",1257302742,0,95aa8c41331e65b20b11de2f38f366329fb79e3c8e475ac4db0f0e34b137bb97,46611154187
20181020,"PAYMENT RECEIVED",1274084177,0,a104360b131a61845b98eb3d2c092e41e8e3157f382a123ef723ecb90fac11f0,45353851445
20181020,"PAYMENT RECEIVED",1268439827,0,87b1ad160e97b8a6b9ce8ec736f2803544c1e225aa7252c7f8bfd12b88186e79,44079767268
20181020,"PAYMENT SENT",0,-50407548620,d0d7a3bb4e350c9172a8f2c305b9d1f621b4da9b6a7a80ee0e79e6cb056e1e98,42811327441
20181020,"PAYMENT RECEIVED",1253496084,0,3d23932e1c1354a7e56ccd450eb4f463ea834eea84abece8ce8a9c03d1ba447e,93218876061
20181020,"PAYMENT RECEIVED",1259715492,0,dd23e4f815b291890584afa8fab1040810354977e3049859e73e622e390759bd,91965379977
20181020,"PAYMENT RECEIVED",1252704264,0,c1a87210e0892a0a67126adb9a406fca5ea098ad3e28a9236cd9f8d06126f74b,90705664485
20181020,"PAYMENT RECEIVED",1255632819,0,8479b2756bd9da0f283ee74068811d3626be3a0f4ea8f90e6668361969ed7bd8,89452960221
20181020,"PAYMENT RECEIVED",1252729403,0,6a26eb76c5a2b2d385ae6f8d3cfa36eb72e4c0615cdbc7a755a963de635fc45c,88197327402
20181020,"PAYMENT RECEIVED",1250271536,0,ea90a38275d8a654bc35f5d6650669fe8a3b2ab90fff7794b7bea8fd9ad0920b,86944597999
20181020,"PAYMENT RECEIVED",1250272045,0,abda43dc5ae5f62a610816b7f01e8e13d70ab2d2a2d92ed3c8d69d4a0ecefb78,85694326463
20181020,"PAYMENT RECEIVED",1251942289,0,3b47a6a3c1e4cd73e844592a7406fd5bc34a406d95a67a348712b4b7b779a4df,84444054418
20181019,"PAYMENT RECEIVED",1250018160,0,30804bbf38392ab7daa54c040ec58d035e4c3717516bb1d5c7bedecac29de8a8,83192112129
20181019,"PAYMENT RECEIVED",1256245215,0,7f8fd40d9bf0626eb52d7c78443cdea635a0d0056e64d3b574730710bcf86375,81942093969
20181019,"PAYMENT RECEIVED",1253648249,0,91b6579cd918eeae9ad965884ca296b3d703856d21759ea87378dd4c31a7ecfe,80685848754
20181019,"PAYMENT RECEIVED",1250174682,0,fadf40706f314b47c2f0b4e49190a3bbcb30e8f04d659a119a59f734b71c71d7,79432200505
20181019,"PAYMENT RECEIVED",1254824083,0,0167a12f41822aa9002a5e9975b47ea89b6a5526ec28a8a54b125e55c5941d31,78182025823
20181019,"PAYMENT RECEIVED",1255437444,0,60874c63f65234b2b205d9e778d6805791380ceb8629c64c547e965945525f4d,76927201740
20181019,"PAYMENT RECEIVED",1257757484,0,02e0712a3a0e7d605574ab904d33259430dd9e3018faa6e6a21227c312009624,75671764296
20181019,"PAYMENT RECEIVED",1254867406,0,a4ab4a3f0a602bee91e21204e42d48b04bd1e4fd99f5f91284d0a7c4fb896f36,74414006812
20181019,"PAYMENT RECEIVED",1256117007,0,ff87cd8bc0285b20d18bb1d0f52630fd645c6961258a96be59e7194be5d981f2,73159139406
20181019,"PAYMENT RECEIVED",1256814022,0,690ca1e0aadfe6a2e004a6f2955b60c75f8037cfedd15622ee8893b1fb7ec66c,71903022399
20181019,"PAYMENT RECEIVED",1287586843,0,fb96ae4a17e30e9132ca5756293a0614d346b625c58a1f2c5fedc26efb59d83e,70646208377
20181019,"PAYMENT RECEIVED",1272896590,0,691f8b4606cb16df89deeac0c0730593b1748c5617b8ac5ce667a335c0de38d0,69358621534
20181019,"PAYMENT RECEIVED",1280413505,0,c87bd4d9663dc0b3740d90916983510dbc8701348db314178c39f9145d780f7c,68085724944
20181019,"PAYMENT RECEIVED",1262511573,0,644b8d6d5ac4e76e0cf32b08207365f4aaee3189539d950bb31b34e796977cdb,66805311439
20181019,"PAYMENT RECEIVED",1253908833,0,8ad05f9053d18822bf762c753f0175eb367d29f776f7551a3a7d05acdb18402f,65542799866
20181019,"PAYMENT RECEIVED",1273735777,0,f1e3dff4f898f3685087b6e7d22e0f88c2339cd9bb44bf343f59e2bbddb71619,64288891033
20181019,"PAYMENT RECEIVED",1253846203,0,6e9f8239378df232ffcc148190e8431f681e8b56fc755c98f338974dd5f01f5f,63015155256
20181019,"PAYMENT RECEIVED",1258381981,0,bb90435f96bad20318fbe528b20c18db47747e6bf06a37e23b6c9b694e494c4d,61761309053
20181019,"PAYMENT RECEIVED",1253832337,0,8bfb1edbb3bf8c827b75ff937593f6e9f76cfa78e47ffe57237ea9596d4781e9,60502927072
20181018,"PAYMENT RECEIVED",1253736386,0,57e3f2128bda375d17e3fdc0999e678ad084f0090a605b062adc48558204ecff,59249094735
20181018,"PAYMENT RECEIVED",1257271011,0,557f4e673e41e2bc5c714a3e63a0ea809493b80c020834041affa7b946e5f5ee,57995358349
20181018,"PAYMENT RECEIVED",1262232460,0,42c279cb2f0b40d8a64d1fb6ca7d45a8816c963cb43aa45a9b80ce0cdb604e43,56738087338
20181018,"PAYMENT RECEIVED",1262976106,0,7cd56428cf725ddfc5d6a66e1811523d97627d3a53ce585c8ed94ef87a1cd153,55475854878
20181018,"PAYMENT RECEIVED",1284222473,0,e3f3451ec77356689ebc5502094b9fc14fb24adeacce681706205e506eedae1f,54212878772
20181018,"PAYMENT RECEIVED",1251380795,0,2e4a884c65b67db11528d9f7a0cccc7a451c7f02818310b34db2dba552c03006,52928656299
20181018,"PAYMENT RECEIVED",1258487647,0,c55a64d07394cee2421312d5728184ffffbaf0ab8cf647c578a7b80f906d9565,51677275504
20181018,"PAYMENT RECEIVED",1268547381,0,076085b0d10f31ab4ee4ec51732cd61bc8b262cb07e5c9e3a79f9b0893759198,50418787857
20181018,"PAYMENT RECEIVED",1257081322,0,4bcc46412f9c619b9bb804105837cbb9cc11cefb3495a34d4c4bc531efbe66c8,49150240476
20181018,"PAYMENT RECEIVED",1263848634,0,1719d6c70bc3cf2f33d5bc78a339f4b09033471e3454cc2a099916c987702212,47893159154
20181018,"PAYMENT RECEIVED",1265468159,0,7922d4834e5769c6dfdd7f8b552cf01af712d8eccff5738dbccf67e7dc806217,46629310520
20181018,"PAYMENT RECEIVED",1272994517,0,faeeb6d783c807349d25ddee6f73d15100d3b32f405de1c6724ac25c8b5bb1e0,45363842361
20181018,"PAYMENT RECEIVED",1262158955,0,fa1e18b81e5df35efa3101d2ed825262e9b6d7c1335fd555bdd98c0fffb807cf,44090847844
20181018,"PAYMENT RECEIVED",1261873938,0,825553be8185d53c5587a9eeb1c7532f2b805570db04ba3edc0989a96469ce99,42828688889
20181018,"PAYMENT RECEIVED",1253867610,0,55f592d09e3d52fee117ddb4d027433968f7acc4ae02c49b05a2862884c0b820,41566814951
20181018,"PAYMENT RECEIVED",1250160694,0,e98929161ff71f30de657ee204a7ea208d0d5463325f28d0addf72ffbe376a9f,40312947341
20181018,"PAYMENT RECEIVED",1254792953,0,6d3a26058deb9e4aa9db95a634e79cd30ca21b03d51db8d8d7eda6e818552fa1,39062786647
20181018,"PAYMENT RECEIVED",1254149231,0,bf8784c208f44f226333c4bb2e53925e93e8203df95a2ff32b61a5e7f3785dfe,37807993694
20181017,"PAYMENT RECEIVED",1254718011,0,ba38779fed3744249dd005546415a93c811fc5df21d1cf40bf63186edafc2e36,36553844463
20181017,"PAYMENT RECEIVED",1258500212,0,dc76c950173e1670d4ae30f03fa6ce5f038e6f7a71a7711aa1dd8ece9fc4739c,35299126452
20181017,"PAYMENT RECEIVED",1256332931,0,8fbe106d816e7a3c5d49fb0c6d2070b3f9efc263ba8432f72c6c6c19bbc4ca43,34040626240
20181017,"PAYMENT RECEIVED",1284391230,0,069c6c8ab5ebde9ba41d27a1292f9bfa21f3791b268b67a00864a8ec1f76ab52,32784293309
20181017,"PAYMENT RECEIVED",1253062660,0,59b8d90b17377036b522b0bdd8bbaaa4f7b5ddd138bd27c6f1d8e6b453440bf9,31499902079
20181017,"PAYMENT RECEIVED",1258414984,0,300a9450479ea78c3ffe1c1edd2513246e3a2b344e1de93744a5806f1803b9e7,30246839419
20181017,"PAYMENT RECEIVED",1274599272,0,62dcc862bb6e50cd713f822ce8314f76b77137a5c428c3f2b8fdb7b3481ffd1d,28988424435
20181017,"PAYMENT RECEIVED",1262130677,0,24ce8a00415ae2724f3f05d606261bf6d29bf464d8607737b5e091ed49d80ab1,27713825163
20181017,"PAYMENT RECEIVED",1253544472,0,cf8f4488ad527610301ff742a0f90540f3221474d1be59b5d1cc927e585a39ab,26451694486
20181017,"PAYMENT RECEIVED",1265561742,0,aff01d7632d58cfe3ecf3be3d5abc0e00b5e6000fb7b40ab4d4c0a52aaf2eca6,25198150014
20181017,"PAYMENT RECEIVED",1251647449,0,96fed90251d031e9aa079198ff7a530608d7bdda40a53006059d45d53ecce33a,23932588272
20181017,"PAYMENT SENT",0,-47869682327,d9df6e9b9a93269614405e331b3972958c5254fbaeb2cbb2086d4102b354c09c,22680940823
20181017,"PAYMENT RECEIVED",1263477160,0,a7187f5d6f06649944974f758ab46d91f225453e9e59c47dd9d12b74075ea1a4,70550623150
20181017,"PAYMENT RECEIVED",1272097698,0,a1886966dbafa35a692b60fe002ec715459b35432d1317d7d12fcd1026a2f88b,69287145990
20181017,"PAYMENT RECEIVED",1250776715,0,d3e03673cb81b1d5aefae48bba4faf623bd81a5b13d118bf88826155fd39705b,68015048292
20181017,"PAYMENT RECEIVED",1253407244,0,a77389ea3d6a4bb0acf15dd486d4fcc3330b7b8823c351eaaec40d3585241643,66764271577
20181017,"PAYMENT RECEIVED",1263358586,0,206b1fd5d52ae2b003eded952dabcb0154111be3049213b9568222fac1b8f7f8,65510864333
20181017,"PAYMENT RECEIVED",1264731716,0,944c5de39aefcff4cb5cbc23dcf50bd2daf370e27c3e1e8d5e45696be0ea05a8,64247505747
20181017,"PAYMENT RECEIVED",1257826597,0,e284bf53f8f195087b73d7f248a43f31711227da20373efce247fc7ed60c120c,62982774031
20181017,"PAYMENT RECEIVED",1252727273,0,12e1c94580ef4bff9f9e6045429062a63e33b9e56018be705987836fa548d772,61724947434
20181017,"PAYMENT RECEIVED",1263620701,0,fcb47b12c974062b0a62d40540e6596d701f6aa7ef8897c6a469d13eca0de3be,60472220161
20181016,"PAYMENT RECEIVED",1254464349,0,8ba640201c8db01dd3f4cac9360044873293051630b1a8bcdf27032f4929cc57,59208599460
20181016,"PAYMENT RECEIVED",1262262546,0,96d1751d365a7abd4d2a051273832cd4901e8c3654b12f79fd73f526779be282,57954135111
20181016,"PAYMENT RECEIVED",1252806147,0,d4cd2dfe681410eafb3bd3001459ce3462ed638d8d3a8b8823e6ad785da9fa6a,56691872565
20181016,"PAYMENT RECEIVED",1252056860,0,4b8620518d39f988dc88e77c4c70fc9a45573891053aca9efc043dbdbccdaa67,55439066418
20181016,"PAYMENT RECEIVED",1250000000,0,ea50fd8521e8b0d2c777b2467925c244041811529a7503c209453d218bbf9989,54187009558
20181016,"PAYMENT RECEIVED",1265342635,0,8a9967f638d5e905010f4614a8ecf0914f0dd1d1abbb1c43fc9bf75e4ecbe965,52937009558
20181016,"PAYMENT RECEIVED",1271994531,0,e9465b59aebbdfa12cea8a3d71b4ed8cf0bd629eeafd64ba600a23f1b5273758,51671666923
20181016,"PAYMENT RECEIVED",1263142266,0,4cf78d194deece4604db97ef7d09db1ca01480b0c4a4ac7efb7168639ce92c0b,50399672392
20181016,"PAYMENT RECEIVED",1266847799,0,4bd5ad9a6650d3738301ccc4205a2d225e4d70a2e754cbb4ee9d2cdc8a0090dc,49136530126
20181016,"PAYMENT RECEIVED",1262937389,0,05091d21dadafda4685279f2ce446b14e8f3e73c4de607b0ca26cf435885ff52,47869682327
20181016,"PAYMENT RECEIVED",1274789798,0,d2bbae60fee1f984124df432b5699ebe69bbbb86825fe87ba6e52dd8720087f9,46606744938
20181016,"PAYMENT RECEIVED",1266856856,0,2cfac3c406a0729b5ce89910a68505bc641d6c6f2d95edc5a2da7c1d4493469b,45331955140
20181016,"PAYMENT RECEIVED",1253515351,0,054a437e5951c3607a982d4be6ccad9341558c915f2746fad669cc59807538a0,44065098284
20181016,"PAYMENT RECEIVED",1264891119,0,61b7a8391f86de41d94025f0cb620fe87f3594c0671d0adcbda20e036355cf3d,42811582933
20181016,"PAYMENT RECEIVED",1251802903,0,c514393cb44b40ee6fc08c126b0d9b036e59e4b455a598d40e77de1eb3ceaad1,41546691814
20181016,"PAYMENT RECEIVED",1254969043,0,643bf9980521f79388b3024760b39046b28beb7df439afef79cef3697b2fbe74,40294888911
20181016,"PAYMENT RECEIVED",1261693247,0,db4ba5f6fda18c5e80cdb9e22c5bad2b5f1ee532a4c4a27fa7f0ccb10ba1b8d9,39039919868
20181016,"PAYMENT RECEIVED",1257559747,0,2e346ff0bbdeee9a8f513f19cf612f20d2c77c3e83726762513abb75ba110e1b,37778226621
20181016,"PAYMENT RECEIVED",1251969983,0,9fe71fac1547994058839cacdbb0f57ced17e9b0b74bb5a2693844a99560f105,36520666874
20181016,"PAYMENT RECEIVED",1261232948,0,5374bdbabb22ac760705c1a3fc4ad5eb4500bdc44fd451635fdf51a7e8c9e523,35268696891
20181015,"PAYMENT RECEIVED",1274229508,0,1e20bf69e82aa2ec955ad89fb07cab010540ca695766e346bb4239e8b0da9588,34007463943
20181015,"PAYMENT RECEIVED",1268252027,0,ad4d7cd2f80cdd46865d54b752a6d2a3f7c4785276438c57a4a0399d0a1c7d20,32733234435
20181015,"PAYMENT RECEIVED",1250659450,0,7220df5201865c488bdfd6d158fabbef76bf2b3556e23c7f95937fb816e90c9b,31464982408
20181015,"PAYMENT RECEIVED",1254246978,0,7ba9fca0186b1be8e4324a6a4dea1edda886c0d9102011a7affd8186d676e1fc,30214322958
20181015,"PAYMENT RECEIVED",1250559351,0,3f1168c3c0727d34b1e9522bbd52c92edfa43cff752c6100d6c4f3aaf8146060,28960075980
20181015,"PAYMENT RECEIVED",1257095635,0,179c0a5ebb5d72944520d2bc23bad2f8e15877e4ac58dab3b78c6adbf3d8c6f0,27709516629
20181015,"PAYMENT RECEIVED",1271406478,0,9c11f19e1ea8dcc4da4862767756d0e971a3b49230d1ba96bbdec79af3c92626,26452420994
20181015,"PAYMENT RECEIVED",1270511834,0,0c3bdd537ed348af7b9b9919074d0036b1f5721ea7a84f791fccbdedced37d4a,25181014516
20181015,"PAYMENT RECEIVED",1256826839,0,099c7f7984bfa4d402357f937e4a6f5f5331709dab2e885086d72de9c70b5a84,23910502682
20181015,"PAYMENT RECEIVED",1254841241,0,2ddf5f4665febd175470ee2fd13275ba65ac50709951444be465bbf2d4625696,22653675843
20181015,"PAYMENT RECEIVED",1250369361,0,6fd2cf6d2546c7d4c43bb1642e190d3db42ae6596e22b68c4ea287c530bb30d5,21398834602
20181015,"PAYMENT SENT",0,-27662262265,39e63c2cf0fd028036c4c120dd4dcfbb5699d284961337e1b3e07b4584f9ba76,20148465241
20181015,"PAYMENT RECEIVED",1252920975,0,f54fe3fdb9dd616089caa4ec4e8e699396f3c18543c74c4cd5e64ebde1ca6dd3,47810727506
20181015,"PAYMENT RECEIVED",1255438648,0,7821a47deadcab188191b394b84d5598bcc15a0c627353698962203475157e0c,46557806531
20181015,"PAYMENT RECEIVED",1250046118,0,e8d49db94ed038201a34762c890ed9f77d18d7036c52ce9178d10aa45b37134e,45302367883
20181015,"PAYMENT RECEIVED",1251579721,0,46765d033f0463ef5d7f1b62bbfdd68ddd39db28d1254a57187077514eff29ae,44052321765
20181015,"PAYMENT RECEIVED",1254300323,0,94c910834b851d572afac098ef5119dedae82b529dfca6f6ec7e3270ddbdc7dd,42800742044
20181014,"PAYMENT RECEIVED",1258345297,0,42dc00b3addde829d4b437a7999e0320df1e5b29a8d5e72c4dbaed58dbbbe9b5,41546441721
20181014,"PAYMENT RECEIVED",1285371488,0,d262cb80510e1fb0f5e1726ea4bc4647490bfbc747ac2ee673a6a9fff7f86bea,40288096424
20181014,"PAYMENT RECEIVED",1252924277,0,42e09ef5cc7b9b21586f2d6c8f19de2f75d317263cf0e055e20d11c9127ad1b8,39002724936
20181014,"PAYMENT RECEIVED",1252671365,0,fcdc43b4ef9feed7e1002a2e29ba3a9f32967c891c0542fa53934fc795a3869f,37749800659
20181014,"PAYMENT RECEIVED",1268448752,0,581c169d52ea580b5d2e4070dd14c9756bab141e6962cb0bc14f9cc0c1c49752,36497129294
20181014,"PAYMENT RECEIVED",1273579741,0,b285534631fea2d74271e72d322dd69b097601792f335e4a0a66c8bbd5765d67,35228680542
20181014,"PAYMENT RECEIVED",1250852098,0,62785f6b33612c51aaad93559e6fa84e05de377afa0d9e27c609eb260234c5bb,33955100801
20181014,"PAYMENT RECEIVED",1257068451,0,b1c3007160c106d997334eb886aa7cad439d92ae1c44614b6ef31653b4c7da7c,32704248703
20181014,"PAYMENT RECEIVED",1262707397,0,c417646ec1479e58d380d474c42a0a8b904ebf342e5b2151a7530e6407693390,31447180252
20181014,"PAYMENT RECEIVED",1254485845,0,0e224913156eb7d1f42329e46c6b582775eb33cce1b70b63151b72edd862a6ce,30184472855
20181014,"PAYMENT RECEIVED",1254140208,0,3efec8b867372c6d1733218a74047549391b50dca0b5a5f8287029c52a4874d9,28929987010
20181014,"PAYMENT RECEIVED",1267922876,0,0a884abeff6ba200c9b522c871b0e90d7c6cc6bc23706a56c4327836132de21b,27675846802
20181014,"PAYMENT RECEIVED",1254660364,0,c2932be10aff611c6eb41777bf4883d66cc85513a988abd70b059987122c3e2b,26407923926
20181014,"PAYMENT RECEIVED",1258083648,0,8c4dd5a9d8668a8fe6c5c434653a128a8eaefaa1104da3f94e5e1d2315539ac2,25153263562
20181014,"PAYMENT RECEIVED",1257585434,0,70caaa42e9a09ed3ae9c6922341ce3c71aeb957221c5982431f85323b265e0f2,23895179914
20181014,"PAYMENT SENT",0,-40350682753,76d4ebdfc7517f8aa8f117b6e40839331e549635f7004b6e0c946bc3efab4396,22637594480
20181013,"PAYMENT RECEIVED",1251999699,0,1c13174400bc197aacf4e55945cb2927187044dc7e347d6d129c63aeca9e1c28,62988277233
20181013,"PAYMENT RECEIVED",1256971790,0,407cedab106756aa790c5b2bb859b50d177f6b3a55768ac3eecb7b1356250cb2,61736277534
20181013,"PAYMENT RECEIVED",1273946377,0,18b13e8a64999e9681a414fc480187e118d999581a6071c65bdb9b690d94bd99,60479305744
20181013,"PAYMENT RECEIVED",1264824278,0,254ca77f2c24575d14e6f66ebcde3064d1c79c80ae92acc101e40e0ea61b4269,59205359367
20181013,"PAYMENT RECEIVED",1260857998,0,692aaed0c764713a48cd6d79d403f86d40095bbf595fd66f776b220686091f24,57940535089
20181013,"PAYMENT RECEIVED",1253876868,0,66109f27614bd93ba86a3a382306888d1d958d7d0ab8c0168d0fc8c7fa53cd8a,56679677091
20181013,"PAYMENT RECEIVED",1260862903,0,10206edcb9aaaf67da401c8eb12c3e40f71aabe6cd4ed4e911bc58f5e347bdf8,55425800223
20181013,"PAYMENT RECEIVED",1264418148,0,8d69ea7fb4deaa11a934ef08e41c2ff0dc664492d22d8d521a57da6cf9d5f5ab,54164937320
20181013,"PAYMENT RECEIVED",1254084133,0,9171b5e5e620c4ce517adca84549bfa66c5a7f73e3c7cced1430ca9f6f5c5de0,52900519172
20181013,"PAYMENT RECEIVED",1250353749,0,b49cefe24abf4d6934d6841f187aadcd8d8480ed5bba17e8433f5eacdff61d3f,51646435039
20181013,"PAYMENT RECEIVED",1250324417,0,a5f4bbb61b217dd8295fe3772ecd32f5f35216965e9ecedf1ff38b2cb2f05952,50396081290
20181013,"PAYMENT RECEIVED",1254306129,0,4846fb83b366a66d57196dcf9089a3f60d14af0dd111565ecaecdd4b8647b580,49145756873
20181013,"PAYMENT RECEIVED",1256997490,0,37aea25a905305c64116956a5e3176b123e5cb267b7cc19e95a85bb0f0b10eea,47891450744
20181013,"PAYMENT RECEIVED",1255874634,0,2ac407da0f24c526e8120fd8abec36358e5cb4cbbdc4cbb203b5d99c6972b218,46634453254
20181013,"PAYMENT RECEIVED",1253705489,0,bc802b20802193f20e54de30d17ac0646917e7962d13eb7d3771485e77a0ff48,45378578620
20181013,"PAYMENT RECEIVED",1261423228,0,cc6e9994bf1022f0194de5633bd81847d69ec03bc4c30f1f8fc4c0e18964b474,44124873131
20181013,"PAYMENT RECEIVED",1251307356,0,777e5324bc8e9e1d70484f12ec64bf80d317818991bdd868857df3e47bf2548a,42863449903
20181013,"PAYMENT RECEIVED",1275692840,0,23c92a91cda026327792c8e525fced6c341c55b4a84f9e65176a43eb6a8989ea,41612142547
20181013,"PAYMENT RECEIVED",1253299512,0,407683749a7c6121de43c699bd06415583599e576f3718f964336c4dc933a0bf,40336449707
20181012,"PAYMENT RECEIVED",1265362273,0,83b477fc742ccc19e419cc210357e0da8abace321847c395807937026ad72479,39083150195
20181012,"PAYMENT RECEIVED",1262778171,0,9a199e489df4cb29fefc29be69e893eccea1fdc2f97a068021b7c1c88c9a1e7c,37817787922
20181012,"PAYMENT RECEIVED",1275034721,0,dfb698a9d62d8139eb9d599923bd7b263cf5a9da5cc9f25dbe5a9e657c76bf38,36555009751
20181012,"PAYMENT RECEIVED",1272737227,0,0711d7d32703cc2efaec074c4db7732349427fe7de1661c82a8a3f94bd4714d4,35279975030
20181012,"PAYMENT RECEIVED",1254522887,0,6008ec0c06abf5f51925ea2125d4ea6d8460bf96dc7cca174fbd30dd2bd43e36,34007237803
20181012,"PAYMENT RECEIVED",1260095674,0,bc93d36ad74fd6d62d1d6aa4e1e7bc3c4216ae6a549d24bc59b05b3ae6e5342c,32752714916
20181012,"PAYMENT RECEIVED",1261202485,0,0c01070dbf68a1924c8f1fbfd612519590b7c5f195ec0a904fd232c67c800929,31492619242
20181012,"PAYMENT RECEIVED",1266488688,0,c63731dd4fcb699cf1ec0562c3ed66bf0d5b09d8d9ca4295d027e992621b5c26,30231416757
20181012,"PAYMENT RECEIVED",1262772713,0,f05d98f2ed9a04e8a7cae3da5e4dccb9dd3ce46ad1dbe22ad1b7ee85f438e133,28964928069
20181012,"PAYMENT RECEIVED",1291862354,0,61c76bd758875d6d7aa2f7c040c60a955566bcb1d629d4a9feb308a9b6e49b2b,27702155356
20181012,"PAYMENT RECEIVED",1260458737,0,b3d762f2d2e390c6aa182309832b9c6baf22262f4fab6fc8448c28846d2f6083,26410293002
20181012,"PAYMENT RECEIVED",1255825778,0,942c071bf14971704e385d2d76aa7f9ea4d8b982806eb9e6b65e7e7c654801ce,25149834265
20181012,"PAYMENT RECEIVED",1254973687,0,4f5804ab2b7255aa00950cf77a108d13eecc757b159f0be117e70eb6cceaa238,23894008487
20181012,"PAYMENT RECEIVED",1251372100,0,51502b5095a9e9b1fd30408691168b893703033bcff7e319a80be65852095407,22639034800
20181012,"PAYMENT RECEIVED",1255228342,0,863247bc87fc0e09a4e5d1ee845bd7f5c1b917fd3fdd6d55cf394da0abb0ab2a,21387662700
20181012,"PAYMENT RECEIVED",1261808614,0,1baed2759c3414ed452067c0d76e8379a581850f59bd3ebb84119015ee7b2594,20132434358
20181012,"PAYMENT RECEIVED",1250201346,0,4a1349e57d940e7c3fe0360024b697f8ece3941de4368c7fc0b60ade6d562d56,18870625744
20181012,"PAYMENT SENT",0,-49063266322,38347ff70a6f7e358aba9f466d4c2bfa7aa415489421522607690eb8047a7e46,17620424398
20181011,"PAYMENT RECEIVED",1257296555,0,bf30c500acf4933b530784ccf429a5714016c5b9ad75d8aa2d67acdfdff22378,66683690720
20181011,"PAYMENT RECEIVED",1261209771,0,7e90bac717fa311af2f011a160626677718450c618efb4487110d30600a6f04d,65426394165
20181011,"PAYMENT RECEIVED",1254134472,0,e9b39cce122d3fbc5cf4fc10ab27e7be8176134c8cd9360e80f5b22c4e3a0454,64165184394
20181011,"PAYMENT RECEIVED",1253209081,0,fc03a649806c27adf85b07cf7e34b58a9445d0dc19606a676912c06b46790f17,62911049922
20181011,"PAYMENT RECEIVED",1252080226,0,2931962d6cca5d2069644d98ff6eef8e810721b09d4e96e0d753b266e090cda5,61657840841
20181011,"PAYMENT RECEIVED",1250024907,0,a4ec76e05b4b5ca842e9e66d197aaefbd96210da69d03fe507cbc9f7eafecde2,60405760615
20181011,"PAYMENT RECEIVED",1252035480,0,db40d375942f547cbb5ecb87e7515674df8bd0413cfc03595543186841d2e1da,59155735708
20181011,"PAYMENT RECEIVED",1266047805,0,60ccdbf69da1215bc046febf89c12ba476ab8fbc4f202a0923739edfe89212ba,57903700228
20181011,"PAYMENT RECEIVED",1250142968,0,0c6b4be1c9ac51eb176e980e424c9b6ef51511dac790d7a557523c99ace6d983,56637652423
20181011,"PAYMENT RECEIVED",1254556466,0,c2abf1f9ca71c1a4d46a7ad18b03132c23e4ba0541d1478b399367ec76e6f879,55387509455
20181011,"PAYMENT RECEIVED",1266976697,0,07a122846c7767abf8fbcdae651a5454a0ebe8d4cf9b7d69bd9e1829668ce1ba,54132952989
20181011,"PAYMENT RECEIVED",1300128731,0,b903ca9a8b01df9a8a9ff2ab6c17ad0c14ea4bb99cfb11df9909f46d7ffaa14b,52865976292
20181011,"PAYMENT RECEIVED",1250000000,0,fa5e7a58b0e6f1032d969be4fe44f005c2b7f7466c63dd28adecfe1bdfa1a881,51565847561
20181011,"PAYMENT RECEIVED",1258389070,0,3ea041aca3ac4c1a82528a0fa20ad37bdbcb9b2d57884f2ae83ee2a59c88035a,50315847561
20181011,"PAYMENT RECEIVED",1250013384,0,5c2c6da1ccfd5b9ff92bfdf2128a82e161f77f10ccb88952ad5bd28f200b4aa6,49057458491
20181011,"PAYMENT RECEIVED",1251451091,0,696809485c17650ac91fddcfccf0389fd592d8455625ff62c98b4d2c9b68a93c,47807445107
20181011,"PAYMENT RECEIVED",1255143443,0,af999a2e5b7800fdf5dc986bb7e76e5ffbd22d8fb016427df0a959977952b0dd,46555994016
20181011,"PAYMENT RECEIVED",1250005788,0,d1c0de952e7687b9b079cfc5995992f512889621c1e091bb97bba352af6d5516,45300850573
20181011,"PAYMENT RECEIVED",1256235652,0,8213d3054ef3fb1f3cad5870a5d9c0f6abb601a2831ab5b5508a9c9a6c1dccf6,44050844785
20181011,"PAYMENT RECEIVED",1264235536,0,b3e46e73348a7dcf9fef896efad114f086a47dc7880c8bc4a304a1a23bf22636,42794609133
20181011,"PAYMENT RECEIVED",1262512687,0,5297503076ce6188cf2cb5ae46e9bf6d7b69e45059b24f8c3d5704b0011c0a7a,41530373597
20181011,"PAYMENT RECEIVED",1269305948,0,784bb2e8236399affd3384bf361aa86115aa358feed0c436cad636e7deef843e,40267860910
20181011,"PAYMENT RECEIVED",1260431730,0,9a2349897f030d04ba0a7d6d84c6ae7c42036764ac62550fa2272ec391877151,38998554962
20181010,"PAYMENT RECEIVED",1250595810,0,bbe2a432e5d94368c94f4b2fef0d76ef8fbcb4191b13988b6b683a5157aac67f,37738123232
20181010,"PAYMENT RECEIVED",1261797337,0,d77a062dd60db3fae13795746584be9c94a7193e883f0e816d280270490e8616,36487527422
20181010,"PAYMENT RECEIVED",1263002649,0,b9c215523f52441302f7dd8c2352e1d54001c2c1e7d34c0f604d777a952a19ee,35225730085
20181010,"PAYMENT RECEIVED",1252111698,0,230606b1dbb48dcb71591e4a59d073918f8b8e01f525df943fe0bec3613ed6d8,33962727436
20181010,"PAYMENT RECEIVED",1262456263,0,923983c0f653b355d7f6fd3a18449cf3fe41a84fb07162ddac94227e9bfaf3bc,32710615738
20181010,"PAYMENT RECEIVED",1252581239,0,7e496eb6e514b0364a9ae06276f06bc5d069f1d2ac679593f5c8338c9967b2b2,31448159475
20181010,"PAYMENT RECEIVED",1262974543,0,869f0d7df0fde4ab72274042660723b7f90f408c5a87a19194f122a3682941f0,30195578236
20181010,"PAYMENT RECEIVED",1255558633,0,029a87b56dbd72472720ff7d21313f4049ec32708082230e4eb7fb885e9453cc,28932603693
20181010,"PAYMENT RECEIVED",1259168467,0,7bf10b397e78570795b3c51ff378efa24ee437b0954813e10017b281f2236eed,27677045060
20181010,"PAYMENT RECEIVED",1259277199,0,f342702c641ed21b8bab0314dd438385e2a8f14b44b7bfdd4b16725c80dfe318,26417876593
20181010,"PAYMENT RECEIVED",1250173808,0,28177111e1164184b5626e64ccb70f2d4497d3696a9bf2acb1e22177cfeac589,25158599394
20181010,"PAYMENT RECEIVED",1257099285,0,4d0dc541725f83cf93f4c4f185cc02ca0304a503ea434e37fa869427fe5e0780,23908425586
20181010,"PAYMENT SENT",0,-28910012839,9c9bb2e0631334406ee68c5ea61bb36099d2da39eeb728e450bc13efef633eb1,22651326301
20181010,"PAYMENT RECEIVED",1250168544,0,a47ed5748199c9c72d6c3c527b06e8386ff6b4cc9a266fad83b1b9395943152f,51561339140
20181010,"PAYMENT RECEIVED",1263684339,0,5056edeeb92b9e60be2166f08dbbf85608740ec990243db6bdf713089357148e,50311170596
20181010,"PAYMENT RECEIVED",1255016368,0,dfe2dfe4538261e6ef23440577aa71d878bc93cfc9d8d0be638f4eaf6f72917d,49047486257
20181010,"PAYMENT RECEIVED",1252189050,0,85092f5528a16d5af67c239fa04dc779adb2272c4d396f0bbbe14750dd3ed82f,47792469889
20181009,"PAYMENT RECEIVED",1253694614,0,3397b1191b8daa171125bde5fb08c92cb109edf0d1c54b6acf19af5e7879207c,46540280839
20181009,"PAYMENT RECEIVED",1250021666,0,267e58bdf740f63a6b5d443001842a0c8bb4d159b0461fe7c2b548dcc1677b05,45286586225
20181009,"PAYMENT RECEIVED",1263616127,0,69271889d353c2a2ba3512f96d8231e14efd83c156c584c11605eff31d3c10bd,44036564559
20181009,"PAYMENT RECEIVED",1261952596,0,697f9d1578e5af9878bfee1db3b83ad3f9aab451bd84fecd5e2604143a4c8902,42772948432
20181009,"PAYMENT RECEIVED",1253040485,0,8a45777d98aa8790fdeac1b311ef11028deb7f965ae8ad7460ccdd714592874c,41510995836
20181009,"PAYMENT RECEIVED",1261978006,0,ec2994b2510858e47aaf28b0e43a06288436922505b4c3214109d63bf51f042f,40257955351
20181009,"PAYMENT RECEIVED",1273919223,0,21028d9855c693e177c35adc196249ef46714c93502cc1dc0442a8768d2941be,38995977345
20181009,"PAYMENT RECEIVED",1254862863,0,f6772c016fc58c8070a9d5cfb8a69a2860fb5c03f96c61b237ba893e364ffd80,37722058122
20181009,"PAYMENT RECEIVED",1253072099,0,d5c6b3097992bc0762527e73f9abf5e4ad9d0114d9357db57aa2d72066c976f0,36467195259
20181009,"PAYMENT RECEIVED",1258284082,0,4797dc64665fe07e51b378f533c2e577ce4a1049aeb41b9bbc2721b8a8177956,35214123160
20181009,"PAYMENT RECEIVED",1269563289,0,3e516095208aa28e3d93e57084e8dbdc983387f84fb51244e46e26bc61e262c4,33955839078
20181009,"PAYMENT RECEIVED",1263364026,0,b81e782397acaf88b28a7ac20cfacea6699598c20c1cab9365a329df0bef1005,32686275789
20181009,"PAYMENT RECEIVED",1258958055,0,2674607c75c52ab9d54e5329fcabaa5af838326df4d12bf20acba8fcd4b92ad8,31422911763
20181009,"PAYMENT RECEIVED",1252759432,0,eb28d267379861fd4eb19a16643c7e5be67514933709911f3d9dabbaa6ccb24c,30163953708
20181009,"PAYMENT SENT",0,-59180436736,4ecde852721e71559b9f0bc4b9477099eb944ffc5ccfa719e91500f65f16f0ca,28911194276
20181008,"PAYMENT RECEIVED",1250067926,0,167633a8abc57e0c72f7b3ce0f8a1b4ee817c4fe03e6b174b0465aa4cee8534c,88091631012
20181008,"PAYMENT RECEIVED",1260845987,0,1790c0dcff5cebf3f54004857b47a7030ca2ad5e71da044bfdfd39e49278444a,86841563086
20181008,"PAYMENT RECEIVED",1258910197,0,0df04bdf3423bf54d2b2c0763f300f31b382ebae36ca2e163daf6815385fbf53,85580717099
20181008,"PAYMENT RECEIVED",1253392768,0,6f2f41ae5bef2e8c563ae5bed531a7708ba1a9aca361295d1513506191f48f2e,84321806902
20181008,"PAYMENT RECEIVED",1256524168,0,ed1e9402ee5ed89898e662fd5945b99f3e1a5120d00b8581b943cd087709ed0a,83068414134
20181008,"PAYMENT RECEIVED",1263648102,0,000771adceb846d02b0229c2326d66348185bacbe97b7a1de5cb86baf8f88ce2,81811889966
20181008,"PAYMENT RECEIVED",1259075450,0,82d31ababc65cfe0aad05a75df65e04cc126fce071b59add301a3ee596871e94,80548241864
20181008,"PAYMENT RECEIVED",1275591860,0,b226decf29fa246d8f9637287ede0e582bd15900d5b3357d8aca203baea90146,79289166414
20181008,"PAYMENT RECEIVED",1261004460,0,76432f41f2f03c9613b1fb4382ff2d4e6586a8d1e34f626b2bff78e9f79388d4,78013574554
20181008,"PAYMENT RECEIVED",1268575179,0,f57bed6fa12ca852ffd6fed9052c2b9bdeb4ea2d917fea1602c9b136692d9619,76752570094
20181008,"PAYMENT RECEIVED",1295721567,0,b11299c2295837fc5919830c39ea60ffbfa7ffcd37e3be025760d4c207b72e48,75483994915
20181008,"PAYMENT RECEIVED",1250014936,0,882484bc9cf6c69a01eaa184928621810651fdb780cddc65db0d23eb9766382f,74188273348
20181008,"PAYMENT RECEIVED",1252923290,0,1bccbf80fdb9836865b77b1dae4f86abd89ff470233fb7af4f846ea8e8dcc917,72938258412
20181008,"PAYMENT RECEIVED",1256253621,0,13fffb86555c5f25bdffd86486f45c8f899071eac4267c0e434903d093658b40,71685335122
20181008,"PAYMENT RECEIVED",1251446222,0,77e90d943ea8abcad10eb9244f65848d1b4ab3c8c3a039f511f29b0e719d4b6e,70429081501
20181008,"PAYMENT RECEIVED",1259282861,0,09117163761a15be328f0fb3411bc4d0eeb16ecdc99ad777f2d6b80049b26a56,69177635279
20181008,"PAYMENT RECEIVED",1261983527,0,9a47b60731ea4386a4833ce43597f3c8d4edb63cb0f87425ad323751f6ca8b81,67918352418
20181008,"PAYMENT RECEIVED",1259041233,0,5858693e4af09221ee3dac8b5728e320f6f68801458f162c20b2edd32cfdfb4d,66656368891
20181008,"PAYMENT RECEIVED",1266938976,0,f59d572732bb7ba4848a264f1deef2e632663f39be78088431330ebf318a73a0,65397327658
20181008,"PAYMENT RECEIVED",1253821010,0,71db2b5cff2819e8330a68fc7aac414b7b5e06685ebca52b0d45a92b5edaea4c,64130388682
20181008,"PAYMENT RECEIVED",1262551030,0,4bfbfbc4aa3123badac84b6a715c61f099d0ed7369dcca8393e7708974f64957,62876567672
20181007,"PAYMENT RECEIVED",1254127450,0,200c065f4bca513c48c5d6b8f62e7b5f572523221f01c4fc477f85eb19b6a4c2,61614016642
20181007,"PAYMENT RECEIVED",1259223578,0,e9137c77515520cc18a99741d42cb707d5929d489207c5eb5b6e166fecaef95f,60359889192
20181007,"PAYMENT RECEIVED",1262298393,0,f751ee079325d5df10c55187d674785b8712b16bbd5ce78f606b59155370575f,59100665614
20181007,"PAYMENT RECEIVED",1261946856,0,ad8b7b583c36b11909be93fa66d2fa4e9d2b81925828b9f9a459e43bdcb8c4db,57838367221
20181007,"PAYMENT RECEIVED",1263249683,0,767c3ec4632dd29229599503c0483c1777df64f9ee1d0d98da998c541ed82169,56576420365
20181007,"PAYMENT RECEIVED",1263631439,0,7032dac00a38420a558ac14b163d6615273461efa918640db980e39351e73d28,55313170682
20181007,"PAYMENT RECEIVED",1255239456,0,247ae3eac6033e844adab89e096f6d4b6605a9562a050042c0d9f4a5bfd17bc7,54049539243
20181007,"PAYMENT RECEIVED",1251011502,0,7b819e52d9b4059c22c0f32227b903af0174b3ada8eb6450e1545aa104f38efe,52794299787
20181007,"PAYMENT RECEIVED",1254517683,0,27e0831003f4c96a033a43b17ab7a625e179d52c2f3a4bba0d4c55fc627dfe51,51543288285
20181007,"PAYMENT RECEIVED",1251247982,0,bd76474cf07e10927c3eecd45203e2d79bd0500a581cb704c943eb11911973ba,50288770602
20181007,"PAYMENT RECEIVED",1259188193,0,7f1aa03970c52d399a74b08b5dc35a75d83552341ca59eb2a92833866acbcfc5,49037522620
20181007,"PAYMENT RECEIVED",1257651709,0,d44366d50dfc2e2305ee0570cef5e9e46d4f067fad0ce7002aeb534ae38addb6,47778334427
20181007,"PAYMENT RECEIVED",1252616795,0,c33528286d12d0993c0f309b33c232024712aa3752b8b563d10fe856fc72bbe0,46520682718
20181007,"PAYMENT RECEIVED",1258266333,0,8b44e877bfe8774c654c46f8f015ce2bf3d5c7d9be7ef9b0435c1cbebb104790,45268065923
20181007,"PAYMENT RECEIVED",1265096565,0,d988160d2c5f81d2815b242e1d8b82d54ed0fd9969ec81e338b0c557fe62d00a,44009799590
20181007,"PAYMENT RECEIVED",1250154701,0,4a9fa00ec712bd17a96a6d7a8123273191b8d3a2ae2afe0695c3d822a51ce652,42744703025
20181007,"PAYMENT RECEIVED",1259211092,0,d6c1c224fa007865994beb6c266d3329bb28d91f4e8f22468dc994beb58435be,41494548324
20181007,"PAYMENT RECEIVED",1274539542,0,ca6ae7b1b6240068a44043daad4e815a0756a2d974f6511ddf75a7a7da9dbbdd,40235337232
20181007,"PAYMENT RECEIVED",1252229215,0,c104bb8e9d839a1850ba1fa6e9bc5c79d58262291440fc5828a07cfb6c12428d,38960797690
20181007,"PAYMENT RECEIVED",1250038475,0,56bf02e56a009ce2761b280f01258996fdd212ae8895719d6d4160307ebc1cb2,37708568475
20181007,"PAYMENT RECEIVED",1251759305,0,f07e5a3528de43429ba6d2c2578fab0e875a718606ee6febae6b36fe46009e83,36458530000
20181007,"PAYMENT RECEIVED",1251025128,0,d460d93123331191231ff93fc8f2c01915a9bb8a34be95d2f72d8b2919f81de9,35206770695
20181007,"PAYMENT RECEIVED",1260792112,0,0365ac714c0bc79949d8a2f030ed4a247ec7cbd6608e48fddcb14008dd1e05df,33955745567
20181006,"PAYMENT RECEIVED",1257576148,0,bd4544c154d194bca1d0303b2c5bc3852d55c6244baebdf022264662d5fa9129,32694953455
20181006,"PAYMENT RECEIVED",1252749988,0,d5812962db7e010bb2a53471f7d5dfb87e61eac65ec9ddebf8a8bf0624b7cb23,31437377307
20181006,"PAYMENT RECEIVED",1252452885,0,a707cf94a1e013df54f195ca95e6a850c505c3e94fca7d8974895ed984961be1,30184627319
20181006,"PAYMENT RECEIVED",1270510973,0,7a4c8d761d5cddeba7ea74720bb1b224eff129be7735c10682bd6e32f0ef3e7d,28932174434
20181006,"PAYMENT RECEIVED",1266429433,0,d89bb56e1ac3645e773776f1b0717ff3dd4bb5bd4b483a0d82b7057ae7f247d1,27661663461
20181006,"PAYMENT RECEIVED",1261048755,0,38110d5a4a15c1b447e93d57a4618eda6a91b953d93eae88247de6aab7301895,26395234028
20181006,"PAYMENT RECEIVED",1250163683,0,02a9b75e9c151dbc577deb9fc1beb3922a51e770ac0ff58ee695a733d5f28677,25134185273
20181006,"PAYMENT RECEIVED",1254681580,0,494f22d53a1b1aef0553a0d83ff0e95a62661706f9c01477c10ae3825dad86f1,23884021590
20181006,"PAYMENT RECEIVED",1287087039,0,56023b6cfbdb50523e4e65385940576da786a275cdab1a56707477b9e4debe88,22629340010
20181006,"PAYMENT SENT",0,-20105327293,3d6a9b8e42fb79bfedabc1929963b0d8506a24aad5fad137d78939edb8e050df,21342252971
20181006,"PAYMENT RECEIVED",1255212845,0,7cdeb7ad8373315c8c83be43fdb9d01d1cdbfd1f0ade9703b0c068c37a0e9312,41447580264
20181006,"PAYMENT RECEIVED",1250002650,0,75eb4ddea3ea2731c103ef22110586e78ef70471ccbcb681ac053ac98e0567d6,40192367419
20181006,"PAYMENT RECEIVED",1250280378,0,4ebe3c4263b1e6f5e7e1ee886a27abca2adeddb87c5e9ed1c0da307710fca320,38942364769
20181006,"PAYMENT RECEIVED",1275075126,0,5f6187988bc4a10e8eb0fe0512e2e941c7dfd1d1a42c2bbab33ae1ae9cd25cc7,37692084391
20181005,"PAYMENT RECEIVED",1250000000,0,8cddcfc5a449ee700011c21db267078128a30f4a4190839e360fd6be557ba081,36417009265
20181005,"PAYMENT RECEIVED",1250000000,0,8f12302806ea1112768721dd732033dbb1dab945c276e251e3718b5b43dfb1db,35167009265
20181005,"PAYMENT RECEIVED",1263023245,0,5f31b67b61f80377167a17bbe0ba06dbcfec58c944848a3c022f1a8c90ae9068,33917009265
20181005,"PAYMENT RECEIVED",1250000000,0,6614958860d5a4cf2333864c270d6512536a262751ff928671a52c2dbec80e63,32653986020
20181005,"PAYMENT RECEIVED",1250000000,0,bfbb7152a49648e0cf9b3a1da344116516ea35e5a36ac635821ab4a5420ea2b5,31403986020
20181005,"PAYMENT RECEIVED",1250000000,0,6b62d4a224b63fc76ec76502b2dc3dcf5b04ce86551d8ae1a3b0971fab99e676,30153986020
20181005,"PAYMENT RECEIVED",1250000000,0,e032fe62bf1f06850196f7404eec321d4ef2a3873f4c88487f08eea25f95ace0,28903986020
20181005,"PAYMENT RECEIVED",1250000000,0,b179f402074a2f56cb979c6c51e45dba961acd07c16d94382ed2a01313c9a9e5,27653986020
20181005,"PAYMENT RECEIVED",1255058037,0,cd1b69ba5dc2ca08f2e8f75f7627c218d5b601d9a2059ccbc34c9c18ae431e3d,26403986020
20181005,"PAYMENT RECEIVED",1250000000,0,9a667ab621899110938a32abbca1ee486e92ac46d106e681ec55c37a37f184df,25148927983
20181005,"PAYMENT RECEIVED",1250000000,0,19bf7c3340196212cd91cd69d9390480c1d8e1df84abb5d32591f27abb87709b,23898927983
20181005,"PAYMENT RECEIVED",1260227142,0,5ff93d0bb75e1e4641e8fe8e3afd4ad804dc7f6fd284b830f68743a993bf21a5,22648927983
20181005,"PAYMENT RECEIVED",1251146270,0,98e8d2f1a362814fd00789862c5ac29a163aeda79d858d964422a7e5cb0cd943,21388700841
20181005,"PAYMENT SENT",0,-49147425801,5fcab6d80016ec16dff158cb3cbb7b58561bb2305754def3a5c35bb27d33d2a5,20137554571
20181005,"PAYMENT RECEIVED",1253613645,0,9d7c39f11b427a6eb74a8493d63790ae77760d5338e38b9717d2b1f3985ad8bf,69284980372
20181005,"PAYMENT RECEIVED",1279830099,0,61fa2e38cbc39cba6f0d7d6cd3cfac5726bfbc074dbce95eea397d098d59a26f,68031366727
20181004,"PAYMENT RECEIVED",1250002153,0,641137088f069a9c82f1ca64a508fadc2e5187c6cc21a2f46eaf1ed4ec350dd8,66751536628
20181004,"PAYMENT RECEIVED",1255902348,0,90cfb9cc5f740bacb92ad5b7de23e019b0e6104668d6332822b25b678bed5b2f,65501534475
20181004,"PAYMENT RECEIVED",1272038376,0,43bf880286f6aef486e4da2387890444aaba9a26c3e4786525edf6951f924fd2,64245632127
20181004,"PAYMENT RECEIVED",1250010783,0,48bfafaeb0261ce406565793731cfa4a17d28288557bd9a1cfee2e755c801752,62973593751
20181004,"PAYMENT RECEIVED",1250000000,0,1a45f79afde66af3c196d6e63ee0ac261117a946b24792a1c0522d72c91be326,61723582968
20181004,"PAYMENT RECEIVED",1250000000,0,84eb1386cb1eb4a461128a912b9e0e9190338cc3100e5065bd8ac67702a844cd,60473582968
20181004,"PAYMENT RECEIVED",1250000000,0,a53e366a3d10af49c9c53563785d669ed1bf414511d773270dc7f7a192a12a43,59223582968
20181004,"PAYMENT RECEIVED",1277449527,0,aa316f2265c04a20be1dbbbacef5f41b32ddbb31cbcb9c6bb3c0ade5086d6375,57973582968
20181004,"PAYMENT RECEIVED",1250000000,0,b6fd32f528ba0f03c9de9ad30e2d1fe09f0175e74888a7d0ec4044fab1c8b900,56696133441
20181004,"PAYMENT RECEIVED",1262700439,0,ba1007d09f60aad7b759c2151e0d3708e5754b3b9167c6adae8ddc3b35941d71,55446133441
20181004,"PAYMENT RECEIVED",1268323594,0,2689365d1ba69201269bd88af90648cc014bdeb892c0fcf653ead2e1f6cd9c3b,54183433002
20181004,"PAYMENT RECEIVED",1250000000,0,f4639d3d066ff222a21d0a71c65e09ba5a04ad0928cb0413886be7fccd5da7d8,52915109408
20181004,"PAYMENT RECEIVED",1250003402,0,1f350f4b0ec9c14450fd02b806de244fec12a344d513732552e6fc3549f4b5c1,51665109408
20181004,"PAYMENT RECEIVED",1267680205,0,6c284729e51f3a8f294cabd36d9de93ac47c5b37ffa94185944d71712fc5148f,50415106006
20181004,"PAYMENT RECEIVED",1250000000,0,3812d180a461c8fea51621730eb11a1c62dce457761184ac2dde1e6bc2ff23b9,49147425801
20181004,"PAYMENT RECEIVED",1256057157,0,629c348cd399f0789e3e61349180447ee337ffba5b8c22e246e4a5ad1a63feb0,47897425801
20181004,"PAYMENT RECEIVED",1250455495,0,2c38fcddee582b095d63f746d681016c712d536952bdd72a9c198b3f34a14452,46641368644
20181004,"PAYMENT RECEIVED",1264606579,0,0341edbec5db431c3bf18dc2f49f23b7320be3d40edea067377c5f907e23b4da,45390913149
20181004,"PAYMENT RECEIVED",1255657611,0,006510f5e50c839d2e870893747f496f5b9c7bd5aec411d6911423288ddad438,44126306570
20181004,"PAYMENT RECEIVED",1250000000,0,a8895b659ab76e8f894930d5374b39a8c6f98179d772af2098744230cfc4b6e5,42870648959
20181004,"PAYMENT RECEIVED",1288728717,0,24a6d3c24d8a2137bbbcd772d0e90875b8e0aeae3a888057bd044f35ce6c3cdf,41620648959
20181004,"PAYMENT RECEIVED",1250000000,0,14ba1449eb11b0adc13af20ac073200081798274214c37852b68d753e08e036a,40331920242
20181004,"PAYMENT RECEIVED",1253438507,0,27a8f91016920a854424ed274ee37f0faffd89ef1011a58252875a3e02ce9b4a,39081920242
20181004,"PAYMENT RECEIVED",1250197764,0,e74ce546bfc756b5f2ba32f3410fa3833f871ee6becf0c68b57e0335acb55170,37828481735
20181004,"PAYMENT RECEIVED",1251470461,0,9c2915d8563ad7b2da9878be613c499d9af11233b93f65258052a3403826488a,36578283971
20181004,"PAYMENT RECEIVED",1250002580,0,5a0aa5017892ebd4408ae678067cc43226de3c54bed75556857441b11fd0e2aa,35326813510
20181004,"PAYMENT RECEIVED",1257573713,0,be8fe2d7083350dfabbed6cfb21086724f4efd8cc2e05563b9c53080d064460b,34076810930
20181003,"PAYMENT RECEIVED",1250070323,0,e3b91cd8954432d31652705d09c65787a912260a8f09420a0ede68f288553948,32819237217
20181003,"PAYMENT RECEIVED",1270924698,0,652ea2172027953bbe3fee9e63d5d5edd58c84e995d4c20aacc0707df260949d,31569166894
20181003,"PAYMENT RECEIVED",1281972567,0,05b535b3e587ba3053206a952012db7074ca0b09a37857b611f803e98919b316,30298242196
20181003,"PAYMENT RECEIVED",1251843342,0,819796c79d3e2b728cf74a7eb6916d57954f1648afec9dd2388361697ecd83a1,29016269629
20181003,"PAYMENT RECEIVED",1254886736,0,8b231227e09f198ef19fc885f3390cf57638c668f5848d49d67abba4840dea1a,27764426287
20181003,"PAYMENT RECEIVED",1267925482,0,ecd2dc4e0df1fb8f61e8378316ce4207efbcd97c87eb0221bd56577f12092255,26509539551
20181003,"PAYMENT RECEIVED",1257916035,0,e65595374a0315a6cb32c8c37d137909ab9cc7fffc706be9695b17ba140319d2,25241614069
20181003,"PAYMENT SENT",0,-29021413344,5eb8cbe492ae51e7bf49a899198a20863a7643f3c9b0a22673691c3d3f396c40,23983698034
20181003,"PAYMENT RECEIVED",1281812787,0,ffc947fe2e2fbb1e49ca04c50f49db57b66eb3772247b3f2cb3af6b3f78b524e,53005111378
20181003,"PAYMENT RECEIVED",1250000000,0,0ad0ce663b5f85b54f6787d839951cafb6af2783f3b99d1f89c758571003c8ac,51723298591
20181003,"PAYMENT RECEIVED",1272492094,0,cc342385e6a1b1f9926b0c71e6f503aeb8983dff732634933212ff6c8fcff415,50473298591
20181003,"PAYMENT RECEIVED",1261816395,0,d994b691c0796a08ad8028e547972734b533321f696d4e990fc72151342c8329,49200806497
20181003,"PAYMENT RECEIVED",1263089050,0,59203c0fc4ad5781b4ad4a0c92bec93825aec5c4aa96f3906bf40754e7cb069a,47938990102
20181003,"PAYMENT RECEIVED",1255276759,0,0acc50a18becd06c6d330c381f655b9ccc5871de4de4c7122e5fa5dcfdc0dc52,46675901052
20181003,"PAYMENT RECEIVED",1253697886,0,e79b80b742e7ca0f67507576e36b9ccb4958dbd787cf747023d51953d790da86,45420624293
20181003,"PAYMENT RECEIVED",1293940920,0,510d31c94846631c2e63710fb597b73345c4d10648d2ef8c4a5a1a068d08e5e4,44166926407
20181003,"PAYMENT RECEIVED",1258801091,0,c64879902b68be8939a68ee25de8857fdec7e6320e1e4cb402e7a6b4f967c6cd,42872985487
20181003,"PAYMENT RECEIVED",1255378400,0,c5431b4fbb6791741e92817e5c4e7488640b564bc3e8070dbbd9afa7e09cd57a,41614184396
20181003,"PAYMENT RECEIVED",1250000000,0,6b7cb9055b5bd4d4ccdfef9e37f6a696aebbb68aa3700da828e1a12cfe5a5496,40358805996
20181002,"PAYMENT RECEIVED",1272096246,0,0cb16d6faed239cd68f49ee9336b5418510b3bb120aa5abfcb15c554105fbdae,39108805996
20181002,"PAYMENT RECEIVED",1254752572,0,3ce2d04d54f26b688fdb08fcb94333dbf9e1ea43b2442c1ee3f66d0e16582646,37836709750
20181002,"PAYMENT RECEIVED",1250018261,0,f07a709ed956b71daa57f77429027a0962f9b8febb40092f75a8f20ad7a01981,36581957178
20181002,"PAYMENT RECEIVED",1251741054,0,297b31247d30cf5e390e6deb8c7906ef6cbdf09632dcc5f76c1281493c9f38f8,35331938917
20181002,"PAYMENT RECEIVED",1250000000,0,3911381634d075c440c92d2b375db9f7d635ce589b5d3cfa04d6845712e77f12,34080197863
20181002,"PAYMENT RECEIVED",1291225882,0,25e6bb47348b0a83c5d7f6620a3537cfaf7636ae5006cfc6414d1a998f28f5b6,32830197863
20181002,"PAYMENT RECEIVED",1277884897,0,2caad1866f502adc1363e930e886a20e9c7115e473a82296bb98edd5526318af,31538971981
20181002,"PAYMENT RECEIVED",1267558637,0,502b6051e2f94a1ae652a485931502c4d09e6fb743a7378c13f10957917da859,30261087084
20181002,"PAYMENT RECEIVED",1250000000,0,221c3afc08bd9ddb29896da5c0e82b2048b71c62579516451833c9289d1e90f4,28993528447
20181002,"PAYMENT RECEIVED",1269977322,0,9ca3aaccfacbba663b0b5b52542b70607109c5650957cf01e35442c624581504,27743528447
20181002,"PAYMENT RECEIVED",1281290491,0,69355a7c3e33649c76dc9c300d2283f61e32a5c079385e303887441f9caaa9b5,26473551125
20181002,"PAYMENT RECEIVED",1261328051,0,d2610d8228965dd5484752ee7d9ce992a7944b0908073a22d9d6360c480f9a0a,25192260634
20181002,"PAYMENT RECEIVED",1251355297,0,985025b5a643537ff888e325a2c464c50c76acdb7d53bf19b7ebed96324a9ef7,23930932583
20181002,"PAYMENT RECEIVED",1250000000,0,70ece894fe4717558ce6a0f477ef7f3a7041feb84715ea2a08ee294da6b1cd7d,22679577286
20181002,"PAYMENT SENT",0,-26377359859,4c04c040271e878cb55bf37e36f5bd033a634690014faba8857058c55e6d39fa,21429577286
20181002,"PAYMENT RECEIVED",1253139235,0,577ef3dcdbc3a01979a2745eedb967173a6ffadaefcf782e348c19e73c32bfc3,47806937145
20181002,"PAYMENT RECEIVED",1250000000,0,55b32c628b76ca5d0b4457748fcff3d15fde00e9f25d93a130efdc4eb27f9949,46553797910
20181002,"PAYMENT RECEIVED",1255495438,0,4a322ed7717cbee134d2814e7c363196ac6d007512facc0d7469f109eecb5113,45303797910
20181002,"PAYMENT RECEIVED",1250000000,0,0565c31ee065d182f030ff8a317fceda962c9ee6e883abb14e692e3b7c807e16,44048302472
20181002,"PAYMENT RECEIVED",1253691215,0,c56aa15f075b2f519b97ab69bdb6d9eaf035ddb33e6c39968864bdd11868b6cd,42798302472
20181002,"PAYMENT RECEIVED",1258001979,0,053a3253bcfc9d9869101d496aaae0bd21aeb6fd841b46bcee8d8afc87b69c0f,41544611257
20181001,"PAYMENT RECEIVED",1260456554,0,a7d6919ce53e70d167945910b329aa11f203b27b17788b61eac85904745f9330,40286609278
20181001,"PAYMENT RECEIVED",1273027521,0,7c77d892c2a1c1eb7d011d88546e3d61864635000412c6542d78231b353d5603,39026152724
20181001,"PAYMENT RECEIVED",1263581023,0,2881a13a35e7534aafd4b81efadebcb29f0daeafcbe40a512426b58af0dffde2,37753125203
20181001,"PAYMENT RECEIVED",1273283536,0,ef319b34c372b8cfd32fa20c1129c9201222f4e7f073cf35e8a8a1de817599ec,36489544180
20181001,"PAYMENT RECEIVED",1276696411,0,415a4f7bc44149472955ebc009530a27cbebe75b2884f2050619c80f2bb38e2d,35216260644
20181001,"PAYMENT RECEIVED",1269264786,0,0ab443e1722cbe277c59841bbf2d4b54800f0a9d5f58a8653f578663ef32ad1f,33939564233
20181001,"PAYMENT RECEIVED",1280353201,0,751039e1d8b6599f8d48c9aa49f3471742660de236ddf776155d8b76630ea5dd,32670299447
20181001,"PAYMENT RECEIVED",1251189878,0,48bf72f9a5589076e88c692c9ab7ef025db430de87966fc913268fe41f4cccf4,31389946246
20181001,"PAYMENT RECEIVED",1253000098,0,5d9e820b875216ae6a89262cb702325b8e17389a824969e75d939324d29c1961,30138756368
20181001,"PAYMENT RECEIVED",1255715159,0,5f84f223aedb87ab37c52b956e4b2a889d4acb350bab4b1af51d6a72c4917b86,28885756270
20181001,"PAYMENT RECEIVED",1259542599,0,fb9bf5f8f257cd6a668266ff94a248f0db10301fa9eee648c262d0ff57ebe8fc,27630041111
20181001,"PAYMENT RECEIVED",1257021968,0,853f4c8cab2e66e05fef0daf69e5b8e038ccb31c83f4f8bf1aee881cebfd2c31,26370498512
20181001,"PAYMENT RECEIVED",1250729402,0,be66622f4104acd8efc8a90bceeac84dcd3dd799bea1d7c7471e8dd065fbddbc,25113476544
20181001,"PAYMENT SENT",0,-57954063280,e53046a7bf1b855f0538636c6f0131cbf38ffe926cd79105f82471ebace982c1,23862747142
20181001,"PAYMENT RECEIVED",1257146086,0,cf60b6a7e54f9d70c3f172fc2c2d985faa8070b142ea812ba82ff0759e4cb09e,81816810422
20181001,"PAYMENT RECEIVED",1252150480,0,f83679c226f431282bd1c407203fec246ba05ba9e78339eb26b12c961c30e09a,80559664336
20181001,"PAYMENT RECEIVED",1259384424,0,067ff4cf87fd9420b9ef5ac0ea90aefefa50c05f1d59af8e13d637c8447f19d2,79307513856
20181001,"PAYMENT RECEIVED",1252219070,0,c8b76574b007a160a09e2f2bdc63b0b5389417d25babdbb64075d524a2ae648c,78048129432
20181001,"PAYMENT RECEIVED",1253673166,0,051893920dec2784acf4c02d2f68c42856d50b12caf9cf2033e5be65793cc501,76795910362
20181001,"PAYMENT RECEIVED",1269928627,0,88cb83160759c4bbbcea0d160f3b2044ca0caf20633d00b627acc5d4aa6dde28,75542237196
20181001,"PAYMENT RECEIVED",1250563057,0,8b24f680dd202ca4aede72f4557beee042c0aef04a48c3c7427810f0d699bab8,74272308569
20181001,"PAYMENT RECEIVED",1250001368,0,81d7652a59966fc4aa93095ecffc05df59a1c7c6a436af157484f712f1be4613,73021745512
20181001,"PAYMENT RECEIVED",1262263902,0,333849d618771a00759d713efa5369b67684b008d4f8b51f9621236316d29604,71771744144
20180930,"PAYMENT RECEIVED",1255655669,0,5ded06515a54d45ca2677092dfb9290894c664fb78500e6520caa0768bdb5402,70509480242
20180930,"PAYMENT RECEIVED",1251819051,0,55a22fd976729bf1dd0215f24d754c9e7b22d8efd341982a33b9c816aa13c961,69253824573
20180930,"PAYMENT RECEIVED",1250000000,0,f64a29acf62950dc0a71acd875f7c69229709cefd958111027b607d8a3ce7b23,68002005522
20180930,"PAYMENT RECEIVED",1252382339,0,96083ad2a1c3a3c3afc4ddb358bc8da1af8b9013125f368dda1c7534b97e9e1b,66752005522
20180930,"PAYMENT RECEIVED",1252431372,0,10b8a639e1c7ed6d42b786546abb3e7854b1658c2849f6821019143446aa27f3,65499623183
20180930,"PAYMENT RECEIVED",1275991060,0,8f8df4d4fb692e3ba55afba8164b0adf8de4114fea9d5ccc9ddb63495d4b726a,64247191811
20180930,"PAYMENT RECEIVED",1259544044,0,1d69d787d25272366796e8ce9a04151ce65547e3c2b196a35c59859834ac7246,62971200751
20180930,"PAYMENT RECEIVED",1252762475,0,45d4832b3f53c609eff6d5822101bd1754f0f2bb4051fdd9e005365fae8cf472,61711656707
20180930,"PAYMENT RECEIVED",1251578013,0,3d7a56647c5a0c2538b1de75f6f94e84a591997778e0ec549597fa663b1fb41e,60458894232
20180930,"PAYMENT RECEIVED",1253252939,0,d4ddc05b495693042094fe06949f1c5d6abbd7f59f8a447f2c7f750c8f919aac,59207316219
20180930,"PAYMENT RECEIVED",1259892532,0,6248108ba94e489f1e829792ef686034a2f1e02d4d3427149bd82c63f96f9f7e,57954063280
20180930,"PAYMENT RECEIVED",1260914681,0,8d861c62e46f45dfd50b7d0779837064c12858b2c1f0b966e4065e224bc9f018,56694170748
20180930,"PAYMENT RECEIVED",1258712023,0,7a0ff2094d7d8f6548d67b6506c4b43979b98e9d7f9f07c6241d68ddfca1cf76,55433256067
20180930,"PAYMENT RECEIVED",1251359355,0,d26d8eafa1f2093e7a9e53f478e02af9b9269b9ae2a7e2af1795554554a29e76,54174544044
20180930,"PAYMENT RECEIVED",1250728536,0,8293fd70e339eed197b9f853d27994ccbee51390898100e81c3535d284bf3f3d,52923184689
20180930,"PAYMENT RECEIVED",1250000000,0,c109b3d86e6169840c2751e15a40980d82bf0873c91a884d6fd30892e0ad483d,51672456153
20180930,"PAYMENT RECEIVED",1259057810,0,912062b757f224ffeff3a1dd18aa1b002b00ae552f5d4da504c9cc795c37657e,50422456153
20180930,"PAYMENT RECEIVED",1250378805,0,3283f3df9d44def8f05dbb7297529a2dc3953627d330a3d8a28c538014b5085e,49163398343
20180930,"PAYMENT RECEIVED",1250000000,0,56514747f104a20f59473c38b03a030039e2946290b4af6d2079a3e7be0cc7d6,47913019538
20180930,"PAYMENT RECEIVED",1253123681,0,5942b3ff093781890a14e6c8d65d865c5136788a9997a376860a0987a5994d19,46663019538
20180930,"PAYMENT RECEIVED",1255968059,0,0a3713d82f7692a61f012b01940c98b6638a43c0a0046696cff6000fb5fdcc01,45409895857
20180930,"PAYMENT RECEIVED",1250028485,0,d178d34960b23ea839f75befc32ad2a52b29dd9a69a6fe69ad074113c333acfd,44153927798
20180930,"PAYMENT RECEIVED",1251670723,0,1bd0afcccf64beb4ada9acb3ee51bb0b592ec72043602b28e46b708c09f168cf,42903899313
20180930,"PAYMENT RECEIVED",1259780222,0,b5dd33ef018989da9747e313e5be8289782e44ade1651130d19e89a38e293b6e,41652228590
20180930,"PAYMENT RECEIVED",1273137874,0,43359fcceef22e0ad55b109e58532a146241803b7025503bec44660c9e191413,40392448368
20180929,"PAYMENT RECEIVED",1253065104,0,43f451024b5141a8e31b716cc83c0f084ad60217e0d7fe9bbf3aae3db3fa4337,39119310494
20180929,"PAYMENT RECEIVED",1251808991,0,42777be4eb6b5f2bd882440ad8717dd636c73c07496365a742694cf32908645d,37866245390
20180929,"PAYMENT RECEIVED",1267964325,0,4f78a15ffab8a3f91d9ebd1cb7408e114f52a110d3b7c77a55ec22c1484d67c3,36614436399
20180929,"PAYMENT RECEIVED",1258689271,0,1945ee06b79c3f35917df37e909bd982a49b737f44443016d4a2db0f827597ab,35346472074
20180929,"PAYMENT RECEIVED",1259551174,0,0785e83fcc465fe1ae210900a6477221d5bdda4dde121eb40c28c86da6eab8f5,34087782803
20180929,"PAYMENT RECEIVED",1250000000,0,e2ad92f090265176edfa73838c76c200975f6710f094b3adbfafbc79dd0e3cf9,32828231629
20180929,"PAYMENT RECEIVED",1260379186,0,8347702f91e59b0b455a8b35831a1f803f6bc6301b3a05391574b65eb7e1da03,31578231629
20180929,"PAYMENT RECEIVED",1254490623,0,624f777ce1f58f8d54eb16e74bf00f0bd5fbb9c71f99cc982f31e34f8a15724c,30317852443
20180929,"PAYMENT RECEIVED",1250509806,0,f1d82971bf97ccd0983b1d63ebbe06bb277b61d3fa25cc061b64da03f7226a46,29063361820
20180929,"PAYMENT RECEIVED",1285862702,0,93d77c5a5d5ba0d3a535314a4b7e8c10694f2c3a936d519e2128b37b214f1eb4,27812852014
20180929,"PAYMENT RECEIVED",1256218214,0,793c57966faaa19d1f275400c5f9ba87d91fda5c7074528ff18a3f3c57a4f393,26526989312
20180929,"PAYMENT RECEIVED",1280940490,0,c5d707044bbcc5473df910b102fc43f4123b51dc8c242e2445df7530649991ee,25270771098
20180929,"PAYMENT RECEIVED",1261015008,0,f054a5c0703ff5b8a134a3df696e8b6486487b238f1a5bc8f457539cedb79988,23989830608
20180929,"PAYMENT RECEIVED",1250100578,0,4e6a8a17b0c6a2a0cb7f2933911115dc87f8810a18b81a93ab07c875c2b1149d,22728815600
20180929,"PAYMENT RECEIVED",1253321291,0,f59ad57468cb44a99e4ade8be8b07f598eabbaaf71cd361d998c5fb493ec4a5c,21478715022
20180929,"PAYMENT SENT",0,-31544673120,847f3f5669f47310ba15cfe75a2686ed8fe931215f47fa2e30f7855eb32c8666,20225393731
20180929,"PAYMENT RECEIVED",1256305969,0,8666d2683bfb71c9ce704d0180dd89c2f769c79aa3e37bf38d461bb50eab9476,51770066851
20180929,"PAYMENT RECEIVED",1250245837,0,8d488c4d43464dd270d15acdf636c33e456a18b232ecf7f4027a92e0001c3f4f,50513760882
20180928,"PAYMENT RECEIVED",1276150630,0,373d157a5d2a5e4310a42f98d34fe0a7ae881259f06333e8f9d5cd39ebd502b3,49263515045
20180928,"PAYMENT RECEIVED",1250000000,0,e268aa16ad432d504a9bfabe7d05448105f5ae9723de52bf41bd9730aa8946fc,47987364415
20180928,"PAYMENT RECEIVED",1251198506,0,6db42d00639f573baba91302ed6f03ab4dec1813913af1804069c072338dec2b,46737364415
20180928,"PAYMENT RECEIVED",1292639128,0,f0e815fc52c60b8ad0d4bd6bfe56a7b2430577423f69d25670fcb44be667e671,45486165909
20180928,"PAYMENT RECEIVED",1250007952,0,ef21462015100c9759e2e8822083f9d42e3bc9822ca90f3181708411abe6b2eb,44193526781
20180928,"PAYMENT RECEIVED",1256495886,0,dd393b868f7f136f86680be9ed958f6f12eb84ba5bb114d26974267f1ae30c16,42943518829
20180928,"PAYMENT RECEIVED",1250608117,0,54b77e94b21eea59241025fdca0dc088351dc0494f84b123ac0b38d424f17d3c,41687022943
20180928,"PAYMENT RECEIVED",1300266713,0,e6013a168d95809b3056b0518796d45ad22e4f9ff0adc598ce8bb8e2053b6062,40436414826
20180928,"PAYMENT RECEIVED",1259983412,0,63e57c355c3b8ac4d18e97eb128558c11a7f4797c56d22733264b09e46ba7354,39136148113
20180928,"PAYMENT RECEIVED",1280618811,0,5910ff6fa28db102bd51023d9d61b465f89cf543cd993e68869dc529b6ba0da5,37876164701
20180928,"PAYMENT RECEIVED",1275056967,0,7518fdfa6c95a2c43ed0dd2c350acd60e3c9766bfed17af46705b1620adeff3d,36595545890
20180928,"PAYMENT RECEIVED",1250000000,0,c3fb9353032771c21e50e5aa4509e988f310267750eed324c86c2bfb15fe70e5,35320488923
20180928,"PAYMENT RECEIVED",1259452448,0,145da0ed9c1193a2bfa963ea78012aad6343b1a035da511bf15ab424c5165576,34070488923
20180928,"PAYMENT RECEIVED",1266363355,0,f35d2b3aad3d980f83ea3d251b2925cf08d0c818ba1622ba0520dc48638c663d,32811036475
20180928,"PAYMENT RECEIVED",1263643075,0,ed1eed08b16eb0316354a3a66c49a4f5aa59986c8ef41949869cb89f6b1cda32,31544673120
20180928,"PAYMENT RECEIVED",1258443524,0,96fd0ea82d6628e9a8516bd74aadf0d688791a9dc59eeaf336418a5a1b418afc,30281030045
20180928,"PAYMENT RECEIVED",1258910611,0,9f0c32d6307adfb03c7e8bfd27e8d0c50c4deb769b10f8618f53592df1631cbc,29022586521
20180928,"PAYMENT RECEIVED",1255552455,0,35406248a51dcc7c38681ef00951b208b1fd368abc0216b3bdceb2b5bb4d5140,27763675910
20180928,"PAYMENT RECEIVED",1266225253,0,0409fb3dbf48b4d3ddcd1fd1ea27ed1599c42c3102f147caa07d1c94ad670ae0,26508123455
20180928,"PAYMENT RECEIVED",1252513986,0,0569fa89b618af9b17173d3d40a5c4005243a9cf703054c5f40ef5f84087bc3a,25241898202
20180928,"PAYMENT RECEIVED",1252222464,0,dea88e835c2af3b24897d54957e93818cec429fa39559da756a65604c00c5ce7,23989384216
20180928,"PAYMENT SENT",0,-30227684755,ae47c46f4969d286ad2b9be4e56251df8041334e65fb4b782fe5d0db470b2de7,22737161752
20180928,"PAYMENT RECEIVED",1252468786,0,e6a923152a4d004c25b7ce9d716bc49dfccae1b27b38173db4631f4cc6b01624,52964846507
20180928,"PAYMENT RECEIVED",1250000000,0,e12408c82817511581383d5efed2bb36cae33f04290372b65cee94a3d5fd4dec,51712377721
20180928,"PAYMENT RECEIVED",1258379777,0,f564540e6b6630354a1f7dc28380a9bd675b21b66fe8fe25d8bb77aa08b59af8,50462377721
20180928,"PAYMENT RECEIVED",1251665848,0,2a4e09e8b2ab9c0744608eefc2be5f58ee908fff2963cb32ca5c7ae7c71e438d,49203997944
20180928,"PAYMENT RECEIVED",1283514568,0,aa7d062627831ae8c17af5e804ab6c7e991ee1b2d653dbf6460133ae92f36090,47952332096
20180928,"PAYMENT RECEIVED",1250000000,0,e0bdd7432d1554a7c6e0b3d32c019ea289ee5a655d55367532be19b058618778,46668817528
20180928,"PAYMENT RECEIVED",1269911985,0,0e0c0e330fc99a085f7febd168ed63c28ea33eed892ff2f52d15febff910a19d,45418817528
20180927,"PAYMENT RECEIVED",1255898577,0,d766dc247ce3d5cfea137e621d0eec73f39eafaf22091730652ea9d5953cae10,44148905543
20180927,"PAYMENT RECEIVED",1278347261,0,7e86a24d251aa0400c1557a898d05fe9d98adae87358d38fd22ddc986d690863,42893006966
20180927,"PAYMENT RECEIVED",1250000000,0,88cb1a2eac5f1bd0e6955bcd506fd1e63679ebf34c1cf71827b0c4af6ae296c0,41614659705
20180927,"PAYMENT RECEIVED",1250000000,0,61268167e33ee36869bef380b76f254e516586505dbb37667cdb6b46548a013d,40364659705
20180927,"PAYMENT RECEIVED",1270306978,0,27339ab7a52bad47a1650dfc55cdf8209e5fae48291a04b78b9487a34ea2ce88,39114659705
20180927,"PAYMENT RECEIVED",1261220075,0,bf536d48f9c957d1ae490bd0f74f5db2984d4e9ac934093e4d948fff49c0094f,37844352727
20180927,"PAYMENT RECEIVED",1258346345,0,24452764eeab8ba778e2d4ef674d32fd26070d702dc6773828b349438e5150a1,36583132652
20180927,"PAYMENT RECEIVED",1297765404,0,ce2d2984b5b3b2f813cb0687e5cd4f9adf71456305ee242330b707e2abb8bebc,35324786307
20180927,"PAYMENT RECEIVED",1298167066,0,9d023efdd62eb8267750d876c1da8dcec7ed278ee95c59b40acaab50d2283928,34027020903
20180927,"PAYMENT RECEIVED",1250000000,0,222453acc032bfd0c540f57fec4e305b164bd22427a89fbef0fc329777f7897d,32728853837
20180927,"PAYMENT RECEIVED",1253156799,0,dd56e35daa1435bf64ae765b79ab2d42cb618fbd9758ca138c148dd606a6aca6,31478853837
20180927,"PAYMENT RECEIVED",1250000000,0,3a4b708e777b19b3c66223e13af45cd77844e73cc66a715f0714c28560f185da,30225697038
20180927,"PAYMENT RECEIVED",1250000000,0,90fcb5831190b8a2df224f8bafb5627ba9d0dbde178f1ae4240fddb37e7a7547,27713721334
20180927,"PAYMENT RECEIVED",1261975704,0,a0a623e938baf6d863a98579f4d52369cc1b7588059e63b3fd59e211fdaadeef,28975697038
20180927,"PAYMENT SENT",0,-35301779874,d8dd3abffdaed474dd6d378434c86c07c4d673fa386f1c8ec08a223bad36a8a4,26463721334
20180927,"PAYMENT RECEIVED",1269693393,0,4463ff29c693cdfdf1ce5b142184c583cb11a11897744c27d94c131a967ece6a,61765501208
20180927,"PAYMENT RECEIVED",1251328980,0,7f66e0ac35a68d47a54a11493a3bc01c73cb8c061753004ad071aa2e6414e703,60495807815
20180927,"PAYMENT RECEIVED",1250879328,0,7bd9e3e92e3f4117d1e366fbff602d3fc9afb1758a66fdd8c449300a4a224edc,59244478835
20180927,"PAYMENT RECEIVED",1260935956,0,22db5324cfc9e2e872f3cda3d5a6142db5a8db45017ec7d015ad1e4170f5b004,57993599507
20180927,"PAYMENT RECEIVED",1256994449,0,0ed5a8da9945dc05291b1f6fbdedcdf96a8433956f84216bb8fa0b535ae4d85d,56732663551
20180927,"PAYMENT RECEIVED",1252940170,0,2e5d3ba53a6a54628726edf37c54e03ab43846fe32c3cf3dd47bd1197893ad15,55475669102
20180927,"PAYMENT RECEIVED",1250785697,0,9351731d68f199ae76ca1a103ff2fcf995b6dfa2976aec5cc589a41c3189bd9d,54222728932
20180926,"PAYMENT RECEIVED",1251169082,0,96b1cf0d48282db362a3db12432f7d5f60c026b9663a63c7afee8da6341bc180,52971943235
20180926,"PAYMENT RECEIVED",1252844680,0,f3d25df728ba7d0abf8ab529e4685a4a36520b80596a318593fece5983c3cccd,51720774153
20180926,"PAYMENT RECEIVED",1250000000,0,daae1d807393ea9a523c9b592ce97afd1c25117fd6b75076e355fe5a5d7e21d0,50467929473
20180926,"PAYMENT RECEIVED",1270448344,0,7369c737f1c9d106989e460ff27c5ac6d702c730feb74745803fe26c0bc5c7b3,49217929473
20180926,"PAYMENT RECEIVED",1251412309,0,63a6a221386eb8c089f4b2bc161b3b31224442fa9fde957b97c300c04df9f171,47947481129
20180926,"PAYMENT RECEIVED",1250000000,0,60e901fb410ad09903ece7212d8b973aaeee8a3894eba16b66f6a7302c8b7cd5,46696068820
20180926,"PAYMENT RECEIVED",1262355814,0,e659647a795bcd2416028c6cc2e3b7e91227b600bfb5cfa203fe637530f96428,45446068820
20180926,"PAYMENT RECEIVED",1266359588,0,b07c68df65f40aae24b095ce1992766a7139c76ecbb52036261433cd0ef02eb7,44183713006
20180926,"PAYMENT RECEIVED",1250000000,0,f1d848312833c28ed3358fe197ebd3374bdbfa0b06e434103a20b572f212a1c4,42917353418
20180926,"PAYMENT RECEIVED",1272794611,0,48e4ca548fd8744dccca3a5c90eb83835107b227fb1b1c0e7ef400b2c8398cb5,41667353418
20180926,"PAYMENT RECEIVED",1297298585,0,ea0ce553793e3d4d9b680f63ff4b2934122d0a4eb964297931760f9fb1ee2863,40394558807
20180926,"PAYMENT RECEIVED",1257566019,0,28986d35392fa42dbf89a195c425ec123a918616f5e3ba0618474f526029c634,39097260222
20180926,"PAYMENT RECEIVED",1280015657,0,32fa4c0517dc133268318498ea99fdeffb27d95d8ada0d46a1dffefbffff34e1,37839694203
20180926,"PAYMENT RECEIVED",1257897849,0,77e8991099cb88112b5e79212d59e281fccd1ad22fa56ef1e0805b5de2624159,36559678546
20180926,"PAYMENT RECEIVED",1295905938,0,d769eb027104ad673d8ffcdc770bdc060d7050d415dbfa5e72f232be8f5e9658,35301780697
20180926,"PAYMENT RECEIVED",1274877758,0,fc0552929daad5428c53ef864bca35f5cda61762fa56173d6f1e15272497de56,34005874759
20180926,"PAYMENT RECEIVED",1253782439,0,c547e0923d878fce0f94b3d07a500c864504df48c9c000bbee2b58dc0b495baf,32730997001
20180926,"PAYMENT RECEIVED",1254184609,0,231e2ab6803ee9e89f344dbd34940c96e5d2bf8dfed49eb317e592be70d51ed0,31477214562
20180926,"PAYMENT RECEIVED",1264006463,0,e1e64d2be32e7cdcf729ad2cd85e38391fa981d8501544aa1bfe981ef27dbf29,30223029953
20180926,"PAYMENT RECEIVED",1290280218,0,b32d63d17cfcb7e59067910039d42fc156d60a987be6ee1733e3914f668838bb,28959023490
20180926,"PAYMENT RECEIVED",1250415784,0,933ad974baa061dde216cb2f6b9882f509f28eb26ed15b6d6a284d6cb7a07566,27668743272
20180926,"PAYMENT SENT",0,-26469244757,c5f44e4f8cc0ac09ef6f54fb485ca642e4bed875b82f59d6ddf166d8a244d685,26418327488
20180926,"PAYMENT RECEIVED",1255236610,0,24a4f0ddd5d0b7bad28d49709363caa7d972a7be1fbccd1bf740cde31b8648a5,52887572245
20180926,"PAYMENT RECEIVED",1252060179,0,60c602c4afa9e8421a0f62b9dcad35891d91df2ec614a7338477bc439cfef126,51632335635
20180926,"PAYMENT RECEIVED",1251475976,0,5271ff761d7b053a2c96b913078cdf4ffde6a9e7c9fed67d34a38588796918d7,50380275456
20180926,"PAYMENT RECEIVED",1250366786,0,f4d3dc994f78c22a98584f0c61d41b87d6b4ce265c7ae252ca061664a0b870f0,49128799480
20180926,"PAYMENT RECEIVED",1258215402,0,5fec4d213c30ba0450ebb0ebfb665ab05f74125ce8da16415da2caf9bd1e6282,47878432694
20180926,"PAYMENT RECEIVED",1250000000,0,a8b37f395c05ad9df5907115a30b16480a9dbc111dd3d95dc02e5029eb2ca053,46620217292
20180926,"PAYMENT RECEIVED",1268533532,0,f7ce2529f707f906b21a6039026ac4dc33941da609ece1ad009a45e7c5dcbddb,45370217292
20180926,"PAYMENT RECEIVED",1274098671,0,e67d89040ba00042f49ee47215364941cb7621cd20189eea47a77a018c0301a1,44101683760
20180926,"PAYMENT RECEIVED",1251336865,0,77547e54274164deb814db6b17d89d9047f634834e40bd9af15b934371926c4f,42827585089
20180926,"PAYMENT RECEIVED",1272581643,0,00adbc8ff8197d7e39b913c9a54d65e08b4cdddbbc8d6ffd1ada325d45856ba9,41576248224
20180925,"PAYMENT RECEIVED",1250001700,0,97815b4b3dbe297cb4629d838e2c79e426f3ff2a1f569d13cd9f4346a19d1ec3,40303666581
20180925,"PAYMENT RECEIVED",1261932687,0,55eaec9407a370b3a6fbbc18e6ad62758bb94054ce223e16a5b7ed33533aeccf,39053664881
20180925,"PAYMENT RECEIVED",1250000344,0,3451d7f5497ff32414dcaa150012b23bd6b3bbc6f66c4e668c5ef48ef155cdfa,37791732194
20180925,"PAYMENT RECEIVED",1250211833,0,d11a13edecf5122332f70e8ee49ae4f8e0df34a05fe6475403877e11df30f6d6,36541731850
20180925,"PAYMENT RECEIVED",1252275702,0,e8bed980d551f4b93b247a2d1bbea84bd128954099d94455e9a310a199ccb979,35291520017
20180925,"PAYMENT RECEIVED",1250423606,0,04839c0c85a73af01367c836def3f63d68d0ebc2bb2bed01602640ff2f783a83,34039244315
20180925,"PAYMENT RECEIVED",1265892184,0,3504cf9abdd669a20d8296b5903f25abe382030fb274bdf210d654b7570c2e5f,32788820709
20180925,"PAYMENT RECEIVED",1253661265,0,7714425e0226f54fb8210384f0a71219e63768b2c20e5ee7dfe1efd7d0273511,31522928525
20180925,"PAYMENT RECEIVED",1271764537,0,f77660c7178b7a3ffe1dff3b7b8f5aec8cf33db4bfa7a669860c1dd20f84ec44,30269267260
20180925,"PAYMENT RECEIVED",1278257143,0,1fbd400e1be6c63e9769dc4886b461d34788738a15cb86b77104da9668e69174,28997502723
20180925,"PAYMENT RECEIVED",1250000000,0,952c7ba17a98710db35361a1d7b5869955f334acb32953ea7be06258ecb9e537,27719245580
20180925,"PAYMENT RECEIVED",1279743984,0,68a6960f88b9e177afe817853f82dace6837b2fef461a69e8a3c072f79436ef2,26469245580
20180925,"PAYMENT RECEIVED",1267940395,0,c45eb208f7f60128f05712e0cf2011939222d23c09ceee9563e882ea862db20e,25189501596
20180925,"PAYMENT RECEIVED",1250000000,0,a23f732a4bd6c523d9536a6c4316fd2ff7f229b02650132ee0ce87eb89d8638e,23921561201
20180925,"PAYMENT RECEIVED",1265345029,0,79563ef1840ca5504d1ec983c51da50bd6c6917fc62eb8b595f1963646dc99d3,22671561201
20180925,"PAYMENT RECEIVED",1264129665,0,b2399a959b827f87b7cd1afab96e8e904e2be0fa84a60601acd8dd5081fa9e4f,21406216172
20180925,"PAYMENT RECEIVED",1250000000,0,66143a7dac295a988ec472f95e4c5b15ab1013962304a2b0f474b308bbc04acf,20142086507
20180925,"PAYMENT SENT",0,-28959164501,245254ae806c56ceb5e4ee25d3ddaf49e7a82fefb5f995dfea2d8d4a6cd7791b,18892086507
20180925,"PAYMENT RECEIVED",1266272632,0,e3e2000a91f524aec63df2ee6c82a9e831bc1187165b09ae01dcab40dd261572,47851251008
20180925,"PAYMENT RECEIVED",1275374926,0,43c2ce9e6c567e35a7ea7f58694cc2ea33b824dfc93807482b068834231125e1,46584978376
20180925,"PAYMENT RECEIVED",1271489118,0,a3747859778a26d7d611654572603d23e42e1f4191e94e85b5b15268a158b40e,45309603450
20180925,"PAYMENT RECEIVED",1251204501,0,7a39fbbcbd8d56a010d3d3c52610c414f6f368c2e1b6a89d901f28586bf3e94b,44038114332
20180925,"PAYMENT RECEIVED",1266113846,0,c51d17db314cec869d42bba296bd93186b6133b6ae026d3ebd5c8bfce20f75e0,42786909831
20180925,"PAYMENT RECEIVED",1252290360,0,a8a39cb3f7df358f898a421307c18bbe094348431c9be0a0a1ed82f78c130731,41520795985
20180925,"PAYMENT RECEIVED",1250000000,0,7df7b2e3e1cc57a604a2d802a8de34b27cd1cbdf0038fd13329f44a1f15bfe88,40268505625
20180925,"PAYMENT RECEIVED",1250264280,0,c6d478b82b996d293bfe51bc64527f5489d6e8f60e2bebe4d4f94db58451a125,39018505625
20180925,"PAYMENT RECEIVED",1260449061,0,3af8369fc1bb87c488a5298cb31cb633ab6d0e1d9b2752fe5dcfe79145f32a98,37768241345
20180925,"PAYMENT RECEIVED",1267817898,0,16a6196030ec135251e357b2417e8d01b3584154c23db88fdacfeb23ba33bf5e,36507792284
20180925,"PAYMENT RECEIVED",1250000000,0,55425fe2dcd272a2e0dc5836cab5cc078fa89d36caba674c74e9b9e0f86b4d9d,35239974386
20180925,"PAYMENT RECEIVED",1260810527,0,cc8b6e531389d516f9e3d9b1563a8cfaccbed68b07184956cf887e98f442035e,33989974386
20180924,"PAYMENT RECEIVED",1264465116,0,c9f6f75544af06b7a0308fb0def7137562dbb4d2b482e1aa03540e7952fed12a,32729163859
20180924,"PAYMENT RECEIVED",1250118841,0,31a724e3ad2bb44c5b49cc62c4f174b3a884d7a7fa68b59496bbc27635087167,31464698743
20180924,"PAYMENT RECEIVED",1255414578,0,a172a8929718312614816583948f618303d01f33ee014344e816927ed1ae64dc,30214579902
20180924,"PAYMENT RECEIVED",1265623213,0,d967b7fd2965e81a5fa7acbe0a49b0e3e365888b4dd207dd78b206fb9b808000,28959165324
20180924,"PAYMENT RECEIVED",1257165985,0,442b073b80d55e92822d47ecea4469ec8fb7cfe20d5be1156407f81d8d4c631a,27693542111
20180924,"PAYMENT RECEIVED",1250000000,0,8b736006a3deaa7888acdd43afa9c342b6c478e7520c7e2ce154690b44a28bc8,26436376126
20180924,"PAYMENT RECEIVED",1271257251,0,477d83fbe8ffab9a7e989252cdf0c32bae1da959a0d78e8c9140a7f09bb5f605,25186376126
20180924,"PAYMENT RECEIVED",1252898449,0,dd8fd869896593f2db5c9a3fed20c07b7281783822313c39261825ef3855bf1a,23915118875
20180924,"PAYMENT RECEIVED",1252277554,0,2a5db5fbbefe884c3b0496f9a20972623930bd114c6fd5cd1539589c5b7094a2,22662220426
20180924,"PAYMENT RECEIVED",1273595752,0,36e76c965201f381e70702538c78a489242f7345c1a051e51e0b16d4ce52cdd4,21409942872
20180924,"PAYMENT RECEIVED",1263873410,0,56362bddba7c7656b0a622a2498a37add077422057876b0e38cbd958164654b3,20136347120
20180924,"PAYMENT RECEIVED",1274485868,0,59cc3e46a354e8f293b59359712635fb0b688475c9bb7801b2bd91c2c3fd6bf4,18872473710
20180924,"PAYMENT RECEIVED",1258178809,0,c58dcabeddf568d13506ba14b72dd3887fb8ae7a603dd565c331bace5f1eada4,17597987842
20180924,"PAYMENT RECEIVED",1273303845,0,f700dcf1c19a7746cdf8b762a10ed368a0ce5c8f40cc702fab51cea3f32b1442,16339809033
20180924,"PAYMENT SENT",0,-27714736819,7f54e250821229e5655de80639c82cdbfeb0ed46a94166d35daee451268eda0a,15066505188
20180924,"PAYMENT RECEIVED",1258896789,0,c3edbaaf65945c23b38e68823de4079c1d6a58681ac339e8746e7c665b1d50f9,42781242007
20180924,"PAYMENT RECEIVED",1261455760,0,5d13df6ab172a1bd3b685cc77050176846f45907665834b45fd244c4d73625d4,41522345218
20180924,"PAYMENT RECEIVED",1250000000,0,276f831bb04c5a728cab8fef7ddbc192a2e885e25aec416f2d7c47e845901e1e,40260889458
20180924,"PAYMENT RECEIVED",1261686482,0,97ca0fa22e2562f0ead597f7c115939730797dfd10bd44c6ff80fc4d0e452063,39010889458
20180923,"PAYMENT RECEIVED",1260388459,0,3262ffaee49f9536a4102b5968c5accf6601d569416792b287014b6ed2028f7d,37749202976
20180923,"PAYMENT RECEIVED",1250071067,0,eeeb458509b240f1d35c9ac76a035f0b21b479362d4c902043500c386eee6ead,36488814517
20180923,"PAYMENT RECEIVED",1251986473,0,c45d46ca75fc6b70dc8ca32b8a2901dc455123b4e593431958ec3af423aec53b,35238743450
20180923,"PAYMENT RECEIVED",1250173981,0,2fd746a47528a8ca0117002ed909b5f7a3a95f1185a304925c63622ddcd1f3e6,33986756977
20180923,"PAYMENT RECEIVED",1251057012,0,1f44de3274516fe0416551fa9293e6a8618ef97ba135e1ff50ac2024c8cfe299,32736582996
20180923,"PAYMENT RECEIVED",1250590395,0,b432d3befe1960804ff4a4ed2457531684950ad7bc58e593a480841c4b5dd120,31485525984
20180923,"PAYMENT RECEIVED",1251133793,0,e8cd28b172ac803759e0fda7f70ad3141ad3783448b6c68cb3b82ee8c2058c3a,30234935589
20180923,"PAYMENT RECEIVED",1269064154,0,7517e02ae9e04dd1a8434583bd28f2e05ba787bf83fd579b4d621f8e94eb6c94,28983801796
20180923,"PAYMENT RECEIVED",1259073891,0,7d86381e0be38ff1f79285f7f4023094c090f792e137135646e2a72741f0c818,27714737642
20180923,"PAYMENT RECEIVED",1250338325,0,d9e69424ae64ec82f953691f645246b4e60ba1bbe1a9b3919b86b030ca8c60d6,26455663751
20180923,"PAYMENT RECEIVED",1258718403,0,880bd74e0cf4772cf83bd147023bbdc9e78cc2f4b6d369e20ddae5ecf36f9f44,25205325426
20180923,"PAYMENT RECEIVED",1250148468,0,d26783801f6001a4d3d1f38e40b185f6ea898af73b84f7adc25c83b73c302cdb,23946607023
20180923,"PAYMENT RECEIVED",1254066052,0,3b04bf7d593efefa29c7533e05cbe2a8965f4323ac32410cd0776fab953b17e2,22696458555
20180923,"PAYMENT RECEIVED",1251226612,0,6392d134a91a171399ae58e0358a5a642b681b668eca7a10d545f33c633aa7a2,21442392503
20180923,"PAYMENT RECEIVED",1258826767,0,8e92293e3c4ef6eb64ef65f99dca61a7128d91b08f9abbe965ae9ed09073dfff,20191165891
20180923,"PAYMENT RECEIVED",1262603412,0,1dcc8c7c8af4cf138a8eb7031af0893869b9e42927fd553e1a1b9a84b25970ab,18932339124
20180923,"PAYMENT RECEIVED",1297791350,0,cc391f06c3c207d8177fdaacc070c157b7c37e57055121fb9de5ab9712d4ea8a,17669735712
20180923,"PAYMENT SENT",0,-7590080589,163fe1624528f8e20c74d5a02822d2471a0b324484092fc9345cc4ac15dffd65,16371944362
20180923,"PAYMENT SENT",0,-8760583257,dff927b3bbea871df61cb38e1614c7259354968f37483e66398d41b5d1e11302,23962024951
20180923,"PAYMENT RECEIVED",1265024844,0,605dedbecfa4b37585cf30e64cdd9323f9ffae744340578f54b3fb533b6a0df6,32722608208
20180923,"PAYMENT RECEIVED",1259035973,0,c127841d1f5953d911532ce268df1eec237dd088958c9ba3ac2b464ed8046eac,31457583364
20180923,"PAYMENT RECEIVED",1254644461,0,4175208a1e5062093fdedc9f8672f487123cd11a55d48348fbec3a08a7469e11,30198547391
20180923,"PAYMENT RECEIVED",1250067339,0,74c028047259636da4555d575033d69a25ab9a41f4bacbb225083651387a23c8,28943902930
20180922,"PAYMENT RECEIVED",1251304728,0,2cf8f564af2596969d74b095315af91de1ad98ccf39a3a03b42c1949f8eb1f74,27693835591
20180922,"PAYMENT RECEIVED",1262017255,0,625828ce663c0753e160069b531e9241d2c3bfffc2150743ea8e2dd1b43e3533,26442530863
20180922,"PAYMENT RECEIVED",1250212109,0,51e844f6342764670d46adafde00db97a1754d9877f8c26e502380dcb96a1089,25180513608
20180922,"PAYMENT RECEIVED",1250000000,0,7b1ec83311f1d627bd214cc4632cf65500cc6c089966d8391f409cc9ebef0e35,23930301499
20180922,"PAYMENT RECEIVED",1260685419,0,9326929e367403c51d2951fa27809fba7ae93a8523123a40d79435eb0ce692c6,22680301499
20180922,"PAYMENT RECEIVED",1256680199,0,3e938c94c50d3b33fed91dd025cc64b271c70be1cd4cb417ab92cbac439fd407,21419616080
20180922,"PAYMENT RECEIVED",1254985878,0,51cbde8e20a75ca56d2faf389f86c085adf6dcdaae8fd89fd8d8e99c60642190,20162935881
20180922,"PAYMENT RECEIVED",1261523828,0,ba2dfd42e4f4275815bb8f92ea5262066d17ff54d35a37efc465dee19c06db0d,18907950003
20180922,"PAYMENT RECEIVED",1295761506,0,bfd932374d50dce9a0d5107b39db5d1757a35f27e85f83ec8522692fdfbca2c5,17646426175
20180922,"PAYMENT RECEIVED",1250091479,0,580564c9ba1cbc2a3ecfbc29319e4b4e910e309efa26ba1defac56605e1d4f62,16350664669
20180922,"PAYMENT RECEIVED",1251949070,0,e18efa98b2dc43dad4129978b6568fb2b552775e6847b19c439115b7d7a45f5d,15100573190
20180922,"PAYMENT SENT",0,-30426603921,baf03c615ebcd1cee1aea2319c5775e5143e73202d2bf2805abf8cd22f4a5b8c,13848624120
20180922,"PAYMENT RECEIVED",1253234180,0,4a512ca18ece308a9fab664b9d42b4fb9a4e4af46c9241784220ff266a442c1f,44275228041
20180922,"PAYMENT RECEIVED",1250002718,0,16356ae77dd1fb234aa60d6541e19addb321a94005b7105d06ae5680b5db7630,43021993861
20180922,"PAYMENT RECEIVED",1261019681,0,5d17b1bdbe4ef08edf726a9bfc1b855fd1b3439bd7a156b8a5549ace74e44253,41771991143
20180922,"PAYMENT RECEIVED",1250000000,0,c2ab998a20a66137aa8aa0b0c8b7f945f976a290c54f60e3e86b4bd273dc037e,40510971462
20180922,"PAYMENT RECEIVED",1250007109,0,9d1873f163da410cd6f9c400e6772a656a1590c9e68f4be0b16a7fa10adc8d9a,39260971462
20180922,"PAYMENT RECEIVED",1277976840,0,be0aa4ca550233e832b68f31a2c9e9d57ee0088c09864cefd622c826ecaf5fa4,38010964353
20180922,"PAYMENT RECEIVED",1267787588,0,65511c4ee7001e333f871cbc0072272c9e71332a5683b82a8bca763b246845d9,36732987513
20180921,"PAYMENT RECEIVED",1253205696,0,f1c76eff9ad779c32bd47f653187294bd0fdafee2e372160122b7948d71f09f2,35465199925
20180921,"PAYMENT RECEIVED",1252095723,0,17c3d6ba68e5c240cb1bbeb1f96de9376a22f2ee40ef4eb99eeadd6e820112ff,34211994229
20180921,"PAYMENT RECEIVED",1279453252,0,63dc354de4dddafe186b5ed6540f1af5d08fa281df192689cc40e4e321655fc1,32959898506
20180921,"PAYMENT RECEIVED",1250000000,0,ccc7529cea081040071fd580a381e58e8764a7a0769dd429c89135d712f58866,31680445254
20180921,"PAYMENT RECEIVED",1305323940,0,2e6afc79bb9a053ac80fe362a96896930edda0b74b4bdd11e12a49e2c8431e44,30430445254
20180921,"PAYMENT RECEIVED",1308854027,0,e282481f45bf49b32b3115a0c80eaf860d8121c5635f8af0f1fc68171259fcca,29125121314
20180921,"PAYMENT RECEIVED",1264710279,0,e3f4cfd165877931ea6b9db5fc6e37e4fec1c2d58fe4040072fed694a5af81c4,27816267287
20180921,"PAYMENT RECEIVED",1250000000,0,8e45df6156a16452177ea6c520eb3cae9e6acf403e916cbf34e9722449f4fbe3,26551557008
20180921,"PAYMENT RECEIVED",1260679112,0,183c26a0c1a538895ef77acab427f699288c9567d426bba34ae5d15a85378c86,25301557008
20180921,"PAYMENT RECEIVED",1262084128,0,b2ee1e2504d6708bd3addf6991c7c2dd11b8088cac3025e14a2505e87f6beb7a,24040877896
20180921,"PAYMENT RECEIVED",1274588506,0,15490b137b9514b11e88643e7255f8483bf26c73c15b380e3aaeee90e08a8929,22778793768
20180921,"PAYMENT RECEIVED",1275245761,0,9e073117bdfc86c482cae43b3ae2d6dc88498b2959a97497e7eac4e58693b510,21504205262
20180921,"PAYMENT RECEIVED",1250105400,0,f241933638b9070568af0503e34e9bb06435a087e162683bfe148b43bd3d64e6,20228959501
20180921,"PAYMENT RECEIVED",1253590592,0,eb35840055888f8743c4af79411bacd145fbf59931719b3f46023f98f3ca07f7,18978854101
20180921,"PAYMENT SENT",0,-22648466109,f40fa6d94ddd1af68e69d55a158bff55addc2e5688a5f6e8b45a30928c219ac6,17725263509
20180921,"PAYMENT RECEIVED",1270597826,0,bc6170078c36d248f07114705c78f07f3f8f93ec64a8185534e29875e604660a,40373729618
20180921,"PAYMENT RECEIVED",1250000000,0,096d9b73caa58dd8bfd0701dd1f278b9050d8afd60efede434aee8ee825df450,39103131792
20180921,"PAYMENT RECEIVED",1264662411,0,d035572bea126ffcbfcd85f012cef6ccea1ba64433b8fe8d3d5a79f1944ca53f,37853131792
20180920,"PAYMENT RECEIVED",1266214204,0,5b341e44a5cd05f5eab7056168c65f74b404f2201b44575a14d00a21476abe00,36588469381
20180920,"PAYMENT RECEIVED",1250000000,0,b5c19b3fd884373612791a534a11d46dd1601faedfa3fb1389cfcaffd6b2bc67,35322255177
20180920,"PAYMENT RECEIVED",1250859798,0,8e34cd026f971e1662cef3e6e81451c5f2532513898026b36167062dfd8ef270,34072255177
20180920,"PAYMENT RECEIVED",1273985081,0,78d6c78cddb0b1d20dde0763651382b84f8366d24fad439cca9cc92427c39ad6,32821395379
20180920,"PAYMENT RECEIVED",1250034731,0,4978d766cafee2b4143f51529ae27319f0fcbdfe9490ac77878f1b9a960a7b2f,31547410298
20180920,"PAYMENT RECEIVED",1262846541,0,accec43a341e83db5a3dd35b9768fe86789ebb7a9d2f92f7e4042b8372f465e7,30297375567
20180920,"PAYMENT RECEIVED",1262695936,0,b797aaa5b6b2073a342c4cbd2d5ae47420d28343e780f7e692d1f73eb1c9c2d7,29034529026
20180920,"PAYMENT RECEIVED",1272703724,0,35afba6064c16fac69c3a89dbd65529c7d4d97eb8cc1cf40851f157c45944c9f,27771833090
20180920,"PAYMENT RECEIVED",1287783005,0,4c9238f75c5d67d7035c04ad5a2a6e3f72d0301740466eeaeb4c15d543fc81ac,26499129366
20180920,"PAYMENT RECEIVED",1306800006,0,c90271425e4a42d27665e4bafee7dfc566d088227131a765b8df91c78fb11e52,25211346361
20180920,"PAYMENT RECEIVED",1260682127,0,9c50a23e77a5d32a114fab3b48a8aef61181791cea3138ed66985285fb92c404,23904546355
20180920,"PAYMENT RECEIVED",1252479223,0,0e31e7d223a51633683904f268b5ad3a8e3674388f657199bdb160f36f8fca56,22643864228
20180920,"PAYMENT RECEIVED",1268058819,0,f5a9e3a2bd4a89f55869214f202996cb325633c3cf29a07992aa89375c01d75e,21391385005
20180920,"PAYMENT RECEIVED",1288950349,0,360ef1d13a957e0178228273ce7e41cb7a25af21cb0af330fc7ad3283009fe6f,20123326186
20180920,"PAYMENT RECEIVED",1268807689,0,a8e401133ba173c4acb848ec344fd7069e2a1fd7b7fc5844c8756d3761aee1a9,18834375837
20180920,"PAYMENT RECEIVED",1250004874,0,c399a9d747a422c9fc9261934f96c406cec3ca136280812f8abb8a3b9fdd868d,17565568148
20180920,"PAYMENT RECEIVED",1250040573,0,57084ed85b3f16dfaaf5e44e596dfab414bf7ee5f5b26766124b2c384d9c75c4,16315563274
20180920,"PAYMENT RECEIVED",1257875939,0,e0976dd8476f7d9f108d6d71109f72d346df6226dd28c609d2ebc771471fd7ae,15065522701
20180920,"PAYMENT RECEIVED",1250021720,0,233961930066766b5b5eb605adeedadfee60972339f2e77b08cdd365ac93b9e0,13807646762
20180920,"PAYMENT SENT",0,-10045130888,2c642dd30a5dcdbf1630107e3becead1891043b78e0f763c212f020180241ba0,12557625042
20180920,"PAYMENT RECEIVED",1250000000,0,b7db13d9b12716a083c60a257a370851fcbe6371cf87f0b84057ce26e90f7365,22602755930
20180920,"PAYMENT RECEIVED",1253445600,0,081b6b0508ddd82426055311b45b2b388f571165b60fef453d3d8677a4350f0f,21352755930
20180919,"PAYMENT RECEIVED",1250000000,0,48a642fe21e4d536cc04b2f84c41231f9ad8e349268be3c1dfd7b2eb8385407d,20099310330
20180919,"PAYMENT RECEIVED",1256079423,0,fb6b095e43bcd49fd0b75b209c12cf23937d123ba88c1a43da782a4ae67ee673,18849310330
20180919,"PAYMENT RECEIVED",1250000000,0,1b96a9bf94ba0f92635e1f26352349ffc8f6357ebf0177fdf40972bd78cca862,17593230907
20180919,"PAYMENT RECEIVED",1252577855,0,76893f096e5489f958a57005f51155c59f288c8a19a36ab3f2a31b87ee6d3614,16343230907
20180919,"PAYMENT RECEIVED",1266385260,0,fdbe5eebc4caaed12ed1976c938deff0582b8201ec685653a5636471b2b4d0bb,15090653052
20180919,"PAYMENT RECEIVED",1253549377,0,adac11f1cd65b85e555254693e1e95029d1262400dd64be6489ae7fa44728067,13824267792
20180919,"PAYMENT RECEIVED",1266406492,0,17c81fd6d026f13100dd43c4b67e3c0f3bb5f1765db39e93a438bc6cc3662a68,12570718415
20180919,"PAYMENT RECEIVED",1259180212,0,19ae49f8499680a0d906a205af53f509994392c390066ad04e79c8f09e30ff11,11304311923
20180919,"PAYMENT RECEIVED",1262266332,0,6777099b19b50e0c23565b0de51971fd1c62772e16d0df5887a4e2b0fea17f69,10045131711
20180919,"PAYMENT RECEIVED",1250000000,0,404ea72dfc8b3a19c2470bdbeb4c3a585bd29d7276fcd9d97d53e2a0d9305778,8782865379
20180919,"PAYMENT SENT",0,-29004305801,643a71c2f1171481512ab085172b1988fa3640a116f8297db622a7c43511c5ab,7532865379
20180919,"PAYMENT RECEIVED",1265247877,0,9da1158bfbb3430792f948d0efc28ffaa45b42140d1b05f3a58def2c776bf4c5,36537171180
20180919,"PAYMENT RECEIVED",1255308628,0,74999b3cd71446a5c36abc9bf84f64db37db19b3de0882fce30b6d09fcb61b79,35271923303
20180919,"PAYMENT RECEIVED",1253295167,0,ef9454f9e6fcc6eb03022c8f9c4b9f70df283e9568d0f349e9d816227b0113d3,34016614675
20180918,"PAYMENT RECEIVED",1250064788,0,eca9eefdac125e0dcab96ee0fdc7907a5accf481bf924360abb4624d3a6a65c3,32763319508
20180918,"PAYMENT RECEIVED",1257339567,0,667914f70de19cd74b3f444f3a94ba2e9fc50b6f283770ccb112afff26ebbccb,31513254720
20180918,"PAYMENT RECEIVED",1251608529,0,bb870899f5ca6bf8dafda5c8447ad1b9e86fe16cd3c565f2d0e4655bda14edf7,30255915153
20180918,"PAYMENT RECEIVED",1250000000,0,a2697281a6e76d743837225dab8f441b13f670996aeae6c9c446b27464aafe84,29004306624
20180918,"PAYMENT RECEIVED",1285102760,0,4a370595d994d5bc898c69df7fe7764861db3f8d96c1fac65c35d920bfa1abae,27754306624
20180918,"PAYMENT RECEIVED",1283450290,0,b59a0c44a23d8e6aae73914eed0b1b20885090b332a14d6216176b3a00997559,26469203864
20180918,"PAYMENT RECEIVED",1250000000,0,b560fb6461d7490ea7a4240d49dc3693f2a6a2183a4bb925ae23b84fab99a0dc,25185753574
20180918,"PAYMENT RECEIVED",1251257574,0,142498a540a3dfb37904e1c34ade7cf61f6da208cd1350444729df5ad2755ad2,23935753574
20180918,"PAYMENT SENT",0,-30245097353,0b3dac43f1ad1b08d054d21ab80524c616ec4479060ddfe11e8bba872a3864b6,22684496000
20180918,"PAYMENT RECEIVED",1262732664,0,12facd1eb3bb0e298fdfa7017746710fe07d5310e9a1c707744d429277db1794,52929593353
20180918,"PAYMENT RECEIVED",1253324082,0,5603ede0172525d3ae299970d1b57249402d0bad4a6497f15654b0e0d0d74026,51666860689
20180918,"PAYMENT RECEIVED",1252644813,0,103cbcd7bd38a00cf55b0764df48fc7d363d903125b298016e82b6cc95666fb1,50413536607
20180918,"PAYMENT RECEIVED",1250153589,0,a780444173833f3e1d2fc921cb8b215fbc5b74ba7539e3ef04a367aa48a38480,49160891794
20180917,"PAYMENT RECEIVED",1257944329,0,463977ef76410ec73cf5e3815013ecfbd25370882b16330931f5042d51f65068,47910738205
20180917,"PAYMENT RECEIVED",1250000000,0,49d7ab8d9173db4c811771b61ad72f11328566fa542090adc17d15181a3ee0ab,46652793876
20180917,"PAYMENT RECEIVED",1250899321,0,c754b20f8de6f28591d6edfb68c6d7ec748667cdce2726ca1b9dc9337e63c005,45402793876
20180917,"PAYMENT RECEIVED",1266841612,0,8de7af5723e43d05cd2ad56a4add9e4a7436bd4685da536a86378dbcaab6c387,44151894555
20180917,"PAYMENT RECEIVED",1261862001,0,c79bd32b081ef11088a788a8df70f4d0bced07a46543583c83fadefcc5e1bf70,42885052943
20180917,"PAYMENT RECEIVED",1264224563,0,128f0239c64f514a3aa562684e4fd16a040b16c8fde9bc87e9b0f69d9641f3bc,41623190942
20180917,"PAYMENT RECEIVED",1270414954,0,5055a5b34d295ad2703acde57edfa1ac37b9451c7cd3f5412f5246421b3cb2de,40358966379
20180917,"PAYMENT RECEIVED",1255331351,0,5680620f6f7791f6439f5bf8269787c317afcf87de4928d88b6eb3d69e887a34,39088551425
20180917,"PAYMENT RECEIVED",1272183447,0,17f6f09d25ec3e5c93ff28ab1e5f1944213f0b16dd26e8d7b4a9b2b004fc8874,37833220074
20180917,"PAYMENT RECEIVED",1253947383,0,d246a596e8bb41f9f3d61391cc6641599a93fb6889c6539abd00034d86689a5c,36561036627
20180917,"PAYMENT RECEIVED",1258915247,0,46c6ae00e8c29db3ec7c894e23ba4c9f8e07f5ab70b506700d184c8ef4018a71,35307089244
20180917,"PAYMENT RECEIVED",823,0,743f147f5ab5aa424df24a303443b498693e2d53c1db1f9371c6846e07e973a0,34048173997
20180917,"PAYMENT RECEIVED",1253240341,0,df6420b817c5d57efa76d96f9dbbff3bb0b08cbeeead6fa3d4384a067c29c97c,34048173174
20180917,"PAYMENT RECEIVED",1250134293,0,2c4e7f67a1b0e4db79b0c16c7397ba2bf5247f0f2eed048068ef9f61b33f3359,32794932833
20180917,"PAYMENT RECEIVED",1264029468,0,0b2e01529e7cfab623b1ab46c455d0b61ec6f7e6308af647a0468b2de55d5f9a,31544798540
20180917,"PAYMENT RECEIVED",1263672318,0,935ddf7e336f07f0782a3f2f37e6f8be76e885b735b4802cc694d724040a52fc,30280769072
20180917,"PAYMENT RECEIVED",1252704920,0,8cbb06232d7661f2a91d32047bfa7d51e85d1094273a4bb7fc691f383843e45e,29017096754
20180917,"PAYMENT RECEIVED",1250002508,0,4a3e84bd1cc7971c1b93da2f06052b2fafde5dd4e592aba50e4b97a78ee67f1c,27764391834
20180917,"PAYMENT SENT",0,-30197866477,6c494b52dc2da1e243b441c7e742c9c991a3f563fb297b33b688522689445daa,26514389326
20180917,"PAYMENT RECEIVED",1272760202,0,84521e9701ddcb6ab774a78e72eb87850d6469525ee915a70067fd901f0ac11f,56712255803
20180916,"PAYMENT RECEIVED",1253273844,0,55caf1409f2cfab5be5ea84d89f3094f2601896100190cbe94282e400e0bfadd,55439495601
20180916,"PAYMENT RECEIVED",1250935399,0,cdb04ea564bfbce76a92095b2dfe0d78b9212e8d77d993545d8488c6c9fb7e4a,54186221757
20180916,"PAYMENT RECEIVED",1256977062,0,290d09289fc80ae307d2820922963e2c1c40e7b3b6ea476c987c885e0e77d3f7,52935286358
20180916,"PAYMENT RECEIVED",1260358271,0,158cc0a11192e80ecdb07fe8278b809854a5d1309c89f10ae8c9fbbe61e714ae,51678309296
20180916,"PAYMENT RECEIVED",1270717265,0,881dd32a2fce547115349b8346d873ef6e35d30d25a74f8a9fa8bde16b42b3ac,50417951025
20180916,"PAYMENT RECEIVED",1261617403,0,79a4213196c74ed30b37435924a148266f65d81928008992e85b395ce87f7e96,49147233760
20180916,"PAYMENT RECEIVED",1260345286,0,975a00aac4d12e7fb8cd8227bb5b77855f3181706fdc359fb87b0387f5f43997,47885616357
20180916,"PAYMENT RECEIVED",1256480890,0,abe62899da3feb6bae5ab7fed1aa4adf4b448cd39650a4607d0916c3dddb79fc,46625271071
20180916,"PAYMENT RECEIVED",1261439132,0,c62f998c677385bdb839d2c0f688bcdcae19a9a3109f8bdf9791bcf7a60f4576,45368790181
20180916,"PAYMENT RECEIVED",1251767528,0,bf6318419ca500907ef37ee7743ee920ff50c10a3c277101dd7fc5c40e94a9ed,44107351049
20180916,"PAYMENT RECEIVED",1261412072,0,f02463c3c2b5d782cbc66afd9e054056fdfafad66ea6c509168a4a3094db48b5,42855583521
20180916,"PAYMENT RECEIVED",1251002666,0,5836fba7a71400c9c58a078b4cbc9ad49dd69b4a7c74bca58f9dfbba059ab02d,41594171449
20180916,"PAYMENT RECEIVED",1254459154,0,1584113c9777a1274d49b0bd40feef74d2752273b46e4fe7458274b0616efa3d,40343168783
20180915,"PAYMENT RECEIVED",1250718716,0,8f492f42c4a55b4593fdbaab9e68bc2db3d4aa42f00ff8db7d92bad085c8810f,39088709629
20180915,"PAYMENT RECEIVED",1258611533,0,8704a3a53c0d6ae083aa86c71ff5c17c7a9ac820bace3a92f7019c21e1812107,37837990913
20180915,"PAYMENT RECEIVED",1273133777,0,ad782e778d5845007c80c7c7bb9d115924a92833a105cb2efc54d5e4b8eea24c,36579379380
20180915,"PAYMENT RECEIVED",1261073666,0,abf630c93031561750e4d976cb54f06ad2d688228c7d3082c877d7af7e9e6b71,35306245603
20180915,"PAYMENT RECEIVED",1254632864,0,99d188d147165dd58f29e05f8d9ea62672e7afa7b137524961feae861d5fa00c,34045171937
20180915,"PAYMENT RECEIVED",1251009830,0,371e184c224bb97fbc9e61350ee65cc1d884d0e865ab1fb0cd3d9e7baac55298,32790539073
20180915,"PAYMENT RECEIVED",1258195324,0,051dd19558379755420aba3d5bad35f6e18d2664daacaa47e27a81966566689f,31539529243
20180915,"PAYMENT RECEIVED",1278665408,0,2b219c31e6ecb6c2f4276c05b2f474538707f3edab857938cf037214a0e53cda,30281333919
20180915,"PAYMENT RECEIVED",1261825741,0,9b75456e826859e5516ddbfb59d7795ec1f63f58a79db6aba4a239e1751048ae,29002668511
20180915,"PAYMENT RECEIVED",1250252038,0,7ca8edd33e6940b6a581d7a8f4de75210fd7cdbe8bc0203bbf20cf740ccb3379,27740842770
20180915,"PAYMENT RECEIVED",1250876045,0,553b249a3111b0fa3d2c1dbcb8c7c0c591cf222d5b25fe7e1b07e78a94bbe110,26490590732
20180915,"PAYMENT RECEIVED",1250203105,0,e954ec968cd64ffee5d25133a0593c14e5a04d179e4380e440a3f0762d7cfde5,25239714687
20180915,"PAYMENT RECEIVED",1265279615,0,e41eaef1aa6ab4ed0e9386e663c4fed31a63a3772ccf8f7c201c43df6713ea6c,23989511582
20180915,"PAYMENT SENT",0,-18937824214,6504a57a946da9bb4ef7e8d1b606f0fa7da8519a82bbe300f46287838445f118,22724231967
20180915,"PAYMENT RECEIVED",1255421051,0,3d562d0a554639642af9e1be186719ca4847a2f8bfb10834dedaae5337b795fc,41662056181
20180915,"PAYMENT RECEIVED",1252317911,0,a482df5e5b8b403b514058f24a8b7f44608ffbe2b62b38ad3037b8b9716e170c,40406635130
20180915,"PAYMENT RECEIVED",1251226175,0,6234c902dcf036386071ba17a72db5278e8fec7e310c6558445f2482e125e45a,39154317219
20180915,"PAYMENT RECEIVED",1270325492,0,b5c6b2ab08689347a3d48cd3b8f7b687f145f80264ad2202d6779c7e83a653ca,37903091044
20180915,"PAYMENT RECEIVED",1255959578,0,4d0094699abd70bb78285dfea016579bb69952d6bf56e321544322b1b0878191,36632765552
20180915,"PAYMENT RECEIVED",1252790767,0,4a6f8198db61a926e1b1df9609b392d4d456d22b68e7951fc578fbac9eb4b8a3,35376805974
20180915,"PAYMENT RECEIVED",1266837430,0,4d2edad2637954567150b1749e0160cf202da1db97ade449470ebf5d6ecc4bc9,34124015207
20180914,"PAYMENT RECEIVED",1253137922,0,98224b629071984107bff6c29ecdddaeb73a018d5c96d4871e7c3d8eb43e5208,32857177777
20180914,"PAYMENT RECEIVED",1265671302,0,fb87b5356072f5432b0afc839787e357ba3f921aee1501d8450f8c26cc21d3bc,31604039855
20180914,"PAYMENT RECEIVED",1261234324,0,9d301e57ed6eae872cc831a5cf37d2e31a37d391e7d28da6c7154013b2f976d8,30338368553
20180914,"PAYMENT RECEIVED",1254137980,0,fda29ec50ac8249099c766870bff71be26c5a0f2dba20cd45772d784724d6751,29077134229
20180914,"PAYMENT RECEIVED",1267438067,0,f1af17347854aaefcb5cc7f29eeb132797d4b775804cd6e2100fb131b75ec871,27822996249
20180914,"PAYMENT RECEIVED",1253007776,0,e32d15c8df39c00a2afca2370dd3922aa5b62dae9c8c48a584a1d2ddf4238ba0,26555558182
20180914,"PAYMENT RECEIVED",1278504411,0,8c31c83065f8ee3c38768d7b057590b67bcb97cd3a1a25d55218d1fef1ff12cc,25302550406
20180914,"PAYMENT RECEIVED",1284306909,0,c38bac42485a20740cf102e830d342e9255a2e5589e3a8f8d85b366dff31a174,24024045995
20180914,"PAYMENT RECEIVED",1270965074,0,c93c42dcad70b3145a10a2661da63d67bf4596aef6e411c267b3e918155a7a77,22739739086
20180914,"PAYMENT RECEIVED",1260067555,0,b93848342f0d53b3c285717415c20c0b2eb4897ee46c46c259c4be315672e6fd,21468774012
20180914,"PAYMENT RECEIVED",1272877444,0,fd7be685cab127b49b2e15946931265044b3074a92aee13e99287fa81a6613c6,20208706457
20180914,"PAYMENT RECEIVED",1260695434,0,b4115949c50b95ace6ed04c098acb9de1ceef5e222d20dc59274648d774e4e58,18935829013
20180914,"PAYMENT SENT",0,-29094769910,c7c9cb680c76dc5daf742c8345e7fec9dfa0cb5f0dc8910bc7da7bdebe705f5e,17675133579
20180914,"PAYMENT RECEIVED",1262371934,0,ba31cd04304ea9e0886dfc86125541a08102d39f87c452cfea7a0c62ac3c6240,46769903489
20180914,"PAYMENT RECEIVED",1267077686,0,526b9b82ffba7e84a188218b87bd8c3448d49a609dcc019cae8bec654bbddadc,45507531555
20180914,"PAYMENT RECEIVED",1264639554,0,519dc22e900875660fd54103cc8397b0dc8060bd5d31db3c1c853f37c54eb685,44240453869
20180914,"PAYMENT RECEIVED",1250381240,0,41260c939033fc11d3cf6b4078067bc6d2dead4914bd0ae73c3a4d5ba91c4e8d,42975814315
20180914,"PAYMENT RECEIVED",1252203154,0,c7a7182ef2136e9550a90ec5a2f08f228dbdfe2b93df7e3daa9c2cc1a77ab682,41725433075
20180914,"PAYMENT RECEIVED",1269487575,0,baea55abea54c9e735a7a6b37cccfc6f5ba3cce8b4ca34c9fc672b5eb6f612da,40473229921
20180914,"PAYMENT RECEIVED",1264914242,0,c43a54873b3fa3edb7e9a590c96bca45cbbdaac33632fe165d129c3f18c12743,39203742346
20180913,"PAYMENT RECEIVED",1259101374,0,278aa30d84d35af345dd579e982f6af13c77f366272483a6b543ab7ab03fd576,37938828104
20180913,"PAYMENT RECEIVED",1269558383,0,672c422dcef08f557275cd8c61e0274b5bf7cac27d12eaaae41a01c47f64226c,36679726730
20180913,"PAYMENT RECEIVED",1265349611,0,3b506ba94cc4e9541f719167b6648b49af05985fbbadfdeef50db9dc396690bb,35410168347
20180913,"PAYMENT RECEIVED",1273400557,0,3b535091fd81a0c057224103f3a6b9a3b63287753d39cfd28d94f48c21c0981d,34144818736
20180913,"PAYMENT RECEIVED",1255909458,0,a7d56a49a7ede9c0704149d4e0cea9da7f73fa1518a154cb6148a64a74479214,32871418179
20180913,"PAYMENT RECEIVED",1254361137,0,2df28ae0df46159d0c3d7a5c81d7f90d0b47e1e5391d0a5c76d25a4e1f1500d1,31615508721
20180913,"PAYMENT RECEIVED",1266377674,0,02ece0071ca2624c1f95667f6ce51aeb8a8c7f21db3193272fc17411b9ef0e71,30361147584
20180913,"PAYMENT RECEIVED",1275964885,0,3c6b74d4877b79eadba941010b77182c10a1824f440add0006ce5a82c04d0ea5,29094769910
20180913,"PAYMENT RECEIVED",1269107447,0,6fc81d07d1afeba103f90c7ca14017ac14891756f8cc236b0f26748df6c60a6c,27818805025
20180913,"PAYMENT RECEIVED",1290669709,0,2f24af6f4d79834b35d45d93322cb0a60c310315a25e2a40933e44e3aa70ccde,26549697578
20180913,"PAYMENT RECEIVED",1257494591,0,25be9e2f62adc74165683e6bb236a33ed878d0ba09e4f31f7000eed5e8873f8f,25259027869
20180913,"PAYMENT RECEIVED",1255669056,0,1f83c52668e3677e3946fb5faf7daa5f4bccf219256cb8e7c48283f0728efea4,24001533278
20180913,"PAYMENT RECEIVED",1261517549,0,c06327cf0962127512039ba80e76afef4bbf8d5ff75f65f3b3b168c56ba49745,22745864222
20180913,"PAYMENT RECEIVED",1260159596,0,69f164085f2841cc7ff9dd1badf0494920b576a0f734c123b1ae2beb073d4e15,21484346673
20180913,"PAYMENT RECEIVED",1252695752,0,3550871dcdb27dd3cd24903d04dbee531c12b9fd9b92ad987962991975f54539,20224187077
20180913,"PAYMENT SENT",0,-20339604694,f18602b37a1f7e48e47d8a96487306bdd2b219e1dcb65e48104073032bcac8b8,18971491325
20180913,"PAYMENT RECEIVED",1275125569,0,141de0fdc39d9ed41f7fc3f76c9ea502c1773cfb2ad059d79af6691e01bcc273,39311096019
20180913,"PAYMENT RECEIVED",1250863778,0,bc0469cb76cb65f83656b60e14c08c9fe55929a6b8b37f67716357d84b3c5f1b,38035970450
20180913,"PAYMENT RECEIVED",1253453903,0,0d87de720a301d72e91499ad8ffd80486fca59c60f4fe92083345a6f27545079,36785106672
20180913,"PAYMENT RECEIVED",1256898992,0,08853d5a3b435e61e9c7928b6f7d563dfd5b553d994c4ac668146e985c4a7329,35531652769
20180913,"PAYMENT RECEIVED",1264319586,0,b08945b0d3c7dad21d39047b88594a6cfc7327546a6308dd1c03211276c9934e,34274753777
20180912,"PAYMENT RECEIVED",1251183559,0,44fc645cedb892742ced1f4e6ead938d64a390b0dc93585258f8ab30535fadc0,33010434191
20180912,"PAYMENT RECEIVED",1266454115,0,ccbd1fe7646e088b72a5f3f2d91364e48f19fdb70c2fc8849e905369d38da353,31759250632
20180912,"PAYMENT RECEIVED",1250317164,0,48c2bf94bd39209f210e7ba0bb05ad5f44f0373bbfba1e289954e5edfb9a796b,30492796517
20180912,"PAYMENT RECEIVED",1256301580,0,970b44f0b5d220551cd40c6ee93dc76de2a1317b335a4cc1d3feb51f2c1c70cf,29242479353
20180912,"PAYMENT RECEIVED",1270305615,0,53462f106c7a853eec0e8df6c7fd2d9f369fe3304ac700fe164af48c1bcc1f2f,27986177773
20180912,"PAYMENT RECEIVED",1288948870,0,547c57f196ab4284a87c6a9ccc1ce7fd9cdb1bce0ddd1906489e5f9db3730755,26715872158
20180912,"PAYMENT RECEIVED",1271953663,0,05bef0724eb2cb093260536d6f8e2e83e785ecdad16214b1bd4f4e40efb72281,25426923288
20180912,"PAYMENT RECEIVED",1257127734,0,b183e041cc6b9ed662967c5c8b9e3b8599a67003693d28351cb0a34c5f7afee9,24154969625
20180912,"PAYMENT RECEIVED",1250000777,0,0d42b6af5893749800224457b86388bc042e6748b26f1c4158b8be58947a549c,22897841891
20180912,"PAYMENT SENT",0,-1263515815,81f4300a1919e69ab9d2665285ac857f87ffc2fe06030a089f0bcd9277debe1f,31714842772
20180912,"PAYMENT SENT",0,-1250679449,8d6f9872f614a25d26f67cde3aa0f65cb06401df7d99a73f17ae17ee67aea643,30464163323
20180912,"PAYMENT SENT",0,-1263546547,d35c2cbdfa26045ac1ca3461a535bebeb9ebf25d56b0ff32a6e4a271ea6cd283,29200616776
20180912,"PAYMENT SENT",0,-1258681418,bb7dd7fce92608849cac3b4297041944b588392958d932ffb89487bce9b7beaf,27941935358
20180912,"PAYMENT SENT",0,-1254907308,27db461c1559fbd1ec92c240715ffd68ff76eff1d42b619d806cd89b6be816b9,26687028050
20180912,"PAYMENT SENT",0,-1263659385,fd736b3829fb178a5dbb448c9a9c829417519147eb1153e77a992abaf218b00c,25423368665
20180912,"PAYMENT SENT",0,-1256761664,2b4bdb06c1fa9a6badb30e73bf291ece4ccb820aed517b52955c6add469e023a,24166607001
20180912,"PAYMENT SENT",0,-1268634443,ba09e03baf678867702958b06a6357bf915671ea66779d7a8a2226f85f93cd47,22897972558
20180912,"PAYMENT SENT",0,-1250131444,5e87094db2dd00c5126a11152fe6ca8554daba68860721ba42b896a07fa5367e,21647841114
20180912,"PAYMENT RECEIVED",1280085357,0,d1b252c39b933c745752fec77c60a42478d37af0206cc4a206a66fa720f89e52,32978358587
20180912,"PAYMENT RECEIVED",1251982096,0,744584709bc03686f5901c5d214b883651c32e92c9a30be5a0e7f343bcd991b5,31698273230
20180912,"PAYMENT SENT",0,-28980290869,cf91681d5550d0063b144352e5151109d3f4cda54914772823ee78c8d4256ee0,30446291134
20180912,"PAYMENT RECEIVED",1252220644,0,a50ad2c972f043aa918a74b45790e37734722fbec4f875d64c35c4f0480fa978,59426582003
20180912,"PAYMENT RECEIVED",1259864433,0,91035f5e3c29cc2ee3049164a93535eba9562ed998f43a4b0958a6443fc23df7,58174361359
20180912,"PAYMENT RECEIVED",1251883152,0,7e73edaceabe736a50d37fd16dff2e67054490ac3e7cff7325e615c8de5ab30e,56914496926
20180911,"PAYMENT RECEIVED",1259513681,0,81ffb96a7cd22d3d0934689317ae8a55bd58c2c1048a753778a329ebf441da98,55662613774
20180911,"PAYMENT RECEIVED",1272279995,0,e5e5d94fc56a92ecbc89a51ea874d6002511b65700bfb3d4eb459f30ce89296d,54403100093
20180911,"PAYMENT RECEIVED",1262540627,0,9ef7b861950e21b74c88bd38194be95f9f96a6fee26a3580087724aef5a685a4,53130820098
20180911,"PAYMENT RECEIVED",1265581972,0,1b0d4ea54c7f532d8e315cba99f5f0f39789662f0bb4a61e327d51c0396272e8,51868279471
20180911,"PAYMENT RECEIVED",1281162441,0,f7767be274213171802dd51eef90b9bebb8bf9f516fc89b585dce619fe561a72,50602697499
20180911,"PAYMENT RECEIVED",1254907308,0,6b7a6439da1d4bc6bdb35b04042b0f9b8d33f9c3f9deb0d0d4d99569dccba379,49321535058
20180911,"PAYMENT RECEIVED",1253775289,0,3924d78ae7752cdef9e3bf4a0f29b5c07e03f86b97e4f764cb542ed81ba3e3ff,48066627750
20180911,"PAYMENT RECEIVED",1287871696,0,a998bf187d2210ea95adc961cde6410f0669887437d9b878f97dcd417d96b9ba,46812852461
20180911,"PAYMENT RECEIVED",1256761664,0,6c19569aa2789104e421dcb4d4e7707cb20f6da7932c9f1e016ba51ef61644dc,45524980765
20180911,"PAYMENT RECEIVED",1273239167,0,002be29cc6f1a08d104e7ca212d2d5b3d366e3df199af14a0a053eef74ffe528,44268219101
20180911,"PAYMENT SENT",0,-30166890226,3cd2278db7b64ea50dda54a0142ffc085611f16f566b2270eeeafead1f5486db,42994979934
20180911,"PAYMENT RECEIVED",1250493589,0,69a537c509554f7abc003a5f4cb9f3377b17454a3e2039710344abfbacacf8f3,73161870160
20180911,"PAYMENT RECEIVED",1250612738,0,95db33b0845b905268938107e654b4090242d155b65f3d82a40c1022603506b4,71911376571
20180911,"PAYMENT RECEIVED",1258681418,0,2cd156c64891ca30ba461c45e33aa737b2cefaaf68d5ea176a4f602521d60a93,70660763833
20180911,"PAYMENT RECEIVED",1250131444,0,9f5b7784cf337bf6bf39f6789f047734752be2f09e4046d6c1f090a823c72887,69402082415
20180911,"PAYMENT RECEIVED",1250003939,0,b0fbd2f5986dada8ddf1001df3584705cfe5185f662d34595287a70d7c153062,68151950971
20180911,"PAYMENT RECEIVED",1260899088,0,cd68efab2192b218949cc09233cf8a959433339815d25d07d32802754bb50f7d,66901947032
20180910,"PAYMENT RECEIVED",1251629995,0,a18c5918a485886037f63263057b1a210762db5b6735876a9b58209355ff1bb1,65641047944
20180910,"PAYMENT RECEIVED",1266990385,0,1feb9684e0e9d74ad6b938228dc77fd2afa5c26bd7472003366a71f215f3c529,64389417949
20180910,"PAYMENT RECEIVED",1263659385,0,f3620ff8514e31948f7f953bdc0ec3ca6e36f9e779a55d7307a1673b19dad288,63122427564
20180910,"PAYMENT RECEIVED",1263546547,0,246b140fbb138e984f6d3acc2a292d0e32eef025ad90f4379fe92a4bd2fc22d2,61858768179
20180910,"PAYMENT RECEIVED",1292391976,0,bfa792c39aa6044994de28898cf0d3b9846c6b8d9776916f6cbe745a093fc784,60595221632
20180910,"PAYMENT RECEIVED",1282857162,0,118698c96b860fb54a5b559ec390de26f4771ee45cb94912207c18b089e190fe,59302829656
20180910,"PAYMENT RECEIVED",1270891204,0,ec037d097e169a4d8bac1017566f49d230b4f1ae0a9c159d39b1e466575b9e72,58019972494
20180910,"PAYMENT RECEIVED",1299556295,0,415bf372c774745e22a92a1447e6af1e8b813c19236c233e074219a85a787ec8,56749081290
20180910,"PAYMENT RECEIVED",1280426237,0,17dd34dfdb8dcc51a54f752eb24e8076a3e2436de342ac5890392fa5536124c5,55449524995
20180910,"PAYMENT RECEIVED",1255390305,0,5c4d0d9ef47d87d8127bf71811b67382b633a37fb69a42f9abc33e95f46394a4,54169098758
20180910,"PAYMENT RECEIVED",1275415141,0,ee3edd26385c8d6eddd6b4a38274c26499e252dd42f23e1f9a56177049625fda,52913708453
20180910,"PAYMENT RECEIVED",1257274695,0,922ab47bf4caf764e36e99188c88df06a72e7874f964e82d21bd1b0f1e3d3a5a,51638293312
20180910,"PAYMENT RECEIVED",1264680211,0,2d5252014a827691c3379d0cfa5734ddb7a36861837dd45469b8ed41e3e2f479,50381018617
20180910,"PAYMENT RECEIVED",1250628167,0,e4d0d4f10c44ef7a8647ce3adce74188a9be40de17299111f02589792d8192d3,49116338406
20180910,"PAYMENT RECEIVED",1253965080,0,4a95b33c121daf04e6b44425558c4964d347038184b2783f5658ffe6f437c0d8,47865710239
20180910,"PAYMENT RECEIVED",1253193865,0,0bc5846f1d248dccbfc7249ba891827575485763abb6ac86f4cf7df1d06d6c3e,46611745159
20180910,"PAYMENT RECEIVED",1263515815,0,68e47df395aad4005bfc50ba843c167dd7195b97412f3a3256d90336c0fdd4d9,45358551294
20180910,"PAYMENT RECEIVED",1254380280,0,4673b03b2ccfa11897373c2fda238a1fd913411a116c6bec093aa7b2ad4d897c,44095035479
20180910,"PAYMENT RECEIVED",1273359567,0,f168af915c94006be83d8f8a28e3d383c9ba95ef6b7b515807f10e24d6d423e1,42840655199
20180909,"PAYMENT RECEIVED",1250527932,0,4ad7b9c44a2d105bb02391d95236b9bd18a6fb35fd57f63cc2faa7708f680a03,41567295632
20180909,"PAYMENT RECEIVED",1256089985,0,e605b971708a4ff4f61dedd084fa9fd55486d0dd03fb0312c61bca7ad10f2c12,40316767700
20180909,"PAYMENT RECEIVED",1252913414,0,8b819ac3a11a0f13c72bf3a8aa29c67530cdb5b5bbbff08d63699611da6949bf,39060677715
20180909,"PAYMENT RECEIVED",1251009818,0,1ab8a4451604ec31b77736c668d0932c91e847edfd2f20228edacc207e21c19d,37807764301
20180909,"PAYMENT RECEIVED",1256083187,0,3ed81bf500cd3bfd3c227f97ac8c2d6ba8a78325cc56e96f8887fd6019621f61,36556754483
20180909,"PAYMENT RECEIVED",1250679449,0,e1e73b4d2ba11f2e079c3b7d7b1ff2e80b30fefbccea4f4cc21fcddcfee268ec,35300671296
20180909,"PAYMENT RECEIVED",1250800959,0,67338202bf15f8fd35c36b070c050eb9c6615dae7af5dbeb6c473d7035295563,34049991847
20180909,"PAYMENT RECEIVED",1250665126,0,dba118a5bf27737ccc3b5fb067312ae2443e8222ab2d97c7341ef6ead26c0aa3,32799190888
20180909,"PAYMENT RECEIVED",1250000000,0,dfe11191595626027f78fe16057c3b37af101b0234a13f38c03a656d6d0a6a96,31548525762
20180909,"PAYMENT RECEIVED",1281691893,0,4e6c8f80b3368ae00e62bfbc5b6fd666bdd7856b5cd862bdd2774cc1707398bd,30298525762
20180909,"PAYMENT RECEIVED",1317420421,0,b890093e8e07c707c79a6c5e4b9a75d3bdac60139f8afc0b1b092ea5696b50cd,29016833869
20180909,"PAYMENT RECEIVED",1252660390,0,e09e1faab10e8ac117db13d3936cd2644a91dd1482dc0d641bc11166fdd61a11,27699413448
20180909,"PAYMENT RECEIVED",1255673624,0,083879bb60a38f8b4bd6e96cf7068138b8f7424d0f0d65f88b0ba25681e8cf4e,26446753058
20180909,"PAYMENT RECEIVED",1272453811,0,e7ebfaf916f8ca7a507bc18fb8a74d9ac6e0455871f491268c351eb534358bdc,25191079434
20180909,"PAYMENT RECEIVED",1256875709,0,b0809b5c6455334573fa59724dbeeb5cd26526133d2d446e1c2bea00ea156161,23918625623
20180909,"PAYMENT RECEIVED",1257770099,0,36fe1c25060ced6ea2df140d7b038683b4f0e720c1af8a336d172f74a271d697,22661749914
20180909,"PAYMENT RECEIVED",1250461247,0,f5b59af012cbc473eda5f7ae412b0c0a8609787114e66fa37e6e012c90b594ff,21403979815
20180909,"PAYMENT RECEIVED",1250034465,0,ec9a9c0460d3d39f075828706dfc8b90b90715606aa639454092937238f80c91,20153518568
20180909,"PAYMENT RECEIVED",1250490544,0,feaf98f690fa58a19234ef13564520cbf3dd56eee06140622831382ed33d45dc,18903484103
20180909,"PAYMENT SENT",0,-26619530491,2155d82b33347e16ca4ba3489512ec145e65e1e969f3abc77cf931d20dca9073,17652993559
20180909,"PAYMENT RECEIVED",1259367680,0,073b4ea2a6c56470d3d89b8f4f7557111c7d3042c223913c9fb4c2e431ce232f,44272524050
20180909,"PAYMENT RECEIVED",1250999115,0,082c653653b26721b8fc5e1b1be9520baca71821b5861c330ebdb7ba0d59cf0f,43013156370
20180909,"PAYMENT RECEIVED",1268634443,0,df150b90222ead5b2043d567521f6c284ad4b3b8709ef098ed72479d2df074ba,41762157255
20180909,"PAYMENT RECEIVED",1254944239,0,ec2ff7f8aca2e0f739e08dea04999591b64034f2e8a33aa004cc7e5655ca61a6,40493522812
20180909,"PAYMENT RECEIVED",1266236329,0,f8f1c302d8b024a00e647a754b1a6e5a6bc4f1bb9813f3ef068840c9bfbd3240,39238578573
20180909,"PAYMENT RECEIVED",1250009264,0,25689da43c05a324565e3fa8f1fe39005c1dbcd5560956851646f4b849b8a72a,37972342244
20180908,"PAYMENT RECEIVED",1254803731,0,82164a491630acc3311b958ab0fabf4107152c5c4c0004d4e56cb436b07ab46a,36722332980
20180908,"PAYMENT RECEIVED",1254148749,0,e01dcc1847f1c7fe9a35a3d57f81d7abe7e01738bdc89d693ad499602e1ba4f3,35467529249
20180908,"PAYMENT RECEIVED",1253322272,0,755637bc1e40c22763c82832d538ccafd032004957debe7aa09f816c2f4e480e,34213380500
20180908,"PAYMENT RECEIVED",1266854670,0,3cbe4ec89cd6436fc5b4902144a59c9e26356c58abb9bc2efc312dbb4a8d358d,32960058228
20180908,"PAYMENT RECEIVED",1270452615,0,77ef40199df849f40416599860d20293d9e47c7c5cfd57e64d39c897b6f6a8d7,31693203558
20180908,"PAYMENT RECEIVED",1279219221,0,3c55b2ec1834c3f46a35e2607ba0f054a421f8e4e53a54d1e9df2a3c617b3fdb,30422750943
20180908,"PAYMENT RECEIVED",1257858949,0,cc10a80a1730687466225eb238c0526f433001811258fb39327d6998e223bc81,29143531722
20180908,"PAYMENT RECEIVED",1257183934,0,c1c1f779f29bacf3998e41d79cd8dd49d4ac6041ede29a60424368a2c43abf85,27885672773
20180908,"PAYMENT RECEIVED",1269617019,0,270c607fed573380a34a8b3f83bf96286935fbe96e1e737d033588f202a1e4db,26628488839
20180908,"PAYMENT RECEIVED",1253072328,0,ca915e6d0443e9532b69e59b65b19ef4be52ddfaaa5c36046360f10f113b00ee,25358871820
20180908,"PAYMENT RECEIVED",1255148167,0,9e46749673ac885f5317e63ac438671a879c6e9441392c4e5a55b09bdd81d795,24105799492
20180908,"PAYMENT SENT",0,-30361614377,bf2e65ccae84a1df77756ca838196b902b179807666058ba8f7b680e35499f05,22850651325
20180908,"PAYMENT RECEIVED",1256152382,0,c2706e3d09c7d8b5ec340e439edb52d5d7e86e3f9932e3f40cd58f881808734f,53212265702
20180908,"PAYMENT RECEIVED",1257369336,0,9b95532196f0c4d906388a6e0dce7a9befdd7a8189ab55d043ff7cde90d0d284,51956113320
20180908,"PAYMENT RECEIVED",1253271584,0,586aea5e9fa1efd9f35e6c7c657bb2b76ec3c10551fef40f34a0b6d240780939,50698743984
20180907,"PAYMENT RECEIVED",1250048085,0,a98eaae55f3d8124891456a423ce45511ea237e0f5dee8b41a5af758e0c0541f,49445472400
20180907,"PAYMENT RECEIVED",1258797126,0,02ae4450c3097ee126960e5bcb40004be56c2dc2e5f71c7f5c361d6c55d19155,48195424315
20180907,"PAYMENT RECEIVED",1280121977,0,983a71847e7c60f4aef6b1969625fdae05734de340300c3e46ce5f785bf11fc9,46936627189
20180907,"PAYMENT RECEIVED",1293666036,0,816650119291f23c2dc9476df23c893af6ac8fba2c018ce789c61ad5354fb987,45656505212
20180907,"PAYMENT RECEIVED",1265169640,0,2e60733d7334f92e38a7a4aaa0468275a3d33541de46a23dd325e20c7d315418,44362839176
20180907,"PAYMENT RECEIVED",1266142282,0,0faabe74b707718249ac8c7722c98cfbd99bfd3795c2473af50717ce75dabcaf,43097669536
20180907,"PAYMENT RECEIVED",1295915492,0,3b0fa5e33e2b298a6de4cc434e3523771f2c2e152ce3efa08c1f957a2f6ebd18,41831527254
20180907,"PAYMENT RECEIVED",1273910468,0,ed0cb3e14c85ed68b892928b34a6cb350fa8666f172996eddfbf0ecdc79a1e7a,40535611762
20180907,"PAYMENT RECEIVED",1268532202,0,ae99817b095dfe25447b1414160d9d685a7d87924d8c65f6578cb37b8dc1dcc9,39261701294
20180907,"PAYMENT RECEIVED",1259656839,0,aed12596e9db97d81e050b181ae64851da10c0b7ca9bbdf137180378aac4ab1d,37993169092
20180907,"PAYMENT RECEIVED",1250020836,0,c4e829a98b67a3ecb5ce2220b85f684df7f2fcfa74131436614351c27efe8fc5,36733512253
20180907,"PAYMENT RECEIVED",1267237679,0,b2d7795971f189d47ad9d04800fb44ca2e5b5b7bb1a2b07399d6437af07e4284,35483491417
20180907,"PAYMENT RECEIVED",1260025448,0,e7bd6f7b30a2b5be120a130db801199dfaa0393b0030c9ca24bc3e53c7a900b2,34216253738
20180907,"PAYMENT RECEIVED",1256256790,0,4b68360cac864ff3d55e858939ac6a4a7f2bd502c4145935ceb2397da04d8c0a,32956228290
20180907,"PAYMENT SENT",0,-30452025453,2634d20426e1797de814d86dad628fbad1aaa0817c4370dd2939eae04704e327,31699971500
20180907,"PAYMENT RECEIVED",1260774555,0,c77e3f2f9968e605f7fadc93da92a001b750e0cec7ff46ff4a11235cfd50abfc,62151996953
20180907,"PAYMENT RECEIVED",1260279211,0,c7405bd0acbeb9fd246f010db0f32216bf9a9188a6a3d58d0c01348ff05734fb,60891222398
20180907,"PAYMENT RECEIVED",1268978112,0,d779172aad5154c7f2076db2cf5dae0fdacf4e041231b930c0cd58527342cdd7,59630943187
20180907,"PAYMENT RECEIVED",1250049932,0,5338d28174b7e6fa7714a60a979f3d3ca8740cc983fc8f812bdfdfe775c17afc,58361965075
20180907,"PAYMENT RECEIVED",1261360649,0,fce386fec94be5f06ed369264df518b8b42329c24963b570e766f9ba9cc91c26,57111915143
20180907,"PAYMENT RECEIVED",1250179282,0,13d5d651ed54765dc2c572a1b2e4f274145671f6946fe25d2425055989c01291,55850554494
20180907,"PAYMENT RECEIVED",1250088614,0,6cc8fe56d8787f13f7eb1383230a5f8ca7a4bc62cc9c8c16b62fad47134ac2e0,54600375212
20180906,"PAYMENT RECEIVED",1275524212,0,8fa9b1ffb0cd51477b3c0ef7d4258bdecf69b75ecdac2e8c9185884506bbc360,53350286598
20180906,"PAYMENT RECEIVED",1272860901,0,5a115c7613133e190525499b1381cedc6666eeb7840304c27a7a3e91f6258a41,52074762386
20180906,"PAYMENT RECEIVED",1250374197,0,e6cb8acd3e18cb0c466070c9fcc461b48191f909819385f85df28c9fdc42ea47,50801901485
20180906,"PAYMENT RECEIVED",1257057785,0,1716cf4de80cdea7ef7be0058ce7dcd8ffe0ff088e6c3ccaeb3641190b556496,49551527288
20180906,"PAYMENT RECEIVED",1251351945,0,b5a842d89b43bc0b6974b3af389a64acae162cadb6ecb8ac449e406a7656c35c,48294469503
20180906,"PAYMENT RECEIVED",1258312451,0,7a1575fba0d941fb3f2dd9f784c7adb17be762838a9bf8b759fa2398562be6c7,47043117558
20180906,"PAYMENT RECEIVED",1272572130,0,65af48063241454dc36b9f3862b146da78089800c60da842ffc684405cdc03c1,45784805107
20180906,"PAYMENT RECEIVED",1288658196,0,2d81c6b3b283c8f7ec60ad595812a4a89ad46cc1b11c70c60c26e8f14e35e81d,44512232977
20180906,"PAYMENT RECEIVED",1259167181,0,458c5a3f6563051883ebc1a1bf228fd2e2becbbbf2b7d26822e7a2a73e3d6d94,43223574781
20180906,"PAYMENT RECEIVED",1267738172,0,260e374ea6d41fda88dc7bf33fd52e8b0757f8867646db0758bf13980d5afd07,41964407600
20180906,"PAYMENT RECEIVED",1290515750,0,bc41b3a52a91c1b396db067e4a91652679a40d55321bacb6d8c0c27b2c8f35a4,40696669428
20180906,"PAYMENT RECEIVED",1281043908,0,165b943cc611a7046df5942173f24f42188fcdc12f5b8237b61fb2e86ebfc855,39406153678
20180906,"PAYMENT RECEIVED",1290616101,0,90735b860ea403f06895a8b3a52f9e78ee03172f3e1ebe38c14dc43959013c24,38125109770
20180906,"PAYMENT RECEIVED",1300427777,0,fa3a5f83107c9a856f0634a4502719d480dd562571381fe1189fbd441e0a44c9,36834493669
20180906,"PAYMENT RECEIVED",1273565363,0,e14029f04c505dc1d723724adbff8b249efb3db4917633ad164ae863be58977b,35534065892
20180906,"PAYMENT RECEIVED",1259250001,0,fc6f5b84f993a25239a2efa2f388d21db48618991ee756d979ed19d1865f5f31,34260500529
20180906,"PAYMENT RECEIVED",1255730962,0,65654f95841cb291150ae2829ebcc86f39fc565746ef4143688b12dbeff6a7e8,33001250528
20180906,"PAYMENT SENT",0,-28026905347,713bcf7569537b91e72592c4baeaa584ad824eac0a4b8cbc15e81b6060db47ce,31745519566
20180906,"PAYMENT RECEIVED",1254820770,0,9f6ecb9c5d38a232ee4cbb24e35d4641375aef10037b74901b8ecb91867fabd9,59772424913
20180906,"PAYMENT RECEIVED",1273669240,0,c023a1cb1bbf961f43184b3aa5dfe9ebef1bb96fe1bff79222062279cd5579ec,58517604143
20180906,"PAYMENT RECEIVED",1274458449,0,a4667d3bb131231612161b7a8cd56b72f8568c0cb399a9ae240403fe2b7f3f05,57243934903
20180906,"PAYMENT RECEIVED",1250142879,0,0cd5c65d783123176e9e2dce10b04c3033fc585e9341e0d87f6beaae8aed77b0,55969476454
20180906,"PAYMENT RECEIVED",1253602061,0,b88a005a56127b1c4d70c943968e5bd1d88e1f3d7b980cd60f0b3b3258373f51,54719333575
20180905,"PAYMENT RECEIVED",1285936820,0,1ff1a46b83a9c343a819f8b65d71589c04a80acabac74c2c2707d22a73f28e0c,53465731514
20180905,"PAYMENT RECEIVED",1291366300,0,a406162c3e7df02e1ef7ac7678770e461890216a43bb9ecb37987a5179b2af9a,52179794694
20180905,"PAYMENT RECEIVED",1281313605,0,30dfeb075ae0ccd841059fe20b70ee5471d46774c4b93b892ddee3583daaad9f,50888428394
20180905,"PAYMENT RECEIVED",1288408326,0,44f69509c5efdb3b872d8a70106aa3f82893d79d6f00b22f195fc79d92e95a14,49607114789
20180905,"PAYMENT RECEIVED",1320854721,0,88eb738ef8eb1cdc6f4535e91c8cdb86970f120a65e330f8fb73235477930617,48318706463
20180905,"PAYMENT RECEIVED",1296487626,0,61800d58c35fc451898e057b0e403b7491d55a363ac0fe91268927d1808d9eb8,46997851742
20180905,"PAYMENT RECEIVED",1296544547,0,340c9366d14dcf9c5617fab373648f9ecdacd544125b723c17f60c61c57e16fe,45701364116
20180905,"PAYMENT RECEIVED",1308061637,0,b3d42afd378c928b05f456f53007baffe5435f9ccad47c62740b01ecc15e2d8a,44404819569
20180905,"PAYMENT RECEIVED",1292975522,0,6a9aea46c7d27d4cef04207b5bab009873cb2702c9897e17e836971a58e9eba9,43096757932
20180905,"PAYMENT RECEIVED",1256732434,0,4bfec13950cab8ed5be143b406f78296a75c59f1fba390ae10f19af1560fe31f,41803782410
20180905,"PAYMENT RECEIVED",1252154916,0,5951cee82ad60dddaa8db58cc1ea87d3b0d3274c9ba4ddb42428e03cb644ed65,40547049976
20180905,"PAYMENT RECEIVED",1261102365,0,033eeb6870bfe2942e9afe934808c68cf6b3d45719bb03ac3073e6015c05da4d,39294895060
20180905,"PAYMENT RECEIVED",1253881677,0,f9417a01e235fded8daa4b74e83ade64804a73873c6888fab2a5f93a322cb9f9,38033792695
20180905,"PAYMENT RECEIVED",1261637465,0,7da3c00239528095e2023a3606f2339958738bda86f44ee796db9769edce1f01,36779911018
20180905,"PAYMENT RECEIVED",1263502078,0,41813529af8817a7faa2e37bbabf6c875a1b46c3a685381744b1dfad5bb1f3b1,35518273553
20180905,"PAYMENT SENT",0,-28924563599,dbc4db577ce6ea27f7465aec5ffe28eec3d7cd06b0d0c7e95a257bf3e79f862a,34254771475
20180904,"PAYMENT RECEIVED",1260309029,0,138b8dd057218278c2189b941cd7430db54976b500f50f0ffe06de711e5b938c,63179335074
20180904,"PAYMENT RECEIVED",1291142829,0,91c9712e60f8a567d4884f3fd5dbbb8fedf3f07c4910e02639ff682b2031695c,61919026045
20180904,"PAYMENT RECEIVED",1285462398,0,97930c0bb401ff5ee0416311d4aea8ea94f135d8ed932803f35f0c6a89dbda88,60627883216
20180904,"PAYMENT RECEIVED",1277661914,0,1014ce7ffe4932310e748ed1c9cfb087b733831630ea9bb6f6ac008026841230,59342420818
20180904,"PAYMENT RECEIVED",1297334336,0,9bf84bb5e3de86da8e161780db002774ebe4b2b3797d19a8274b2e118c1fac33,58064758904
20180904,"PAYMENT RECEIVED",1259211246,0,541fcfaf4556bfb0fe3b4d9db249461b6f7ac18bbe409dff0d860ffd73a9df2d,56767424568
20180904,"PAYMENT RECEIVED",1290378315,0,2f9474c522366f7fbc7b8ca4fb9247b55a7f40c3ecf0c9bf11ab4b2480b1404b,55508213322
20180904,"PAYMENT RECEIVED",1263229088,0,0607acff5b7517e1267441f5111f34808799f5b53c4a0df07c3d1bbf34ea6770,54217835007
20180904,"PAYMENT RECEIVED",1282752843,0,bf31accd1f51fee91915620cb4a976c29955a7879d2a3d616854eb6138afd567,52954605919
20180904,"PAYMENT RECEIVED",1256854457,0,645f523d82ff21fd2cd0a38d114017a0db86ef204cc3621e7f019674e188a21a,51671853076
20180904,"PAYMENT RECEIVED",1287338636,0,89cc54b44f7eac36a8f7b852eccfc757ead5ae69c6b7838826cc59de2c8e1d12,50414998619
20180904,"PAYMENT RECEIVED",1265044408,0,fc88ea5a8de43bbae0411a5434b599f86a42bd9fd06603d15f01eed2fcab2737,49127659983
20180904,"PAYMENT RECEIVED",1260709773,0,00a7e9f9b15d3c06fad04830e89b8e27c8db172e8e5d21ba9f4720a88adafb71,47862615575
20180904,"PAYMENT RECEIVED",1255968274,0,35a6dedd232d39c272bffe5019ff619a0ffd437b8ad4a1a1fa90d78e74ae06a8,46601905802
20180904,"PAYMENT RECEIVED",1262139287,0,ac1e40834cca7a7c762f143d427e637c2707673c2b55ca04fc4fda5e549b2707,45345937528
20180904,"PAYMENT RECEIVED",1282681485,0,f01a8d4de2ceffe388c0006a0355d68c7f326d22e5b68dbdf6096ff039202e1f,44083798241
20180904,"PAYMENT RECEIVED",1251287930,0,104aa3b74af1f45c5a73ec9699717a7d3569e0e32343016a921f7b76fc4167b4,42801116756
20180904,"PAYMENT RECEIVED",1268380728,0,e4e83256f8875fe61c1e53723ceba791c67e65c56efb65232df568cbd65ce981,41549828826
20180904,"PAYMENT RECEIVED",1254090798,0,12e57c1b95e30782f0d8dbaae2767bdf0ac90b4f13f7615857b7a5d8c9538ac0,40281448098
20180904,"PAYMENT RECEIVED",1257419624,0,0164c44713b4a1aa75fdf3973cabfbba856cd95cd741be7cb30a6cdff4f2f178,39027357300
20180904,"PAYMENT RECEIVED",1256350063,0,8fb508cb47b713d012a1ad87ed073627b0590622c42d2126bf4b27062cf757ff,37769937676
20180904,"PAYMENT RECEIVED",1270547966,0,ee5327d0409d98ff4a72a038ea81366f1472a5103c687c7dfeceb571bd5418c6,36513587613
20180904,"PAYMENT RECEIVED",1250005444,0,a74f7ea89bea407a0fe71d74e24eadd58aa1f1260ac182331802fb3a0c9c0391,35243039647
20180904,"PAYMENT RECEIVED",1278073402,0,8e2cbc09582462061f45fbd4fc13ec9b67a6992104bda6655590cf5a28d5e543,33993034203
20180903,"PAYMENT RECEIVED",1255456403,0,d48bc60c5578386066b6f2df70601c071bfbd00c3d68c7063511af5dd0103ff0,32714960801
20180903,"PAYMENT RECEIVED",1265612940,0,4da0badb7482e7883fe95d1b438fed03598c03b2017fc007f4d8e1aa6114eb45,31459504398
20180903,"PAYMENT RECEIVED",1261253218,0,c2301bada0abec259733119e5465aa17784307841c836c2e49a43a196f570de0,30193891458
20180903,"PAYMENT RECEIVED",1266130530,0,a7c8d39defe8d89b029b7131f04d78f2a227474cd047154eb556e8c33fd5d14e,28932638240
20180903,"PAYMENT RECEIVED",1250000000,0,6bf51d70ff9184317ce783dd19e4618f967cc855d0f9750b6c5ada8df3af7403,27666507710
20180903,"PAYMENT RECEIVED",1253916413,0,27fbca983e4a96068a1ce2fef870d285b9324e7e519d8a9a303034dc1e216c31,26416507710
20180903,"PAYMENT RECEIVED",1252696900,0,6eb252705839fe38314ed1e4e8432b711819d2976c1d6665d578d8e41d61fce9,25162591297
20180903,"PAYMENT RECEIVED",1257122046,0,4587cba1a90ee40361b644fadc5823a2f664b8a13202e0cd557e5fb8d6c7c6f5,23909894397
20180903,"PAYMENT RECEIVED",1252718880,0,f39893f1c687438999530cacb74a2e01c9b62fdbc1c61c601288d3343340227f,22652772351
20180903,"PAYMENT SENT",0,-29045221449,1a4be560a8951aae4d53ef666d91aeb1dd83aa3ae812beac1382404850b3264f,21400053471
20180903,"PAYMENT RECEIVED",1266037396,0,d47f2a4398f4c33f9b22aedeae3b550fe724a008aa6990b3e649414586c05ea5,50445274920
20180903,"PAYMENT RECEIVED",1266512700,0,e14d5c803fa0d11614288b0de4a9921e87cdb196c3628aad93f05dd961c69873,49179237524
20180903,"PAYMENT RECEIVED",1253179307,0,fb519efcedd314ab97d370ca18b12dbc9aa3bd1d72ea2c3704fed924a43305ba,47912724824
20180903,"PAYMENT RECEIVED",1252593000,0,3aaa515ed7ecce4c27e6551058f1a5c5dd43552c14458e8f62c36eca1fdbc488,46659545517
20180903,"PAYMENT RECEIVED",1251902833,0,cbbde3136b2c6efdd6e6872b1d480d2083c6e08ad9646aa576ef74a896580e08,45406952517
20180903,"PAYMENT RECEIVED",1259262670,0,a43fc2673cbabb860dabc76bff1bbe0b7c6a74dad7118b5892e58f22f6b1f6bc,44155049684
20180903,"PAYMENT RECEIVED",1254790985,0,7ea2b9b68be254e5cbb3ed8dc3349ecd1a8ac04cfa601b913f0c3ca2a7da3506,42895787014
20180902,"PAYMENT RECEIVED",1265435851,0,5e527e4cfdd92db387134dbfbc562a8f635f6185c3665fc5e8be89cf9ec48d30,41640996029
20180902,"PAYMENT RECEIVED",1257714504,0,291e6a3d64469daf1859f8c5dc9299a220b1a6c818c8a86100c9cdec3d566fbc,40375560178
20180902,"PAYMENT RECEIVED",1263222374,0,26ef5e450df5c95a9d45f3944ca54d265691889e2f126516ed5f11de7589ca09,39117845674
20180902,"PAYMENT RECEIVED",1250078404,0,d922f76720606dae4fbb35ff5f83b286bfc2302f663227c403d64aa5fd1380ba,37854623300
20180902,"PAYMENT RECEIVED",1263546939,0,1a8eeb8856a0d9a07120fabc67deaf87057395317ea473f719b0c0fcd16803fb,36604544896
20180902,"PAYMENT RECEIVED",1251206184,0,0b52cd493b7a96a0c6e2c0687f7e4ecba0cd5bfb048b139372b288240ed48fd1,35340997957
20180902,"PAYMENT RECEIVED",1250245508,0,1cca14548e3c47f690b7e82adce465bf6b999e8a304574d952c217ae7a5d5a58,34089791773
20180902,"PAYMENT RECEIVED",1268079786,0,3a22deff9a5a90f72ec0983a1d79f5a1477b0576abdeb1fc960647c8f36db41a,32839546265
20180902,"PAYMENT RECEIVED",1255675104,0,e78e1a01aa1d8f08fc9618d080091ae4ec655adfe78d97d8d64f901de25a1686,31571466479
20180902,"PAYMENT RECEIVED",1271473843,0,4b303a1eb02a9b94687b1ddc9eab25b5e50fa755887cf8a0ccda955b7617fc36,30315791375
20180902,"PAYMENT RECEIVED",1250027730,0,ca402d7d1ca64536220070ecf99c962b80f973b7f08135b8164ed634de75735a,29044317532
20180902,"PAYMENT RECEIVED",1281738159,0,e9b822917c8db60c098ee7e31b4365ff9d2feaf36ea14cd0d0614e647fe5506c,27794289802
20180902,"PAYMENT SENT",0,-30215634624,c0fb7aeb1679f80427b6edb99967069f04334d15c0cd90bc1b85fb8d5c4fca56,26512551643
20180902,"PAYMENT RECEIVED",1250000573,0,38d2e68bac1557aa8bf1ac522e323a2144e0f1a378ad4efe9a1206d2a3fc867d,56728186267
20180902,"PAYMENT RECEIVED",1250812774,0,620a0d8096cb5c88d7d380871ca4b814c0b97827de32b1273c12bcaae4ba05d2,55478185694
20180902,"PAYMENT RECEIVED",1250000772,0,c452e1291a4da47bc3195614ddc6ba81a61071a989e61b2aaef7af2bf050b917,54227372920
20180902,"PAYMENT RECEIVED",1250385155,0,3c9e9f42891901c471d1f1adf0ae9712a63ccc33f389a6584ffff6eae063a07f,52977372148
20180901,"PAYMENT RECEIVED",1262129131,0,b648f007bc35883ff5b29ba2cb0c54620156e74a9458a77c1fdab7e9c979953d,51726986993
20180901,"PAYMENT RECEIVED",1250552223,0,89d97f6a88efe3e0c7120283942902437ea634e00047e3cdc94d0256b4e5cad7,50464857862
20180901,"PAYMENT RECEIVED",1250682145,0,c006cb8b46dc71f937b5b05b2f5f29a5cc5fe1d0c069f609e9800eebe04f6e66,49214305639
20180901,"PAYMENT RECEIVED",1251413535,0,8013ab35a933f38c75f345cbaa4260a314be32453d8d5409d9f1e8b6eaf85f3d,47963623494
20180901,"PAYMENT RECEIVED",1274516226,0,300d3065995355c214f5cf02951d5761e5c9e1d756db400a6a1a16fbcd43922f,46712209959
20180901,"PAYMENT RECEIVED",1253218494,0,cf01e68a4b0aaa3b110f35007e4ff6e5db21962f1bb0aa3ac6945b6734d6b41d,45437693733
20180901,"PAYMENT RECEIVED",1284533890,0,cff5f9982667ec59be093851987b0c6526cda1ed35a9b3a85c0c85bccb35fa9b,44184475239
20180901,"PAYMENT RECEIVED",1261400401,0,6439488e3ce4f83e5452f7bbd93207906fdeaf2a3d4ecf4a5745d71d4db1edd8,42899941349
20180901,"PAYMENT RECEIVED",1289291439,0,73cacdc355b5819266936cb37620c7edaffbb9ade66e71f7b9827e5de97b6293,41638540948
20180901,"PAYMENT RECEIVED",1263216036,0,9cc73d7b235e9aca2125fab15dc52860e76ebef882167c3966d1e00053158c35,40349249509
20180901,"PAYMENT RECEIVED",1275716105,0,b33187402ca331b01e9a25842b958dda2949078bb603ff3c2a8a4ff43700e7cd,39086033473
20180901,"PAYMENT RECEIVED",1251914928,0,bacb80d8c0afe7f5d352cef26759f30e5159f79645ec1c7551db927e789a2352,37810317368
20180901,"PAYMENT RECEIVED",1253778949,0,3a20a620575ce104c83e6153a199bab4f621975cf94efa3181004fb5636bffc9,36558402440
20180901,"PAYMENT SENT",0,-26844568096,7d59dec677475cfc9a5e68453f3baefbbc87b96e7d1dcecc570632bf61767d12,35304623491
20180901,"PAYMENT RECEIVED",1253480224,0,7dbeae77ca2c54635cacd9235ec9c0f110eb8858adf59bb9f1fd7e3f17eb4352,62149191587
20180901,"PAYMENT RECEIVED",1256253486,0,39b558fbd351a35351842473a86fed3c66561a539c5ecfc401e3ae8039df46a4,60895711363
20180901,"PAYMENT RECEIVED",1265566671,0,1fb129ca47ec944e7b9fa1be3265b8b78a3d2c4034e2ffac71adb678ad7e3ae7,59639457877
20180901,"PAYMENT RECEIVED",1264480214,0,d89b8faf1661a2d8ee6d8fb7b4e4e36e5645016f8bc453f78eebf8d9df23f4eb,58373891206
20180901,"PAYMENT RECEIVED",1272141538,0,e7d6abce04656153e7d5c8e5d6cb03fcf19a190977a3afe240b9b9d5725eaf41,57109410992
20180831,"PAYMENT RECEIVED",1250000000,0,15803f5222b035b3ad5c1c9ab30ed8c4d286722d7464465cefb91e58353b3345,55837269454
20180831,"PAYMENT RECEIVED",1253316717,0,0bb4ec7d6bbfaf149daad3b1be78f51db1a0a4d5086eb9946c4c5510e612ab4b,54587269454
20180831,"PAYMENT RECEIVED",1253370875,0,560c73615ed6db5819e70d9b0b578a81ce3387dc7e9ab38f1c7f1748381a1bf6,53333952737
20180831,"PAYMENT RECEIVED",1257114273,0,5bce375f07f6f373d18ec343b16375fd2accac3b7bde57a1c99f64f93cad8538,52080581862
20180831,"PAYMENT RECEIVED",1262367744,0,79fb8cab348f24c3705cbfb2099fdea80e1d99d9ed3e9e3b2fe357bca5ad78aa,50823467589
20180831,"PAYMENT RECEIVED",1250188473,0,1901d05a3e27b5ffd7f82cd18206ac949487f0ee8b6496f17ad3e8d9d31877fa,49561099845
20180831,"PAYMENT RECEIVED",1682,0,b2bc2fa946e1d6ea1fa3566d614ff64b984bd1ab3e8fc0cb5e6aa062913ae675,48310911372
20180831,"PAYMENT RECEIVED",1262036922,0,297ef1a586a991f02a1baefae11929d004c43fa8b0cd6fb2579edea90a5df120,48310909690
20180831,"PAYMENT RECEIVED",1267094902,0,f61cda67e31ed1a6ad0138e8197be9be2ab6c83040ffa1e07787907186486410,47048872768
20180831,"PAYMENT RECEIVED",1286721250,0,a31169b90a7270dc3b0cc574d7cc977dabacd734bf79a5c2e597ea09d2b75c0e,45781777866
20180831,"PAYMENT RECEIVED",1251115751,0,9dd6974d041fc7c164362bc4ec400fd4cc1d8eff146dec775505ff3f3446b746,44495056616
20180831,"PAYMENT RECEIVED",1278477986,0,dc4528fe8442ba3e88e007939a2fd9f3e79ba0b94a442045ee1a2e6c75af9031,43243940865
20180831,"PAYMENT RECEIVED",1255357149,0,1aae5a4933420aca8ac1cdbcfaafc8d283a3da557453540c6174c52ad1bf24e8,41965462879
20180831,"PAYMENT RECEIVED",1273281595,0,f17a63216c024624e6c88d79bc101133c2c14d8e069d429fd4f6ed2dbefc93c1,40710105730
20180831,"PAYMENT SENT",0,-30248559716,7b11d9167a51a4b20934c474a9533dd9cec704672f19b6171dde4248b73be514,39436824135
20180831,"PAYMENT RECEIVED",1285256915,0,24411a09c9a44aa56f5201c459b3b927c653cf5d558b24fc4102909e130f9876,69685383851
20180831,"PAYMENT RECEIVED",1274894821,0,a7ac2ee692707f4e2b6f8bc0e90be158b61881982b527943f17b7a132ff49723,68400126936
20180830,"PAYMENT RECEIVED",1251498462,0,af083198e323878b4c719497775d1d2fd612ca3d0fc3535844b4c974609af6fe,67125232115
20180830,"PAYMENT RECEIVED",1264985582,0,5772a46fee9cddd98965dc8fc082708792d3d1b29df6984d872d0b87443a4917,65873733653
20180830,"PAYMENT RECEIVED",1260492151,0,49dc9bbac28acbe6f161048a58564ae56bbe61664b12e80ac090a9bc0ac8a629,64608748071
20180830,"PAYMENT RECEIVED",1270569926,0,75167a5f292b52d0b55e08ecbad984270481753eec8bf6f7133e1cdb951bbae6,63348255920
20180830,"PAYMENT RECEIVED",1251475118,0,4f5f2b0cce99691008f4d839c6582b73d06296ce76a40a6d7b542834edc563e9,62077685994
20180830,"PAYMENT RECEIVED",1265029499,0,ece8854812c5a473fd009afabee48a5ba6c5eaa18e097cf032482f4453854493,60826210876
20180830,"PAYMENT RECEIVED",1262306449,0,b120094478a017cef808aed1614bf670ed1c199bf865a0e298a23c9418ffc3ac,59561181377
20180830,"PAYMENT RECEIVED",1250266593,0,28096da2e897e95eea5bad04264e87985fa38f90e1c653b4270070f69fae8942,58298874928
20180830,"PAYMENT RECEIVED",1253803302,0,c8c7fa178807020069b273a71c32c8ce76742b136a73b0e382e2b60869869971,57048608335
20180830,"PAYMENT RECEIVED",1270997710,0,1aa27fab04bbfe4015cb7ace30d924d3a1e53da57ea0d921b5800ac856a796a9,55794805033
20180830,"PAYMENT RECEIVED",1250275975,0,97a69b656c013aa4fdfe685a11f7c23afe353570a9e2304bf2c0bfd306888751,54523807323
20180830,"PAYMENT RECEIVED",1260533339,0,b1ccb4833b7e892f0a32cc67dce4a8859ba19a01295f8fdf6cfc0b167b708753,53273531348
20180830,"PAYMENT RECEIVED",1267855119,0,46d2a8e52e493fc984957c30d759c874eade6dd6be70e3a4f3f239f0010b9a0b,52012998009
20180830,"PAYMENT RECEIVED",1261840645,0,606b01d5587efd28a8daadec6a4a8e95f0dd83ec5c1c07e0aa4028b986731578,50745142890
20180830,"PAYMENT SENT",0,-30241124155,326452c52f75423e49118c75d35214505021e6ba7b915449f0458023432f555c,49483302245
20180830,"PAYMENT RECEIVED",1259106791,0,b3f267145ecc36a2a737babf3182b29f863f80bd67d0c33c02b8defdb80c2e78,79724426400
20180830,"PAYMENT RECEIVED",1250236348,0,e139421ae9a581721af1c7431cbfef933866582ef1a7e7d1ff4b1079e967e097,78465319609
20180830,"PAYMENT RECEIVED",1251413791,0,fab8e07e06364598f5c3e12bd9ba1dee5d07de58200c046bc60a9ea0f2fec8a7,77215083261
20180829,"PAYMENT RECEIVED",1270597145,0,1bc5f2df95e547288f8242c61038a9d248b05d832dd34aa941c3e78e481397a6,75963669470
20180829,"PAYMENT RECEIVED",1253646200,0,f58d37eca27225ba4df9c84f06280ad96202ee6c90efe1b163d834edf32d1bb8,74693072325
20180829,"PAYMENT RECEIVED",1250000000,0,347b4981b054de42800bc7bb57e515fd77a554b88c38938f2960626095e9ef26,73439426125
20180829,"PAYMENT RECEIVED",1279408839,0,27fdf4a6c7938dee8bc3a03d39eb6a2c988eb03cde0e947d4a86a99dbf872b7b,72189426125
20180829,"PAYMENT RECEIVED",1250115356,0,1c54b67ac8cf62dbea236b275133e7ff67d5e3dc1b1d1256a349d18d39dd1d83,70910017286
20180829,"PAYMENT RECEIVED",1270573584,0,c546ab9a47733b027bcff67422b13b4f7034535941539518561672da167a85c5,69659901930
20180829,"PAYMENT RECEIVED",1254179355,0,33db7a835df85863b15fe2680bd884102fd8d763d594b30c570d753c7a45bbbe,68389328346
20180829,"PAYMENT RECEIVED",1255486649,0,e8e6a37b935e772c853576bf20852abff3afe3b4a053d9f9c9aeaec656d39fa2,67135148991
20180829,"PAYMENT RECEIVED",1276678683,0,1432981dc94f299aabcab28049763284ac53c62fb0ecb43d2075b871f39eaae4,65879662342
20180829,"PAYMENT RECEIVED",1250500651,0,45049f61cfeb7f31689d334d9aea4314c556154a6ed580d4872eecbf737d8017,64602983659
20180829,"PAYMENT RECEIVED",1253737305,0,df8714d2cff13a282f2a41f62b8ab422775fc43c130b70b56730148533a407e8,63352483008
20180829,"PAYMENT RECEIVED",1250893477,0,c8f9efacd7237ffdfb4cbab32153cf998959884cf5275359cda8e2a57c0df8cf,62098745703
20180829,"PAYMENT RECEIVED",1253989380,0,ddc8a54190de8c138fe5c39a2d03c17e9942cd6539514eb86e6ea026ba60c5a1,60847852226
20180829,"PAYMENT RECEIVED",1262329027,0,74f6f268c364169229757e110173f2e62e8ef55f2059b5f4ffc2bb6b377121fa,59593862846
20180829,"PAYMENT RECEIVED",1252679583,0,ac168fd75bcea98094210da0c580be4dd9bdfa8501b9b55ca09fddfe67190023,58331533819
20180829,"PAYMENT RECEIVED",1261425652,0,f6a3ad7833f6598399d4d361d961230b005b5b9c117f66cffba7bdc6abf2f49d,57078854236
20180829,"PAYMENT RECEIVED",1263715038,0,f7be1ecf0766076bdb0c157634aa2fd7929baad83ef9f79f0a72d2a58dc5b8ff,55817428584
20180828,"PAYMENT RECEIVED",1290126998,0,e38c3714b7fa459cad3402db07e1313162d71ffdeb7067432af45571ba6a48b7,54553713546
20180828,"PAYMENT RECEIVED",1250306644,0,b4927ccd021ecf9d3ae22b31a5940bd2b0c9ff1396c0969cdd7806397d485a85,53263586548
20180828,"PAYMENT RECEIVED",1269423641,0,fd0bcb9d228e725a6c7b76ba5752a522c559cba9e65d35172f2fa1ecad08a9b9,52013279904
20180828,"PAYMENT RECEIVED",1262811468,0,b6b20d8225b369aac6f21e54a1c073bb4b20d553f27fde9a2a8b81ed55b7a958,50743856263
20180828,"PAYMENT RECEIVED",1250079717,0,f98913e0ccb5fd847bd4828aa99c9f5febef322ead768bfaf036837b0c58bbe9,49481044795
20180828,"PAYMENT RECEIVED",1309138377,0,0059c67941c624950dbda111e0f2bfd35ce87be8b78f434f0c4a4f7d30b4a449,48230965078
20180828,"PAYMENT SENT",0,-30166237636,799203f6ca3f47685f282bd41cc1621da1bd3077e52fc7596abea261292d1e23,46921826701
20180828,"PAYMENT RECEIVED",1258356981,0,061741ca3bebae910a629c36562b013c980509ccac31d478d95928098c8e2178,77088064337
20180828,"PAYMENT RECEIVED",1274500464,0,61c547facc1f57340c5c8cffb880269978794bdf67b1e30bcdb256b4c4e513a2,75829707356
20180828,"PAYMENT RECEIVED",1267372089,0,ba6f73e0c08aeaf8e026308821cbfd2869689025b27b17f6f33c62b428c2446a,74555206892
20180828,"PAYMENT RECEIVED",1277388746,0,7a79fa1f4054d9cd160cf9689843e4ba148ace2b7077484342398c44b254078e,73287834803
20180828,"PAYMENT RECEIVED",1307048770,0,1111c042bec9d78a9ae0df0ed7193cf3197ca84702885ad9005ad40d59cffb3f,72010446057
20180828,"PAYMENT RECEIVED",1259632584,0,550a24e18bf5b227781704798fc29d169fb1a4e88247c731c70e209e0896c1b6,70703397287
20180828,"PAYMENT RECEIVED",1313018891,0,1bfa7785ce7e0fad77c271278ecb87556041c2794b970213cdf3058583f8ed22,69443764703
20180828,"PAYMENT RECEIVED",1255402923,0,c8eb3b65bb306c46f20bc9a7efb37fb6dd1ce506aea686b6cc0b812c9e64aeb7,68130745812
20180828,"PAYMENT RECEIVED",1264442405,0,512225a1faf30bb5ea2dbbe1f550bafef3931a4d63b3b616945105576c05a51c,66875342889
20180828,"PAYMENT RECEIVED",1272702373,0,6f92368ea6666655a00f3ff02876f115da4951a0c24915d0a377c0c41ea97b3a,65610900484
20180828,"PAYMENT RECEIVED",1287132715,0,b4a38772b34f705120b55687697a5bad2771ad34cf3eef104a08b80558c71d72,64338198111
20180828,"PAYMENT RECEIVED",1280745822,0,e0b76c42e40a47f6359145dfac8372d6d0eeab3ab5f4d4b934216490e94fc9a4,63051065396
20180828,"PAYMENT RECEIVED",1250965176,0,276ac9ab1b040e668d9613a0d711042683a9965f60aa1acc114ea81cd2bbceab,61770319574
20180827,"PAYMENT RECEIVED",1264504929,0,27a0daae2c7de9931783fd1aa1f6bff1a8202cd3ed526ea687147a765029023c,60519354398
20180827,"PAYMENT RECEIVED",1250000000,0,a78f1101ea100ad497f817fb337e4fd83f98ab2bd25b7b4d236dcd3d59ab45a1,59254849469
20180827,"PAYMENT RECEIVED",1250040468,0,ea8f27c9ef30a0058ba8bb7de004ad0d35ce08ec695f812f95a9cebf51bd2eb2,58004849469
20180827,"PAYMENT RECEIVED",1251197024,0,6c2ea443040fda9b30c3768a325f4e670a9704a9c2569ad743cf0f7cba708630,56754809001
20180827,"PAYMENT RECEIVED",1288781217,0,5bf8aa7cdba45905dda97a1d1e885eb220e4f713bfe77ad8fb2ee7f979f97f84,55503611977
20180827,"PAYMENT RECEIVED",1263285384,0,e269fbbf6cf1c007c012317b87295dfb801537f20c38c482e8a2368e1fccbda5,54214830760
20180827,"PAYMENT RECEIVED",1250216594,0,48f5f222b14ea4309eb43d4f28fe04fd0e4f718266c6fa4f4c9eb0524051390e,52951545376
20180827,"PAYMENT RECEIVED",1251304834,0,b35a13c56abcd6d84db0d776fcfd2e08cb8edfab1c182995f5c5bce449822760,51701328782
20180827,"PAYMENT RECEIVED",1260764774,0,96394fcb34242d1a176fb741ccd08ac7d94561aa94c2db5c3de1632b016876c6,50450023948
20180827,"PAYMENT RECEIVED",1263734181,0,56f825a7ae9c45f91d1053df88a10e0e884e7e8dc1a4388d5312f464dafa263b,49189259174
20180827,"PAYMENT RECEIVED",1260159607,0,d2ca84a0176aac3b39f2d783ee126664052f0b030a7c46e026f2df1ad222fa6d,47925524993
20180827,"PAYMENT RECEIVED",1250742766,0,c29f1654c8d13fd3af8b0e3504eb3808fdc969d0109c6a3cb9236f4b39379ea7,46665365386
20180827,"PAYMENT RECEIVED",1268699389,0,2499069d1c53e0f42c46911c679b10f1ff0f28de61bcf2d8cd51b874ba9a6e5d,45414622620
20180827,"PAYMENT RECEIVED",1252411584,0,347dcbc233a97dbfaac39951b65008204fd1cff2a4d5879784be0da3566fc126,44145923231
20180827,"PAYMENT RECEIVED",1302798467,0,b4a6bf2f7ad6df0db64044dc0baf7c0abb7d8a405eabc666557c2ee1a097c40a,42893511647
20180827,"PAYMENT RECEIVED",1286222761,0,aa77c4189ff55310339ba8259dba7a50df28a467b21fa4e326cce097378281c5,41590713180
20180827,"PAYMENT RECEIVED",1251032945,0,7289e54e6493ff462a15604906a40fb1d78a69c24bc4cbe31c1fe9f7c93868c3,40304490419
20180827,"PAYMENT RECEIVED",1250002500,0,afa44095c1f4cfcd3df1ff0d859d681dba68144d3e733c530411f78f9c94281f,39053457474
20180827,"PAYMENT RECEIVED",1291301212,0,0fa6d818a63b0333bd0ac61ecb3372087a4fda2f0fd420da9cdb8c4a0bd9d40b,37803454974
20180827,"PAYMENT SENT",0,-29195015080,f8aa55cfe1ba5d313af186e07dde486d1555fc1e322b7d86d9e26d60b75ba2a4,36512153762
20180827,"PAYMENT RECEIVED",1274608898,0,34d7bdcf48a7a41bda7cf7dac7e21c87970f958d364a8a75d328cb34e34d5fb3,65707168842
20180827,"PAYMENT RECEIVED",1251823152,0,1f39109c0464934a1071c0fd6598c65a27e169fcf2f406523e62c5c3eb4c1762,64432559944
20180827,"PAYMENT RECEIVED",1254242583,0,caa3003c5fafb2b28a63de2cdcfabde9be5ebb97b6786df73a51843883349a3e,63180736792
20180827,"PAYMENT RECEIVED",1253787413,0,9ffc57284e4026c4237b3030d2e9e8732c7867e32e9a4850cce46ce0f3480de7,61926494209
20180826,"PAYMENT RECEIVED",1256698677,0,4afa7d750740e7585521e936fef77c68596310d35f6388bf93196611135bb2a2,60672706796
20180826,"PAYMENT RECEIVED",1259548021,0,9a54d4ddb7dc91c9e532770f9a140b5456af48b7486f546359c24d47d59039aa,59416008119
20180826,"PAYMENT RECEIVED",1281290655,0,9676da1192038ffdfceef2e1e90d75c8cb5f33cbb9a63ecf60cb4b2462e19952,58156460098
20180826,"PAYMENT RECEIVED",1268419938,0,daa7f41e26cb69e2b6aefce3af5ef8dd5895c99c568ed10088a627496d53dedd,56875169443
20180826,"PAYMENT RECEIVED",1265792213,0,8e363ba0e5f1a487e3827215d50c5c05f12b307301f58a0ca5f6c4eb65d48298,55606749505
20180826,"PAYMENT RECEIVED",1253422518,0,2ece419e0fba240c3f02343ee6d9849a114fc09435afa0d34682adddec042e28,54340957292
20180826,"PAYMENT RECEIVED",1280001617,0,82a47d0d293b0ba365649d59323fd60c2254e66c49e552d4d7e94d1f7d00a84f,53087534774
20180826,"PAYMENT RECEIVED",1252576847,0,1ae034663378cf575570c77b9b5022806c7383acf9712dc533d13027c73a53f6,51807533157
20180826,"PAYMENT RECEIVED",1254699946,0,9afb1fd45bd277013fd21e76165fa24172f420494492b09b4d1d065d0f227740,50554956310
20180826,"PAYMENT RECEIVED",1260596476,0,26d328a7ea4f5a643edb99a8315a9670fed11b2d078356f2cb3416f5cc00c803,49300256364
20180826,"PAYMENT RECEIVED",1265210899,0,80a12940a7c5a9fe3ef3efd7789e2953818646236770ab1538798c92e985bb66,48039659888
20180826,"PAYMENT RECEIVED",1252147664,0,22ac95f952f3b5a88bd6f86e2c6ee2df568400218e326593b938278470bc016d,46774448989
20180826,"PAYMENT RECEIVED",1251649764,0,06142abd3fb93b94b5d810d7bcca100cc077b38c3e57bcb3d034ec40c520af79,45522301325
20180826,"PAYMENT RECEIVED",1251240841,0,6541b41d5e874be5b4b7bca9f773d819a785acb46156cc3b0452dbaa4ecddd15,44270651561
20180826,"PAYMENT RECEIVED",1252407424,0,f22ed6f12b37f18c8ce1ad88e7d90e62cfea1b1efce8a126c1db136617b4002e,43019410720
20180826,"PAYMENT SENT",0,-28941169748,42bc6a46cdfe37f5699740dc221e8531af1fb5adef5f3e0d11f39d6d930386c6,41767003296
20180826,"PAYMENT RECEIVED",1285606665,0,429756a8c180b9de9848f4b30e1fc71facddd24386e013e73aa6cb99e0e3c1f7,70708173044
20180826,"PAYMENT RECEIVED",1278317572,0,c7115905c711f81b66d87da0c74f74f8648191efaf265c2d47acf8e91a3435f3,69422566379
20180826,"PAYMENT RECEIVED",1250082383,0,76fa4a9dcf7b40e5476482b89e6fe32d7bd8dbee91f99d9ffa76c481b69803db,68144248807
20180826,"PAYMENT RECEIVED",1269810744,0,c9eb98850c3a96b46f6d630ac88f5e02985bac8e9d6a671b87c6fbc4b7bf2f7b,66894166424
20180826,"PAYMENT RECEIVED",1253378187,0,b39836462c0aea0bbff06644cbedc05f500477c974c4258cb747efbdb6fdc3e0,65624355680
20180826,"PAYMENT RECEIVED",1252285665,0,0a2c07517dc80289f1ff8e1d38adb7b2101388549ff739af819dc8f16f4064bb,64370977493
20180826,"PAYMENT RECEIVED",1255296065,0,208b164a901ba8efdef599c0d21e4e8d0a69f6a64d2af144b249195ba9b35faa,63118691828
20180826,"PAYMENT RECEIVED",1255641224,0,0ee605271c0f92b076aca3ec59048657876bd4aecbdcf2204a38687299caed75,61863395763
20180826,"PAYMENT RECEIVED",1254626899,0,008f3c064b4e7bf4d007f1f1c26dc4467399022e71f2b46de8e688208e734510,60607754539
20180826,"PAYMENT RECEIVED",1264956516,0,6aaebd0615d4b0f3b5c9f2d2bed3e6d439601606ce6a9f622f38049cf55b91ac,59353127640
20180825,"PAYMENT RECEIVED",1250892390,0,ec06100b1b170a3877b4aa92b3f97447a20bd821a481407a4a2c0852752f68fd,58088171124
20180825,"PAYMENT RECEIVED",1251159526,0,34789d6d9f45b6979c754c4537663aaa82558fdbc227baccf9812ebcff8b9315,56837278734
20180825,"PAYMENT RECEIVED",1281953775,0,82e2f170e1c6446e5abeca4127a165eca30e6f6da3792e24a9142d27e7d35847,55586119208
20180825,"PAYMENT RECEIVED",1273557804,0,6999f0a47d5d7d898a8f6cae65abca1c497d74adcc3d64349554a38ff1140355,54304165433
20180825,"PAYMENT RECEIVED",1284475692,0,f983fddd9c41a561c0f3b87c2be91e72b2b82121622714aba01dcc6f8d194545,53030607629
20180825,"PAYMENT RECEIVED",1254362140,0,5becdb02739f634d9764a412e7828a08ef034e5609bdeb78dc5dc5404fa45353,51746131937
20180825,"PAYMENT RECEIVED",1279772123,0,3cdefbe95290990811c0a2f859a9b90d7a0329318f3cd94642604b117cb85b8f,50491769797
20180825,"PAYMENT RECEIVED",1250006517,0,31e9370f45eb48f6f52ef683b0737332f09f1cead75608021185450422ec1a71,49211997674
20180825,"PAYMENT RECEIVED",1258305263,0,229739cffcc5d0d8fbb472226ae7ed92d2cf1773139bc81e00c28aaaae920dad,47961991157
20180825,"PAYMENT RECEIVED",1251216375,0,c4598c42e70d2e12eb0c7075660c3777239ac6f1c93daf012fb49c35dee9da76,46703685894
20180825,"PAYMENT RECEIVED",1252240047,0,1b0189bde8d95414b5c99097325905fc3678374776db23da058c8af02a2acee2,45452469519
20180825,"PAYMENT RECEIVED",1267371153,0,fa4c05bc13103bf5a986c41e3abfef087c0fe9688774dbad79738679f904cc21,44200229472
20180825,"PAYMENT RECEIVED",1262937243,0,edd74cbc03bc1e8aad5c1edfb68c8b7ceb2107e4593df03a4d9fb4426e008980,42932858319
20180825,"PAYMENT RECEIVED",1258463364,0,5922478f2d8b4df2416ee030494fa46f2bbdcf9b0751ef410dafcebfac7b67c7,41669921076
20180825,"PAYMENT RECEIVED",1253605730,0,4cb70ba35d9923867c054c9be298f86e3628a65192c79692a01f74b0f624cf88,40411457712
20180825,"PAYMENT RECEIVED",1253587952,0,55a5e3c9817fed0d7bbe6eb6bc9da9018300bc116126b533deaca066a0a9e165,39157851982
20180825,"PAYMENT RECEIVED",1257733709,0,5c1b9609a67de69b1878114791f23407d39a0e44975caf8a728d33451829b954,37904264030
20180825,"PAYMENT RECEIVED",1259588934,0,23fef3a36a2955ed9db6618c6e98d2c51ffc30e7124b8c4869cdc20b4ed1ef1e,36646530321
20180825,"PAYMENT RECEIVED",1251154565,0,fa00c1e853f1fc8bd532cb2955d45f1bdb0b440757a2f77abbdbbf73b2147c1a,35386941387
20180825,"PAYMENT RECEIVED",1268220153,0,6ffde8bb31008bca736cb4090ce7868bb64695499ec67da508f736ec6fa5600e,34135786822
20180825,"PAYMENT SENT",0,-27825743226,24daaaaeeb51b1ccbcc65efc22c9aed3ce0e0dc2c038d43960358f5abeef2422,32867566669
20180825,"PAYMENT RECEIVED",1263656476,0,a9b7f1d4011c9be2ef9fa8b8a8e3f043bdbdd3fa062f07297b8dd8e5ad73d4c2,60693309895
20180825,"PAYMENT RECEIVED",1281443026,0,5958aa838b180c473423593b450dbb5c500e431838a2244984c72159790694d2,59429653419
20180825,"PAYMENT RECEIVED",1264838320,0,7a34054796c39771f38f715d07469f6b81c30be9015b378ec9e73543a04731ff,58148210393
20180825,"PAYMENT RECEIVED",1266700775,0,f9566c9226472c871e307700b62bea892b9b264d51041a3d3fc2221708a7d523,56883372073
20180825,"PAYMENT RECEIVED",1260463727,0,cd9e1bb685493f7b0ddad14c861635e96073b8225ac52196ffd4172835ca8dc0,55616671298
20180825,"PAYMENT RECEIVED",1256506655,0,61df4ee476a426fa71a468edc68717aad64e8a75cc34dd88ea724ef6ac33ffcd,54356207571
20180825,"PAYMENT RECEIVED",1251449561,0,3634831803b509c005e53ed81cd07ec39a2d3fe8b4af18fb6516cdc132244d38,53099700916
20180825,"PAYMENT RECEIVED",1272089478,0,163b81b7b1d7963e6dfe0ce78ee6fdce83c17fb3c104c02a8780e00e5828c09b,51848251355
20180825,"PAYMENT RECEIVED",1252351369,0,c5a3b7414233865b3946a9e3b47d8ee94750f86c199d962a449bc2ca0f366c17,50576161877
20180824,"PAYMENT RECEIVED",1251895196,0,caa22cc3fab34c2fe67b4f98fe49d82e76908dd5dbd6ad2c022e46f518e021e9,49323810508
20180824,"PAYMENT RECEIVED",1267917751,0,88cbd2227c8b451526249907af34ba0239b4693fc97139b8a0b6ca5f185aeb1d,48071915312
20180824,"PAYMENT RECEIVED",1261013591,0,38c0c0ca819a8730843c0aed420a75840b61c268f1fad9776e2207273eb503a7,46803997561
20180824,"PAYMENT RECEIVED",1254760129,0,cba67f6833760cc4f8477c1a8f16295eede7327b5459d36cd3a3c683b34632b0,45542983970
20180824,"PAYMENT RECEIVED",1254805436,0,16bed803e5b597a523afbc59b1cc699c6798ac326c0e70023a3f6ecd85592697,44288223841
20180824,"PAYMENT RECEIVED",1258266224,0,b38ee10613856e72c22a87fc31f0b0554da6e02eccd99a11ac6b6ba228378f46,43033418405
20180824,"PAYMENT RECEIVED",1251846994,0,b0c56f95ae38693126c0b51741beea69cf48561fcc392dc0d2bdaf250b64668d,41775152181
20180824,"PAYMENT RECEIVED",1253220288,0,945132daa595362b3116d46faf6b22ba7587232c6c19878991b3228926e5bb06,40523305187
20180824,"PAYMENT RECEIVED",1274625146,0,32188ac9efde34452de116712117f42155ae5ac0212e4dd37903ebeb623a18b4,39270084899
20180824,"PAYMENT RECEIVED",1285272443,0,985d9178002061fd2ebad1e88ee49d8aed9bccf93b3f252c141fcd6eb18d91c9,37995459753
20180824,"PAYMENT RECEIVED",1265286833,0,7a49365c5e7a00f15060ee1bb6f16a3210593935c5ce27850aa1401de022a8cc,36710187310
20180824,"PAYMENT RECEIVED",1254853713,0,251b911267b8cc489a52303ad164993ba55d0f4dca9a5bb75f99d3822d989ef5,35444900477
20180824,"PAYMENT RECEIVED",1267496952,0,295f1449bc22ccaa475f8967fea2847ca0f811e69b6029156a5de82bb93d86f9,34190046764
20180824,"PAYMENT RECEIVED",1265150675,0,b1733dd97a45016cf860c90c16bdf033355e75c795182918596e66b129d9f480,32922549812
20180824,"PAYMENT SENT",0,-30190727225,cab3a3ee294efa3aa35413266977adf520ef60ac363f2c9c00830c3c9976b435,31657399137
20180824,"PAYMENT RECEIVED",1281763377,0,752951d8ad0c2fc776b5ee666061a88491080cf554b342fff8d00533ae857b0d,61848126362
20180824,"PAYMENT RECEIVED",1259141808,0,87798cf760aec1c3b713a87e2b493e2cefeacc303ff2a6d81c85291647274d8d,60566362985
20180824,"PAYMENT RECEIVED",1254737066,0,4ec83a4934d0ec73f0e17481f176b38bff7e877604953fdf47de5052a184ce1a,59307221177
20180824,"PAYMENT RECEIVED",1276516178,0,ab859a2fdebb1d61013ff16754e87c8308846a58e0fa6b14104f255209a8c61b,58052484111
20180824,"PAYMENT RECEIVED",1250713348,0,8d4ec624fe0a2ed5fe60b3e289982bc0c66b9a3bf5d91680eb4774bcc61efc70,56775967933
20180824,"PAYMENT RECEIVED",1258126601,0,eed1fc9701fc0ebd27a50485f082a438bb9c91c1b6511f1b7f7c6424b206cf70,55525254585
20180824,"PAYMENT RECEIVED",1258492822,0,9cd363ae02864f859669170879b89e1468fa2c45b073d4a4bcac2a4ba62fb634,54267127984
20180823,"PAYMENT RECEIVED",1254069197,0,09f854978915f97dfe7e0737efafb5abf4bc56bd5ec1444b45e98d37562747c9,53008635162
20180823,"PAYMENT RECEIVED",1251232174,0,65146a03dd1cb708280a389310b859dc3ef32476a1413e207a2c8a4572da96c0,51754565965
20180823,"PAYMENT RECEIVED",1250763323,0,1b4a2c70c87289cd6a3b68953fe614a9fce0bf9f9270d5fe948241b32174277f,50503333791
20180823,"PAYMENT RECEIVED",1264269504,0,e60817408cc292f555f982f67a5d3dc743794dd9e15337471641483efb9a560a,49252570468
20180823,"PAYMENT RECEIVED",1260709128,0,db3e885c7d4ed72c387c05072e9de852f91c1a3ef6da2ee0e6585886a0125a92,47988300964
20180823,"PAYMENT RECEIVED",1263701122,0,381b02b6fb9d601d2ee3b15adc1a485e673d117aebf86a1b7e6154b023dbaf73,46727591836
20180823,"PAYMENT RECEIVED",1293517582,0,94a4e575c476d0003bb231f86608219a7fce7abba3f3cfb1788e6a0c4eb6c2c1,45463890714
20180823,"PAYMENT RECEIVED",1287685282,0,9b294bf442257bf1d377277b386f08d2982c4ee8f1b53ffa1b47abd2ee380d89,44170373132
20180823,"PAYMENT RECEIVED",1274269101,0,8789a460462e29d32565545c77b06619de1cf01d42c70be92b0eeddb1de7b3d4,42882687850
20180823,"PAYMENT RECEIVED",1250061728,0,c256aabed3be31a38f7f8b199a168223962a442259c3d6ea838c307d2fdd5b9b,41608418749
20180823,"PAYMENT RECEIVED",1250592641,0,db401d12afaee71d5262a7fc902f55d4f6a28466d26ab546fb98be8d604a8aec,40358357021
20180823,"PAYMENT SENT",0,-29137496446,f22ee09fd3cc5f73671fe2cb454ceecc1fc0386a4ed936362920045af16fb3dd,39107764380
20180823,"PAYMENT RECEIVED",1262430949,0,f83e468ba8d9ecbe77be07cf208957409b476d43455050b1d38778aba17466e7,68245260826
20180823,"PAYMENT RECEIVED",1256397631,0,b1f2d549ac9fb08c565952466ec0454cafdcd7d56120486099802dff7fc1c125,66982829877
20180823,"PAYMENT RECEIVED",1250132595,0,a27dca94447f06f6da78eab03f85ae60fde55f661401c9e7d9ab263f8a34fe40,65726432246
20180823,"PAYMENT RECEIVED",1274434734,0,61b5a228281cf261663dcaed2afa8ce5bbb9e060c19a1cecfc955b840d2af27b,64476299651
20180823,"PAYMENT RECEIVED",1270687323,0,52ba26a438f95d60ba9507776a62321a72ca405cd706102464c0221bd4cbcc84,63201864917
20180823,"PAYMENT RECEIVED",1250544295,0,38900ddb56f1ad98c5ab3572c8492e1f55b367bc4dc32050408692024365c216,61931177594
20180822,"PAYMENT RECEIVED",1250179231,0,31baed3ddfdaab4af06a421d6ffa212f29093c5c385338484ede5cd22f6c07a3,60680633299
20180822,"PAYMENT RECEIVED",1261627997,0,5a63d0bf278e907ecc5b57b16cce81140b21962abb9241bfddc58ff4f2a7992e,59430454068
20180822,"PAYMENT RECEIVED",1256953577,0,6528c3130dc91b5a8efb52eeda8127196873f299d52d06753b39fd967fd97d40,58168826071
20180822,"PAYMENT RECEIVED",1256553469,0,4925b7636f09826256eefa9ce182c4b89add5f727c2c2aafbcf9c417abc95ef2,56911872494
20180822,"PAYMENT RECEIVED",1269745864,0,3deda4a65d6dc1c43613d4edf130af905716244523b8ad9231e97ce760ecab9c,55655319025
20180822,"PAYMENT RECEIVED",1260337553,0,b24316466e765a0afce5b963c506471c1fabf5b7c98aa31bae55e55ddb2e4a0b,54385573161
20180822,"PAYMENT RECEIVED",1260833734,0,69e6f875a3a0d7fd5ee8afaf96070ad30496749cc61b3414c394c617729ba0d7,53125235608
20180822,"PAYMENT RECEIVED",1252592798,0,58d66b0572fb31b34d82860fe350f4c8621c53c097568502ebdc9095b79af81b,51864401874
20180822,"PAYMENT RECEIVED",1258428684,0,061c5db20341f95218c9722e188b756397c1e202f9c8db4b413a26cb4080bcd1,50611809076
20180822,"PAYMENT RECEIVED",1263437387,0,bfe3a548ebba5b957dac17c7e13221e75facc29efac43a8bdb9dd2d533c9d293,49353380392
20180822,"PAYMENT RECEIVED",1276775724,0,84d8df3d62b60483ef162cfa3cb17b9f1eaf9168330c7aad048dbf11b7df268f,48089943005
20180822,"PAYMENT RECEIVED",1277619033,0,018f3d67f6fb967fe629463796ef87b3df3b6b2ccfb986d3017ee169583083c0,46813167281
20180822,"PAYMENT RECEIVED",1290149352,0,4898207c2203318ebebb440c84be9fa644369ae63d8e1ab0f05ee15abea56806,45535548248
20180822,"PAYMENT RECEIVED",1262008473,0,c0e3af36c9f1feee79f1c6ea4f4ef2df6e7d0e6c438be0d27bb61878cb47251e,44245398896
20180822,"PAYMENT RECEIVED",1258241010,0,0b5f7157f2a6fdebd4c24fc9be04a45afd13b749665fb45440b6da9c3b98ba49,42983390423
20180822,"PAYMENT RECEIVED",1267454853,0,67c4ab14422de45aa11f215f01d13880fa28c58c7529eaeda5a11592c112af0e,41725149413
20180822,"PAYMENT RECEIVED",1251727164,0,79ca2348cf492575a15678e0bfce71fddc833af4f2e3b83e734bbac4295c5bd5,40457694560
20180822,"PAYMENT RECEIVED",1262563306,0,2eb084000dc339716ca943cf6cabf7b1f8cf151a7de8530fbbb38f7539288dc6,39205967396
20180822,"PAYMENT RECEIVED",1250007004,0,f8691a306a33a5fd6969bede4ce263c6a9da2e038951830427a188a83331a177,37943404090
20180822,"PAYMENT RECEIVED",1250120740,0,38215f28ad76f6c5e35cdc91d95441820965a93e7b4da17394886383b77dbaef,36693397086
20180822,"PAYMENT RECEIVED",1278417521,0,6766ff85493a210e5aab8f2af0d3937f626c5689495ad702a295d35a5881a111,35443276346
20180822,"PAYMENT RECEIVED",1262475964,0,ce8c9fa84626dd0c301cb31d455c702c8556cf9d9deaea8b4ea68363b542e6c6,34164858825
20180822,"PAYMENT RECEIVED",1252699039,0,aaa95ca39cd8579b41bab269f54ac7f1001a5724d45d1cf979ad4b1cdbd3d180,32902382861
20180822,"PAYMENT RECEIVED",1284247121,0,7ad59c4bc86a0424f6205e26eaf6f09b8028eff76357b7802c573a1246a0bac8,31649683822
20180822,"PAYMENT RECEIVED",1250916538,0,4ef9230f917f678857454fda4d3744bf338b667126cb2bd646aa49f88c7e1f50,30365436701
20180822,"PAYMENT RECEIVED",1261099427,0,8d5b84021acf25d1425c6aa13ee5d74b1c9e24dad40f76475c320a7195dfb1c8,29114520163
20180822,"PAYMENT RECEIVED",1253715764,0,c59371e9e12a59d35859218e2d6c22228ad8cb243cbb07be69387f9d48326e71,27853420736
20180822,"PAYMENT SENT",0,-27808775926,87ef73355d9d902744452a60de5f3dfc3c67ae0cff625f24e16574364cb05e2a,26599704972
20180822,"PAYMENT RECEIVED",1253235206,0,64388e12b9683c61e10a5dbd0c4006dd544ebca19b81b58ee7f61cbaf9d8d75b,54408480898
20180822,"PAYMENT RECEIVED",1250004418,0,e5cc1fc0f22d60f955463f5c543f4945c5b297417c51da3500b7c6eba64232bb,53155245692
20180822,"PAYMENT RECEIVED",1269054782,0,41ad381c346538d8c2f63a98c169740157a79edb40665996990dda5f485f8e8b,51905241274
20180821,"PAYMENT RECEIVED",1253425455,0,9c213c064e2e793c10d5fbeb958f1a599e2b61036c90e24cae805abb14279284,50636186492
20180821,"PAYMENT RECEIVED",1251656330,0,5fa4a921250abff42b99122dc9ddfb3a9ce644944374c2ca3f8d739c6cef41fb,49382761037
20180821,"PAYMENT RECEIVED",1250176470,0,a10930fa59f6a0ae7570584be915f6fbdca4259dc04253da880be743a4638002,48131104707
20180821,"PAYMENT RECEIVED",1254082880,0,7351ec5ceff7fe83a4b04842704cf5fb1c7ecd3cf4e2f40e161fbf600846782f,46880928237
20180821,"PAYMENT RECEIVED",1257719656,0,e8a6611a45ff197140655257cfd02c3be8eeb49d20fa39ae2868b888c87a78d7,45626845357
20180821,"PAYMENT RECEIVED",1280916565,0,7a495c1b359ad67fe13b06f0c604d162b975c52ff17a6e8f5e119eeca30f609a,44369125701
20180821,"PAYMENT RECEIVED",1280972171,0,f1c7faf8140408aa2e5eed36c93950fd3c9672cae28048484e8cae926a47edf6,43088209136
20180821,"PAYMENT RECEIVED",1273454695,0,48e5cb62df89ab818bb7ab9947a5b3c47c058282f66334f921243f980fc51695,41807236965
20180821,"PAYMENT RECEIVED",1280294589,0,4cf09b6989579fa5fd1463019918dc24f836c7666295129c7ce577f5c5b4e028,40533782270
20180821,"PAYMENT RECEIVED",1256988360,0,26c7f9969cb83b7acc6ebc25ee788721489275d62bae9d15c97e6b34a6bd5763,39253487681
20180821,"PAYMENT RECEIVED",1251133114,0,fe4c52b16457a83f41959e0fd52401d53a40747cabbb234112a07f480cf2a29a,37996499321
20180821,"PAYMENT RECEIVED",1255836287,0,afae655e931214e2dfd821b0cf7619215199a29ac3f518454d79b694f6ccdc35,36745366207
20180821,"PAYMENT RECEIVED",1273842864,0,b1c51b1482b6bba84f1710f3b5e788317dda5df0444c7838d87a41c6be0301ea,35489529920
20180821,"PAYMENT RECEIVED",1250020517,0,dd133aabe3721e05777775e06a67535ab7d3b2a65efc0f8acaa8552330ffe946,34215687056
20180821,"PAYMENT SENT",0,-30166156104,a4ee2593aa1faffd53bcca4c3c8f4c68028f222144da9304bd6b3dd9976f2a2a,32965666539
20180821,"PAYMENT RECEIVED",1265366990,0,a02bc4e05a3f8884542c8fa329c7dc3471885a37b7345ec223bb407b2300f1d0,63131822643
20180821,"PAYMENT RECEIVED",1266824431,0,3493c1c6ab96a84496cc91436950d09dd8600a5fcbc7cfa5ff5c530929462bc5,61866455653
20180821,"PAYMENT RECEIVED",1257200059,0,9915fd02a0b793140ef4ed0ff3f4a0bf4dfed9bbd6b499d715e56d9a151a1c4d,60599631222
20180820,"PAYMENT RECEIVED",1265478469,0,59f4075538fbbc5cb76cc1dabf97fe7f5378af03e8a838451e12ade65ca21b42,59342431163
20180820,"PAYMENT RECEIVED",1253078264,0,915c2dd3fa177948f6ec420bb1b5e38ab4a2a870f96e4e62ce2e43ed8fd22aa6,58076952694
20180820,"PAYMENT RECEIVED",1322064528,0,904a5e622423d08d6d8b46594df059dc537a9e48cfe50f7775eb9255d8baf223,56823874430
20180820,"PAYMENT RECEIVED",1259036239,0,c8db858694d1958f512e50014490b0f79e9f579115b7cf5b5c273f52c041e0fe,55501809902
20180820,"PAYMENT RECEIVED",1254008536,0,9079b356355aab582d9bc10f14d228dc4b9979ebb0d197f0ef34518bccd321bb,54242773663
20180820,"PAYMENT RECEIVED",1263836399,0,55da1f28fc26b1c3a86dfc5b10b8aadefef355ed8200768d363cd37f07394950,52988765127
20180820,"PAYMENT RECEIVED",1255870738,0,b6da77995f7d13767a89c53934271239cf7d1518c1898b1b1e10dbde2d899e5b,51724928728
20180820,"PAYMENT RECEIVED",1253564337,0,c3ebabe769c5f38c14df6522443cab24354e7455d25650f0c2686ac8197d9d75,50469057990
20180820,"PAYMENT RECEIVED",1256186886,0,1b7db4c94ef388080302f88a6111381f2cf71ddc8e4c7d0b3bcbddf1c9d59728,49215493653
20180820,"PAYMENT RECEIVED",1255725704,0,df9c4dcabbfff155845972888cfb875c8fd603163231692505e9328fe3e6aa12,47959306767
20180820,"PAYMENT SENT",0,-28862880643,c79a8673b2ba74cdfe6bb6000b0b23aab184b69db5d50f885d6eab8ab319d0f0,46703581063
20180819,"PAYMENT RECEIVED",1251768464,0,3d86e0ee21fa4317c2b74c4e658a2c597225edf72743ec6050d2067e64d331e3,75566461706
20180819,"PAYMENT RECEIVED",1272888513,0,d99cf367754979f49a847c7e296c835b50455e8e1e4d0392f15e4b9cbddc7230,74314693242
20180819,"PAYMENT RECEIVED",1281053623,0,bffcd95e052786f62cadb6766df210ea9d7869c0a6aa9f1d5efd3e5c0492b320,73041804729
20180819,"PAYMENT RECEIVED",1250222197,0,af1c1ed49cc80b81ed7d12d3358db11821b9b05e9a5d05925ab2466192478d5c,71760751106
20180819,"PAYMENT RECEIVED",1251662127,0,d855a5e02f0cdd51b251d4973da50b234b5db90d4a8ac5d0168583af42f9fe67,70510528909
20180819,"PAYMENT RECEIVED",1254374080,0,6e3ff2906bae4e75c7f86a4e04c0d18b6ae18c0d738485e87c53037ce22e83be,69258866782
20180819,"PAYMENT RECEIVED",1256505091,0,5f5cbdc858a999b8182c12a462daa8d62eaeeea2e45cd87f33f790cddae049fd,68004492702
20180819,"PAYMENT RECEIVED",1259910973,0,1ea3dbc054f2bd0e7c48dd8eee675903a308c73cc4700c9daef8d30d44542b29,66747987611
20180819,"PAYMENT RECEIVED",1250212676,0,53790850bfc20d099c951e369f7c905793435798f2d1102a95aa176dc5a53208,65488076638
20180819,"PAYMENT RECEIVED",1252295360,0,4f04121ae341f99f93ffd88e85b7661b31a5fda10fae774591765188077a4c58,64237863962
20180819,"PAYMENT RECEIVED",1281602118,0,d0daab5014d280525bb8af2656dc1d41557d473bf555cafe072eece3015c7eba,62985568602
20180819,"PAYMENT RECEIVED",1250830728,0,824f31ca72ff151be76fca0a75d16c6e8b6f7eb1f8807e267a122a392733e678,61703966484
20180819,"PAYMENT RECEIVED",1252476415,0,c6efa506629cb6db2cec1de4cc6a8fe9e1d4a68c85627471618f38b39e2237a0,60453135756
20180819,"PAYMENT RECEIVED",1250686513,0,8f604d374bb06233f49a7b30e3aa1b545ae44cb9c8412359a00f92716cef2d88,59200659341
20180819,"PAYMENT RECEIVED",1270340403,0,1c9dce8ce9495e602a69ed90da129686931bda5581464cb6d1e1fd12bd271337,57949972828
20180819,"PAYMENT RECEIVED",1250744562,0,134b6afad2088fabd9ed3a3ba571466b022a1d84e60cd3772ba7bfa9c90068e9,56679632425
20180819,"PAYMENT RECEIVED",1263211111,0,4138a37a2a74d49a193ae6f708bcf06dc2422243556530d5ef7e43bead810e4d,55428887863
20180819,"PAYMENT SENT",0,-30140978258,96a61c8961ba3bd44ee67129868d47009a963a3433ef671d26e7a823c5687dce,54165676752
20180819,"PAYMENT RECEIVED",1250083908,0,a7645c2d5f69301b07bd9ab10e567b690a25b784431e57be0389130403c878c3,84306655010
20180819,"PAYMENT RECEIVED",1267402136,0,14c17c8142a338ff23e701c03c4fc3fdc81018e3476f2fbcba84ef62bb62d8bd,83056571102
20180819,"PAYMENT RECEIVED",1250391769,0,6948a84607db9514dce18fe63cfa2a5a5f922e802ae052fa826b7982bc64583e,81789168966
20180819,"PAYMENT RECEIVED",1250024322,0,e5c4e8c76986c87caf2d4b84c8fa9aed3c6c4967d65dd2b366d7a062399ffa25,80538777197
20180819,"PAYMENT RECEIVED",1258789821,0,d3c4ce299e0ee798ab4a7d8a65fd5268be0338da846e8cf7c3c53eabe7534690,79288752875
20180819,"PAYMENT RECEIVED",1250024106,0,bd8ea602062d950bc8fe7cb8a466941ae8e5eac7712847ba59648503c87cde70,78029963054
20180818,"PAYMENT RECEIVED",1252847386,0,17b6f106a40aad1c079b9e5d77c36e8932e62f583a171e6cac5892abc5da4bc8,76779938948
20180818,"PAYMENT RECEIVED",1259389325,0,423cbe58227182e087997d24d7b5b9b22699dada9ea234eb7dd056360679ca7e,75527091562
20180818,"PAYMENT RECEIVED",1250000000,0,9800d042e8b8d07cde592e35ac0fecf89b787d50079b24897dfa6ac17a6bfee1,74267702237
20180818,"PAYMENT RECEIVED",1251659906,0,9e4c5a2eef4fd40b5b20e83d09e706febca64e358891349b57716f0b0963f6bd,73017702237
20180818,"PAYMENT RECEIVED",1261828706,0,0c697e30c0f78bd49c19f121bf789d40c71e4eb6951373cbbbb4acd6f125e21a,71766042331
20180818,"PAYMENT RECEIVED",1265250280,0,1d26f71759772349e3959f352da079100a9a036ea3cceef1e9c8bc7f5b462f1a,70504213625
20180818,"PAYMENT RECEIVED",1252464241,0,2a6ab2b6bdecb242913354939106b5503412f638610900b78233ec311e57b752,69238963345
20180818,"PAYMENT RECEIVED",1250000000,0,e45c4e9e5a69d039ed4b576540716c3d13d6bcda88a86e1aeb8462da66795d4e,67986499104
20180818,"PAYMENT RECEIVED",1252665773,0,0a1b70c218a99ee7b7b8117f5f11d3dd8e65b7f2d5b42e5fb7ed7309cc264093,66736499104
20180818,"PAYMENT RECEIVED",1250298493,0,9250b46ceebdd20dd825845ffec9742b8b0a9d023b54dd1aa0bce8426f344e33,65483833331
20180818,"PAYMENT RECEIVED",1255095852,0,95d4936d691cb926a548c6dd1ed13109016df5cd1c6fe3fd22db123725e89da2,64233534838
20180818,"PAYMENT RECEIVED",1252400389,0,44afb049cae00fd4dcd0a5477ba5d0b9fb0ef489272cd8d7933615f731dca6d1,62978438986
20180818,"PAYMENT RECEIVED",1251702431,0,ba96f56be261282fb0514c935cb804ce168908428e37152873c5ed474e979730,61726038597
20180818,"PAYMENT RECEIVED",1251800973,0,bd7f4b2261d0d2cf2dccc9e37b9de9c0319bb256e1d6c7c347a72a14e5be236e,60474336166
20180818,"PAYMENT RECEIVED",1257377165,0,f5632be62b07b3fcaaa5e8b9c535469de6bce784c463a840a10507b2f4d0ead6,59222535193
20180818,"PAYMENT SENT",0,-10062789222,b157349a4b0079c16128580dc7ca4569c9849d18849b4c8983e466b66976264e,57965158028
20180818,"PAYMENT RECEIVED",1257318911,0,825944f63978de9a8d68a8eec973b8342abaed95409678721a1dc4b2d3f79850,68027947250
20180818,"PAYMENT RECEIVED",1251837118,0,9a416521f86770c8130b6a7913110701dce23b0ec9df58289bbf1c932ed6548b,66770628339
20180818,"PAYMENT RECEIVED",1256176457,0,95409903ab87baa8aec41cb027913102d36b523b3c0affdab7636ee1698011c3,65518791221
20180818,"PAYMENT RECEIVED",1256358144,0,4275a19bf37e2671686020273092e45e36ab49d72bf22a0b0a0c412eacd2c007,64262614764
20180818,"PAYMENT RECEIVED",1273884361,0,19fec56fef4a42f40dc95e1bc0693e58277b55d120dd0d9b8901b4c3fb455e02,63006256620
20180818,"PAYMENT RECEIVED",1251757684,0,0b60a5b85c847e8d8832fb1825ec7f8dceeccf1d98adf2787c415a2399804a22,61732372259
20180817,"PAYMENT RECEIVED",1251511891,0,7e4706bc54bb72ad87e2ff9ca027d52b77f2fc744a62b3ca902bedac422c1428,60480614575
20180817,"PAYMENT RECEIVED",1262344563,0,9234c54d731e4e9f0bb58c967ea8e2f52d5ced178be77d9bc90ee39311e8b4ad,59229102684
20180817,"PAYMENT RECEIVED",1254625778,0,8c3e9042e6b0b3a296dd3e3436877b5b948d97b7acc27f5300837969b5f85041,57966758121
20180817,"PAYMENT RECEIVED",1255763845,0,cfc33c3e9a67065dbee0b596ea76df60d3989498dbee81e9f04cb0f6ff4e5e72,56712132343
20180817,"PAYMENT RECEIVED",1253625431,0,d90f2708b5497cac11c9cc15748356841d6e6a88745f148ea4cf5d58e16c9497,55456368498
20180817,"PAYMENT RECEIVED",1259713188,0,4f743d1783f3e39767c292fddfdcf93009580da84e4fb9e283871f6f1b4f509f,54202743067
20180817,"PAYMENT RECEIVED",1259921349,0,06d535781c55c8d6ad0e6a23fc5d896df2a89ccda616a1bd823df7790f9649c2,52943029879
20180817,"PAYMENT RECEIVED",1252505840,0,f2f8a18bfa60c37e0e75fbba860bbc3798861a937947ecb2e4ec71f2bc4724c8,51683108530
20180817,"PAYMENT RECEIVED",1250283471,0,95cbee9ba3af59b6fb47b7b349fbb1af541d1912ab5602ee649eee0237a84396,50430602690
20180817,"PAYMENT RECEIVED",1250016443,0,3954b8290c3f73ac09758f6a060e695543858dbd17255d7ef32807ce5f839987,49180319219
20180817,"PAYMENT RECEIVED",1260828051,0,b655f41fe711573904113bc6f2f5719776e182cbee5ad2df5aa09a9c317822f0,47930302776
20180817,"PAYMENT RECEIVED",1266752402,0,854c4018181062bb26f7663369682c5a14858fb6b17b3e5b58a34f595f983c58,75950840374
20180817,"PAYMENT SENT",0,-29281365649,e01e2128154a64819c6274ca64fb283ba60457e600815a56e4a5d8462668be53,46669474725
20180817,"PAYMENT SENT",0,-20070827071,7e3c5f2a0e96fd502b708876c65c7bf120b2b6f2cfa997a61273c6268e5de714,74684087972
20180817,"PAYMENT RECEIVED",1258415554,0,159a13e2b310dcaf99e18d2574edec626fce2dde2800e3524d3c56e3733ab77b,94754915043
20180817,"PAYMENT RECEIVED",1311099166,0,fedc64eb8ebf9643ede168a229a020747c1cd70eab62b0c9dbf00d209e6663e6,93496499489
20180817,"PAYMENT RECEIVED",1256519776,0,34dbc8425c1d2cc44687c09aeed376fd50d9deef88224c2a851191d689d16d1d,92185400323
20180817,"PAYMENT RECEIVED",1254230811,0,728dd60dbfaee519368fd733ef283423978f3bf43b1de581721ad8e784984f5e,90928880547
20180817,"PAYMENT RECEIVED",1252004242,0,ea5dc758b074436e7ea74c5236536d67bedf76d611700f38add6ed0032269434,89674649736
20180817,"PAYMENT RECEIVED",1254332953,0,a1c78ed843a24da4c289c41f2c1a16b576e2e25a8402db65f974c58b7804edd1,88422645494
20180817,"PAYMENT RECEIVED",1250965464,0,4092b90227c00f4412a53ed42ade84d474f0d1fd063bbfc6ff1e4755e74d881a,87168312541
20180817,"PAYMENT RECEIVED",1254478253,0,a2206645c7df43643c5c717358bf3a8625729171acd55ef38c714a008df8a99e,85917347077
20180817,"PAYMENT RECEIVED",1251231792,0,efb6f29d574ae4b4dcb40bc330414a137d8ffc1a80004399f41eb63b70ff9316,84662868824
20180817,"PAYMENT RECEIVED",1256382892,0,491b156821274027897a9f69e56c3dc8833f5c14b0f69c3d317b20048d9200d5,83411637032
20180817,"PAYMENT RECEIVED",1265049376,0,d004b146095f94d3ef3e7500f6e5d2b4459fdf5f568439c10fc6615dbea14027,82155254140
20180817,"PAYMENT RECEIVED",1256227731,0,8b0e86b2f3ec355098e735cc0932462c7864d1b512e6125edf3f5718751dadb7,80890204764
20180817,"PAYMENT RECEIVED",1260247921,0,63677496afc177a7c3e273eeba6147b74abfcf833489a7b48246c6e454ffa0ac,79633977033
20180816,"PAYMENT RECEIVED",1250100741,0,81d3f63ed1fcb1c01f64eacd110006b765a0d51c3a56f389b827fe6c7c3432f6,78373729112
20180816,"PAYMENT SENT",0,-16601009398,0b20ffb9ad75d3388f1201dbb6aab5927ced79fec0f795d166cda1cc456e26c3,77123628371
20180816,"PAYMENT RECEIVED",1260588555,0,42b4e7b7d25854d7b458a0576790152542c214f6c5fd900e4f4c155c0493f086,93724637769
20180816,"PAYMENT RECEIVED",1276155248,0,1e212591d9ad655b579af7cffc2c17a93e68392f2b6accbe04cc5ebca2baeaea,92464049214
20180816,"PAYMENT RECEIVED",1269141604,0,541c953837f34950a99d89f472c1e3e0d5f4f4e2211298706311576820499e96,91187893966
20180816,"PAYMENT RECEIVED",1261692657,0,e2b34363b64dd679d7603e9eb4c816f96c9050d443d6a0d0ed13da12c7cd663c,89918752362
20180816,"PAYMENT RECEIVED",1296773368,0,57246902d982f0dc2054c0b45c3efd0ff5b8efb36a094d2bb34ede3a8b982f14,88657059705
20180816,"PAYMENT RECEIVED",1284019427,0,f9fad924d3dc08403bf0a1944f83e223faaebd5e39ce91f85b4598298d022eaf,87360286337
20180816,"PAYMENT RECEIVED",1264597195,0,9b2dfd06db852dd6e36f6b2426221a860c403340dac8586f3668bfe4a0bd2125,86076266910
20180816,"PAYMENT RECEIVED",1275595237,0,dd4e8d991939129783215112e7245da5c6ae2cd1fb30d1d4254b538f4589ba66,84811669715
20180816,"PAYMENT RECEIVED",1257260531,0,a65385b5a6fc0960f649e89ddd0b183c8989d1f43f70b0e7b20f699a1b91024f,83536074478
20180816,"PAYMENT RECEIVED",1267241236,0,ee2d0664e2e8b7bed5e5b171ce24164b5279e565c93bece2d0a3d857eb70e32f,82278813947
20180816,"PAYMENT RECEIVED",1277889871,0,35bd059ff38b23a290e39dcbffc247d6c0fb224034496c15d942222510e00a18,81011572711
20180816,"PAYMENT RECEIVED",1250769295,0,1d83bc46404653ad5a9ae6740a75c81880e1ea87c53f9c125b3b7b4538f495fe,79733682840
20180816,"PAYMENT RECEIVED",1250040809,0,f879ace017a35e2e2f8f8b7ec2b335b1f1d6f8ca69a18f17045ef913dba25ad5,78482913545
20180816,"PAYMENT RECEIVED",1250001620,0,bc16cf96b996cf378cd792ce4593f371bec6ae245d3c662600d5e7c29074794b,77232872736
20180816,"PAYMENT RECEIVED",1253012221,0,4d1c722d07829a4eaa6df73d0d82dc92da8a13eb5a211339804cd1db0692a007,75982871116
20180816,"PAYMENT RECEIVED",1267773958,0,e3906d93c59f3ab3dbbb77aac5834c4ffe29a9700c3ce614fa7bd9cbbfa2a48c,74729858895
20180816,"PAYMENT RECEIVED",1250046147,0,6a5919a82c519d4ba610a958cbe841a0d04c49ffdffeb5e3262f08ec563947ae,73462084937
20180816,"PAYMENT RECEIVED",1258284353,0,9c2c44a4df5807483db08168ff73490cc4998c6e757497572d9403a854b3bd10,72212038790
20180816,"PAYMENT RECEIVED",1258539008,0,dbc8ada31098374715b1aa6aac6cc57ff0298d13df2f16c4354aef6a2e75c1f1,70953754437
20180816,"PAYMENT RECEIVED",1259843776,0,e171307978592a8b49a75bfe15b76f275ce30125378ca63fee1e308bb45dde2a,69695215429
20180815,"PAYMENT RECEIVED",1253281726,0,0881dba563e4c8c8ee02250cb9b8321f5da918c2295c951d451731da60d2d91e,68435371653
20180815,"PAYMENT RECEIVED",1257035612,0,facd4d4ec29cc645a0b8c3432797d0a3c5040e247d3b8c8147e5b075dae30d5a,67182089927
20180815,"PAYMENT RECEIVED",1259319975,0,d59d7486ec6f9a0957cf16ae46743f558534349344d9674f52d964b868b062fa,65925054315
20180815,"PAYMENT RECEIVED",1262136852,0,ac39f2a880e314d56b373d67a52150922e0a9cc70ea6d1318b7ffeeb6f5b965a,64665734340
20180815,"PAYMENT RECEIVED",1252570934,0,826f5a300ca670ab7ad6e68272a8fddf143e56842ba65d52d3a5b6febfb6dbdb,63403597488
20180815,"PAYMENT RECEIVED",1265253575,0,d88867e7540574c9d79f7e4ac6464ad80827c1d598c70f55a4ac27ec91936043,62151026554
20180815,"PAYMENT RECEIVED",1259144329,0,79fe55705648c344bd02c8830c4d258531b381e8194168cd5594f5a2f5bf966d,60885772979
20180815,"PAYMENT RECEIVED",1258229680,0,e6973de7a782de6318de28fcf39df27ed3a70d0ec3d2272b3a0b41bcae5911ba,59626628650
20180815,"PAYMENT RECEIVED",1299895800,0,477fd4b3ee77aa7b64d2671149912f4b85d23492d17a22df8babb8a23765f592,58368398970
20180815,"PAYMENT RECEIVED",1309002830,0,05203493e07abcc5a995ece38ab7545f30107176cd1bb600966d2b9b32fc45a0,57068503170
20180815,"PAYMENT RECEIVED",1257336199,0,2c7534b454b4e67800ce740e3901c69e9d621c8601d2bf7677aaeefcb41cfab0,55759500340
20180815,"PAYMENT RECEIVED",1254443585,0,4b4af06ab8a9bfe495de2ba70a4f8d7916bc79f8a52b8e2df72a631bcb7c93e4,54502164141
20180815,"PAYMENT RECEIVED",1262183162,0,4e48de34011ce6a54d1613b587f9c8521696f8bc70f7b103f797ddbecdabff95,53247720556
20180815,"PAYMENT RECEIVED",1250987603,0,429f52a4dd6e9f2ef4f2af6429b4d8261b60e5b0c84287f72c6066b3b1bfd24a,51985537394
20180815,"PAYMENT RECEIVED",1254281808,0,4a9008ee785b6feccf90f5a906b149308ac1cc5c5ae72d82053fd1b333b8ad62,50734549791
20180815,"PAYMENT RECEIVED",1251975598,0,04a4316dfabff58b2386feb06024195648886dbccb68dff876edda96a0355385,49480267983
20180815,"PAYMENT RECEIVED",1258710444,0,370c8e054d5c8ad80d3e8ae9be211cc720168b4f0e8365729d9bae52c045b5f6,48228292385
20180815,"PAYMENT SENT",0,-27711280675,bb3701822e13513c9e28e2cfb495267ad85cfc6d0434177dd7da9643016ae314,46969581941
20180815,"PAYMENT RECEIVED",1279281953,0,7564553864a781b40402a0ecd528441abf586ac29cceb45522da57beb33a772c,74680862616
20180815,"PAYMENT RECEIVED",1258195087,0,5315be004fa5c4a2e1534f89506ec86ac9acc9c5f477f0cfb6976b1a9989ae0d,73401580663
20180815,"PAYMENT RECEIVED",1250000000,0,366ca94e25cb5534612e8797624fbeca96cc1e212ea8c8660e863a10002ea10c,72143385576
20180815,"PAYMENT RECEIVED",1259313461,0,4a0da4dd7551bbeeb0025806155760677f1e909b2e7cd1b4c043aade65b8089e,70893385576
20180815,"PAYMENT RECEIVED",1258581958,0,b44442001356c25226c5f1f3e1a692cb7d8288d65c27c583ef09187924666e12,69634072115
20180815,"PAYMENT RECEIVED",1256526946,0,471ae5b5bb868fe6ce2bb059312e7204ab2930d49816975233e180a6e2620edb,68375490157
20180814,"PAYMENT RECEIVED",1250257848,0,bb14abb4d80537f14d06ab53f8b05a0825104f86848421018b463037e7f39a9c,67118963211
20180814,"PAYMENT RECEIVED",1268298771,0,17c75ced85956b3d2ba860e6a350405358302b62ee5412b8303509270d839779,65868705363
20180814,"PAYMENT RECEIVED",1268001563,0,a637d7a56b69691efc5541ff852c925b8501bb5e2b32bf80d9ad4718348ad82e,64600406592
20180814,"PAYMENT RECEIVED",1262079844,0,cb79e8005a5d3a27ce03e89e0bec128258a74ff096e47cca141c9bec35ff75a1,63332405029
20180814,"PAYMENT RECEIVED",1277680926,0,2620bb934362dabbc505e223f1fcbfecc2932996f50e5ba1ebbda601f91cb48e,62070325185
20180814,"PAYMENT RECEIVED",1257378088,0,3cbb453133497f8d1da6f21948940aa96064a1aaab810b8d791e0c95bb3804b2,60792644259
20180814,"PAYMENT RECEIVED",1292754240,0,16e309a3dc7cb7e3dd0de5183b758c4eaf81e237dabc8c6f35def68baa9c8287,59535266171
20180814,"PAYMENT RECEIVED",1276613591,0,9c167934812413dd41a8966f49c246bc83d973541aa64496e46ddae9f0954c1c,58242511931
20180814,"PAYMENT RECEIVED",1273905116,0,a944044cf21eb7027e49ee452ddb5ca3ef86f2dac971c63534ef72c3bcfd932c,56965898340
20180814,"PAYMENT RECEIVED",1276686442,0,a3700eedb240f3d52232d69636e037c1e35744511cb2000d067e1cfea43ec97a,55691993224
20180814,"PAYMENT RECEIVED",1282320119,0,ae8548e147ed8cd6ac78ee21ccc700783bef6691ce54cf74838e9485501340b0,54415306782
20180814,"PAYMENT SENT",0,-30249416773,2fdb5526931cde320f26a28bdff56e1348b7081bec1b26faf4f2ff8ebeffe932,53132986663
20180814,"PAYMENT RECEIVED",1257121510,0,8e8933638dd50773285f4cb6eb48ce218e3137c8c162ec9976d0ad93b943bf59,83382403436
20180814,"PAYMENT RECEIVED",1273502169,0,f78424023b79bca2aa1a750205ce7abb303d7ec5e54dbba0217e65070bb59d47,82125281926
20180814,"PAYMENT RECEIVED",1251886483,0,a46841b93d1173396768ea9a4216516307485e3c772b6748b7da57b050e639dd,80851779757
20180814,"PAYMENT RECEIVED",1252324226,0,0d96a81364a4d4dccde2bb92444ee72b6315e0c80b80b6f6392a8ed8b3f390f2,79599893274
20180814,"PAYMENT RECEIVED",1268626081,0,1dafb302f94da3ef4e3d21d245fd24db34e73fa4edc31575ddfbc417ff6fc358,78347569048
20180814,"PAYMENT RECEIVED",1261515928,0,a3066bd2a1995ff5ed7e5148c4ed139bb885b8e8d56136059e5cb310cfd2ec2c,77078942967
20180813,"PAYMENT RECEIVED",1252394846,0,9c1be65d7f64b1400c878b633d7cf5ba2c329caf44af6c2e297b47a7148665c1,75817427039
20180813,"PAYMENT RECEIVED",1251475198,0,127c6a479a54abf693a5ec3fe91fe82d87323b7df6671f78569ba6a48e6ee633,74565032193
20180813,"PAYMENT RECEIVED",1250308192,0,5ae11d04f8d74f936a86b567d29931516665591758abc7f690dc9c416227517e,73313556995
20180813,"PAYMENT RECEIVED",1252454729,0,a1919f0a8dae6ea4aa30559bd0073762ba8ce022f8b0cf4f191d85fa8f91e21c,72063248803
20180813,"PAYMENT RECEIVED",1254504399,0,9f147913338d8930754b17686477076a87a3156d57e1b38886aff145ec5c3050,70810794074
20180813,"PAYMENT RECEIVED",1267360432,0,fd53a2079990637a9273b238717e9ab27145a181f54a3aece7f4424ccf22c4d8,69556289675
20180813,"PAYMENT RECEIVED",1260864530,0,4d53c1e5e6bc90f999b1ee57048d86a0af741b0ef99f6b08fc71f3fd604a49f7,68288929243
20180813,"PAYMENT RECEIVED",1564,0,92229fccd7333bfbfb941c7b4f7a523d34a89cf22b6387cf248ce6b4d3e6e811,67028064713
20180813,"PAYMENT RECEIVED",1260815647,0,e447b7e53d37af03c8cbca3df976e4f6d566390580c09ea2e8f97478ec6a4585,67028063149
20180813,"PAYMENT RECEIVED",1263502726,0,e7e04f8c672efca3b9c85302e9dc39c1e51cf667ae4fbadc770bd08c9363db82,65767247502
20180813,"PAYMENT RECEIVED",1257357536,0,11c451256ad08911ac0e51b3970d5232cd93a8aacb02297b0d47262e0e00ccc6,64503744776
20180813,"PAYMENT RECEIVED",1264974708,0,d065cbc041a0740d8ec6a65bf39faa400cc13908f67b1629a55876303814f717,63246387240
20180813,"PAYMENT RECEIVED",1312346792,0,8622e8c1a8237012414312fd193a9c20b4bef0d64abc2c79eb43c1e83de83c5e,61981412532
20180813,"PAYMENT RECEIVED",1260149831,0,9cff3129b312645a3655a8b4dc0ba7561c058cdc0cbd5efd46a772bbd5889913,60669065740
20180813,"PAYMENT RECEIVED",1263839972,0,017e709cb3c0d87b1487140f8da65867df9a74de07b3face1e5f255b3ba9ca57,59408915909
20180813,"PAYMENT RECEIVED",1271163506,0,fc8e78ef544dd1dce666fb0f614c5d6e982489008ec413b66bcdeac9b003ddef,58145075937
20180813,"PAYMENT RECEIVED",1259833501,0,69484696afb019bc45fd6c62e0038fa68bddca7518d5332c776d467d4e629999,56873912431
20180813,"PAYMENT RECEIVED",1253084521,0,c4be95b201c582eb174b3f690796e874c01af110bb0e5733760a61aec92db31f,55614078930
20180813,"PAYMENT SENT",0,-28890828441,55cf4dd9065322e2da683f8a9961cf76ab452a27725879582b54b8966f119f3d,54360994409
20180813,"PAYMENT RECEIVED",1260908819,0,fd3dc280a54e7081528c8982ddc1c8e69b789b58c468a323cc922f9738766586,83251822850
20180813,"PAYMENT RECEIVED",1258229451,0,9b50daf001c553a11414ad09199b07eaa494946b38e5b2ef82ae5b9ea1cccf31,81990914031
20180813,"PAYMENT RECEIVED",1278399443,0,89969b392dc99bc1521a8ca6c32a52268af2be78ea6823ea4763c7c8bf6d8b3a,80732684580
20180813,"PAYMENT RECEIVED",1252233801,0,667a51fadac6119ef1ba7f84d6b7c89270fc8a7812912728e2bb86c3adbdecba,79454285137
20180813,"PAYMENT RECEIVED",1261094188,0,a38f1752806e06a2fc85e1bb418819cc7e28725ccaff797840eeadd73ab49fa1,78202051336
20180813,"PAYMENT RECEIVED",1251744330,0,2eb14fe71b35e22b13bfe676c10a138e4d06bd732f512eb20071ed0d2cb1d176,76940957148
20180813,"PAYMENT RECEIVED",1265516747,0,3541ffb7ed6dd1868ff1072d4de854e1ddedddd3074582461658e95eeca30aaf,75689212818
20180813,"PAYMENT RECEIVED",1254917653,0,d41c4f9fce384c27edaa0a4736fe8263da0bf411a12038a2a13a91580eacea0e,74423696071
20180813,"PAYMENT RECEIVED",1256580267,0,ff12cef790468bfded0740545919c63e7f4c7c580148f979883b5ac6b6fa3959,73168778418
20180813,"PAYMENT RECEIVED",1260578420,0,1a19412508bc5b839dd0bccf8f377b174d04b0aa9bd93ea5287677f87d6ecb15,71912198151
20180813,"PAYMENT RECEIVED",1273435323,0,367d5ef3bea9298cc7dc85d026e4966864e5bbe86b6b7211e364d496e4c4edb9,70651619731
20180813,"PAYMENT RECEIVED",1257134365,0,f3259af5a38cc7a363e1c627361b3f1ad466eaf178852ab5e3b454f550702d4d,69378184408
20180812,"PAYMENT RECEIVED",1262443753,0,43aee159e55cb7a466788fe32d576a420bf44d7d75e716715c942bb4bd94a7bd,68121050043
20180812,"PAYMENT RECEIVED",1283797757,0,8d040de1c339a70c521f19ae910b211d9406257486c1f24fe46dca4722d0031f,66858606290
20180812,"PAYMENT RECEIVED",1255979449,0,f0e44a28d9e931bb865472551d61d79c952b8036662cd54f79fda33d822cf251,65574808533
20180812,"PAYMENT RECEIVED",1261659225,0,8d216c96684e0d697ae942fecf0b42c043b37cd6bdb22904be44f0271f108fa1,64318829084
20180812,"PAYMENT RECEIVED",1252462353,0,c5ed55d957953ad07404b348aa765117f47fa08b9a036af9e66deadf93ac4fe1,63057169859
20180812,"PAYMENT SENT",0,-30163036884,839e33cf1de822b995903888fd4698affd8832ebeb42444a448980de571c6012,61804707506
20180812,"PAYMENT RECEIVED",1251232327,0,d9ae59ab52d4bf3181394ec305a2ce44d7f9c3fb9bf4a9854f82af35cea3e085,91967744390
20180812,"PAYMENT RECEIVED",1262225489,0,be665088301017e404ec63917b858ae9de783ea0eb607d14875943d30afdb479,90716512063
20180812,"PAYMENT RECEIVED",1262618129,0,93b04d2870cb4a5e8f58ce81dbcbd4e127c1683140ae7cb386b502317e186447,89454286574
20180812,"PAYMENT RECEIVED",1255111618,0,6861219fa14731314b27d714762a1a9230e17d98d6426d24f26cdf9ebfd359ea,88191668445
20180812,"PAYMENT RECEIVED",1269969891,0,7a04ad0e1019c8cbbbad7b5403a4a2dc969793221db2be375f9e091ad39e1476,86936556827
20180812,"PAYMENT RECEIVED",1266139567,0,d36384ee0f599edd2c984435c257d4806af8d7f0e248b795d9a2384178dfcade,85666586936
20180812,"PAYMENT RECEIVED",1251988203,0,dd479c7947622ee0a3e846eb67f0da8f6f09280a8c244f87216be8251834f486,84400447369
20180812,"PAYMENT RECEIVED",1250962547,0,58a192de4010b2be72273a606f1447cfd0dbc215608e5ef18cb2672d8d61b85a,83148459166
20180811,"PAYMENT RECEIVED",1253601544,0,482b52240a4fd3a8eb92df9819e7ee3af3272b5db8a9cb10257bd037fb25f190,81897496619
20180811,"PAYMENT RECEIVED",1252975733,0,933917d5b308132946b31b6ed17226609ba023da6c4e47ac4163bc6e91bf477a,80643895075
20180811,"PAYMENT RECEIVED",1250537384,0,efcd02b8fb632375157b68f9d947e082e61039ddb6b39debae739170d30dd35f,79390919342
20180811,"PAYMENT RECEIVED",1257767906,0,78d0cf66c5da4f8e3eae2fb32d3b177c34d1353665cc4caed1fcaeaaa5ec5bcb,78140381958
20180811,"PAYMENT RECEIVED",1260177690,0,67b15e2ad1fe49b681f9154c30741d595f27aa7b511e1fbe647a67acc05674e4,76882614052
20180811,"PAYMENT RECEIVED",1253025118,0,8e5e6b148e9209599b1ae116363104e512f7ef698a98fccee6eee882312af6e7,75622436362
20180811,"PAYMENT RECEIVED",1261723014,0,91bd2e14f765a83d9df3122dc49a9ad893e94235ba2b8cfa55d4bc994d6c8d1f,74369411244
20180811,"PAYMENT RECEIVED",1256927066,0,a4f86c9c1641d0dfff766e7c2bb4ee2270bc1cddb3c5638a9fe39ff440dabab2,73107688230
20180811,"PAYMENT RECEIVED",1250138445,0,a5dcc63fe4fe03042374d3fe8feb9da52f4ccb34ef2c9e95e6fec49325cf0ef0,71850761164
20180811,"PAYMENT RECEIVED",1252553251,0,0150b24cf0c5416e011d7d24007a30253fd064a40642d04d8805dafea7218325,70600622719
20180811,"PAYMENT RECEIVED",1253278060,0,c3af7ca82970ac4e9b76511fa8bdcf960e7de3d815763fac8e69b259c4dda16b,69348069468
20180811,"PAYMENT RECEIVED",1256329024,0,03a67edfc46bf6f8a98603580ace943f0fea4a1058b15a2fb3393b66bdf4ffe4,68094791408
20180811,"PAYMENT RECEIVED",1264375573,0,83528dc9de6764d0bf0aa175b591cfc8c7da8b60f1575237e427b6cef9bc0c52,66838462384
20180811,"PAYMENT RECEIVED",1254226880,0,2523cf9a7e4fe79101f09cc4c22c759caac55951568625ff2fea0d0759fd2278,65574086811
20180811,"PAYMENT RECEIVED",1260316476,0,45e1df98c866857f492c592d40c414d4fe60169acca5e7199f2e163017d5489a,64319859931
20180811,"PAYMENT RECEIVED",1252834593,0,b082700612595529350edfbe785d4d9788dc4f01d0fe715ba08a0e3b93339271,63059543455
20180811,"PAYMENT RECEIVED",1250471191,0,8de0d2e4c83c1a4f738844d8f178c20a0af7b62ce4c63cf2f12f23d87be2df74,61806708862
20180811,"PAYMENT RECEIVED",1251078184,0,e81f9555622f967bbbdaa151bf8ce428411bd8439e35705dc720f0a7875dc1ba,60556237671
20180811,"PAYMENT RECEIVED",1256452203,0,c7be62dcae5115942a5e4b0ecbcced388c2cc6aae0c7ba40f3f5cbc6fbdcfb19,59305159487
20180811,"PAYMENT RECEIVED",1271771997,0,1eb5da08cab42a5f415e64b06903d67f6e683e76a2b8e6891fdce599399524a1,58048707284
20180811,"PAYMENT RECEIVED",1251206857,0,f6e6f7b62837b7ae71cb35b064f3e427190357cc448100b58d49f855f9b78723,56776935287
20180811,"PAYMENT RECEIVED",1253410519,0,58e80ebad69234f0163fe96bf9581c436f9ac4a4e61b144a2552c3d20311805d,55525728430
20180811,"PAYMENT RECEIVED",1264119767,0,138601c36ea0e4a0b2b97a1a199d7eb7c417efbaf912ec7ec72476ee093f13bd,54272317911
20180811,"PAYMENT RECEIVED",1254309539,0,a9ecb801aa63433cbd491b88c9d146da12c1f881d240f235b4620c39f4c1d35a,53008198144
20180811,"PAYMENT RECEIVED",1254525190,0,29b9c3f872cadaf82a61dfca901a223ffa07d4d7670f8c0590a1de5f44802173,51753888605
20180811,"PAYMENT RECEIVED",1252942650,0,3e969bcb3bad1542eafb16bb4faa284964d08a87a7aa915fb2ad62c42b77d0bb,50499363415
20180811,"PAYMENT RECEIVED",1250056885,0,9cdbad17e7d644ed651f686516a537cc741187a55d40a7d6b106b707ae1565c1,49246420765
20180811,"PAYMENT RECEIVED",1254320623,0,fd54689ac776a0cbc9914e79fbf80de6bc24ac6d4d827741de290dc143f01395,47996363880
20180811,"PAYMENT RECEIVED",1256290604,0,5ba6bb7e431dc283393dc0493d1076dd14eeceb5663972e01484c895a5f0cbc8,46742043257
20180811,"PAYMENT RECEIVED",1252602800,0,befaa96ede5ff9f1a98d2b8350fb65372f96c08dbf08eb9510201e851ec33281,45485752653
20180811,"PAYMENT RECEIVED",1250479028,0,f8305fca1ea229ac3b6bc86c306722b1fc8bc3034399139d377e19bf3d49dea1,44233149853
20180810,"PAYMENT RECEIVED",1259505394,0,d2ab66576a591d31e7401631bb8ed0d419093beeea1f9f33d5255f28cec08e6e,42982670825
20180810,"PAYMENT RECEIVED",1250546956,0,36fae4b87ea4f942bae8992061de442da3b6ebc2eff92a026753a51317d311dc,41723165431
20180810,"PAYMENT RECEIVED",1257025934,0,a861f50bc8251eb25d9f65e8354c85ac873b08d4878e8dd67f6676621c75d893,40472618475
20180810,"PAYMENT RECEIVED",1259365038,0,7fb173244bfd3bffe332d3a01209ee452ea51c11e41d6433ab85e6452c36b272,39215592541
20180810,"PAYMENT RECEIVED",1267928110,0,b8f10aaf7a7fa20e590d58fcbd7c9e9a376e20128e8472b2388ff06cb3125e05,37956227503
20180810,"PAYMENT RECEIVED",1269343183,0,7fe8922a8b69a7f7f3cb5ea5c22ccb8dbd36a7a06c4a7660994b3d391217f76f,36688299393
20180810,"PAYMENT RECEIVED",1270730716,0,4212eb533b18dc8b3a4e31474e21c5ff56db937e72a30140292483deebabe838,35418956210
20180810,"PAYMENT RECEIVED",1271672675,0,a6d3de9704ee7ae4711473d9935776cddbae4203c69453f5d6c0f9c968dfda26,34148225494
20180810,"PAYMENT RECEIVED",1292486754,0,a7cc3c5a8e4c1bc2e56ee34fd176c54d817851930594639f51fee1d83f40798a,32876552819
20180810,"PAYMENT RECEIVED",1254423781,0,96a51e3d48f8339f1302563170e53383fe452236892c2f41f746766347240d29,31584066065
20180810,"PAYMENT RECEIVED",1250534648,0,d64a3b20bacd5f712085baeb8ad52306e4c45b76e8a0d4a39ec912068ec46c70,30329642284
20180810,"PAYMENT RECEIVED",1256291561,0,1e2f81d05f22ef290b2c98efeb3fbc07ae8d72223a8e6020fa7d3ac3b4a5d055,29079107636
20180810,"PAYMENT RECEIVED",1261675768,0,365e61dd994b2a256ab404db7ea455ef7e8839a9e0991ed2d7f4ea4c4bd6c280,27822816075
20180810,"PAYMENT RECEIVED",1259901079,0,8de8c713555721cd79eea411eab38847a6369ccffa42bd1f397f662d3f69810a,26561140307
20180810,"PAYMENT RECEIVED",1261047169,0,f9a7dff4af8d0d9ae0e878cfabd2a69ce857b82efe134eef21fc25ba14789569,25301239228
20180810,"PAYMENT RECEIVED",1266292739,0,d5ab3b83d16abcf674bbc99eed3188c3697f40cad0c2838bd5fad57e39cd60c6,24040192059
20180810,"PAYMENT RECEIVED",1292529039,0,ffc71afa909ee698f5215310623672bd2f7503dadd71ed11a194cbdbf5b8b347,22773899320
20180810,"PAYMENT RECEIVED",1264952115,0,4ac3e5a5802974607c99add51748708abb4dd30b130c71b2df28714c705130b5,21481370281
20180810,"PAYMENT RECEIVED",1265399123,0,fab0f75ae28d5dbae3c7205aee150e9b8cb81cd6b0509386973c413c983c55cf,20216418166
20180810,"PAYMENT RECEIVED",1270301790,0,4874666ab0299aae5fb612f9ef388a4f7aa0646c2ac0a270974420503082f8c4,18951019043
20180810,"PAYMENT RECEIVED",1250593827,0,6a032b854b3cc6014b89ab120080a10cf1cea8abd5988866d9dc237c8ce861aa,17680717253
20180810,"PAYMENT RECEIVED",1253124054,0,21bcf98e622dcdaf3731fe7d0e6f712bf2c3b16e9f1ebba5f7053e699258ac54,16430123426
20180810,"PAYMENT RECEIVED",1263521166,0,619ab3203d7738dbc6e67c1c3a82b69b750afbc8e2fd0a4bcef0f18ad975a8c5,15176999372
20180809,"PAYMENT SENT",0,-13890419570,bfb45b2f731d74e1fa200d53d9b966e515fc75e142ec3cc89771acc6fee5501f,13913478206
20180809,"PAYMENT SENT",0,-5054351371,a071e34fcb6df4f441de24444597446b4fe84abf0376533cb2ab422490876ec9,27803897776
20180809,"PAYMENT RECEIVED",1273794865,0,e57e1ac5b7597a00f96e3a750ad0f5b41ca53473d71209e727d82ea61142d56e,32858249147
20180809,"PAYMENT RECEIVED",1268952464,0,b5f4df5022963f461571a978d67b0d196a0a46c08ecc1e74f6cc7f3b282a84d5,31584454282
20180809,"PAYMENT RECEIVED",1253642296,0,f15daffb7f47ca529f95f16d68d95abceb634138a2233d7a5247e1a71eccf48c,30315501818
20180809,"PAYMENT RECEIVED",1260427381,0,ab4b7ef2fb20f060a2afc577f84be320c921ab592bf4d3d7aeaaf7a844b25e99,29061859522
20180809,"PAYMENT RECEIVED",1263646744,0,3077f894cfb3191f9b17e50131e3d90f4f206dc14ca0cabbe72788b4e2cf2546,27801432141
20180809,"PAYMENT RECEIVED",1291132565,0,007ffa2763ad9cc698a0d20733010125cb7f8b7368c47d5d57bf84a3945a0501,26537785397
20180809,"PAYMENT RECEIVED",1277886860,0,d9bae9ab104d3cfcbd356977eb5af7bdcb3809d00788091e35330809cfe5490c,25246652832
20180809,"PAYMENT RECEIVED",1259599132,0,22e33f03e6fc18cd116d7764b82d73d69320c31db1330b637b2de263bdc72e1a,23968765972
20180809,"PAYMENT RECEIVED",1250642218,0,c0e14e84fed53976368bc2d97fdec7bc47973976b1e0c48a1c75c28ba36b8c56,22709166840
20180809,"PAYMENT SENT",0,-20185516270,06b0b3a7c0b62865be719f1dec0c5ef9101b40eb285395d8d3859bf7db0b982d,21458524622
20180809,"PAYMENT RECEIVED",1259896536,0,2769b317a720f9c86ccc2cfc4048956c51d825683b9eafe8c1d4ad20318b0fe4,41644040892
20180809,"PAYMENT RECEIVED",1253857145,0,cda0a0154dd1bae20e2793e94d65255f30e82f6fff8a1fb1f7ff2a5f62d00667,40384144356
20180809,"PAYMENT RECEIVED",1253386275,0,a63df38259fec463c18e5ed8f7f078cabb9fa30bc991fd46f9c3d1c210a5f492,39130287211
20180809,"PAYMENT RECEIVED",1265365190,0,cb10d6f5e2830ac97d31e6d62717fe56830aeedab0528b28b556332ffc542770,37876900936
20180809,"PAYMENT RECEIVED",1271160824,0,a2773c8ee9c4be560fa9e81c2c3d9ea72e728727e9fcf001e183487bdfe51933,36611535746
20180809,"PAYMENT RECEIVED",1267571277,0,a41aa2613f7e41b1155ee654920f6dacd5e2cda2f3f08990991f072eefb0d49a,35340374922
20180809,"PAYMENT RECEIVED",1262567188,0,be7dc4cc4651e114edc2a0881f3a0aeb2ebd91ac04dd26dd6bbae1a88a066f9c,34072803645
20180809,"PAYMENT RECEIVED",1251237573,0,38914e65e4418e45ae81b97deb6773a6becb83fc5e8221ec03daa5fce68cfe86,32810236457
20180809,"PAYMENT RECEIVED",1261259113,0,35eb3cc469c5cd98b02a4d15de79e88d7a7556bc4b25eb663dc207598cc286c1,31558998884
20180809,"PAYMENT RECEIVED",1263064620,0,6388941a360bbb2a41c14d1a4dff973e45136b5c8fbeaa86d870ce7a9a690120,30297739771
20180808,"PAYMENT RECEIVED",1271626883,0,6c563301305a5cfba7baf7b1756656eb8dcc3b01d66ebbf209c9027dcebe2a3c,29034675151
20180808,"PAYMENT RECEIVED",1258045685,0,2c9a578340e3df09340a22ade0ae0457b5fc006d6501b801351110433781cfc9,27763048268
20180808,"PAYMENT RECEIVED",1265134942,0,f71037cc0c3260d3c267f99e850947567860d9e0f2d3dc1138ff201c56957e33,26505002583
20180808,"PAYMENT RECEIVED",1250423683,0,4da49522bc35fadc5972c28a731880937807495487c02d3cd7f2240caa2bcede,25239867641
20180808,"PAYMENT RECEIVED",1256785155,0,94d2e3f56fefb6a7183f59f000631614359dcc65d07fb615a94d7aa0089c35c5,23989443958
20180808,"PAYMENT RECEIVED",1268527866,0,6c8dd34c68a97559a78d99c271d3ce888500dacdc34707dec2093b03d1edb224,22732658803
20180808,"PAYMENT RECEIVED",1278614667,0,cb9520473b679adfbf2644fe4dcde0f45a20181f3469441654a20742fe564087,21464130937
20180808,"PAYMENT RECEIVED",1263899490,0,98bf536034f433f8210224c03bced37904b251ac4a6b085aad43511915d2f668,20185516270
20180808,"PAYMENT RECEIVED",1264425216,0,a0e029ebb13b9945364dd0dbacd4760cadd9b4ed1f60591a3616d85354bc8cc0,18921616780
20180808,"PAYMENT RECEIVED",1250242042,0,917571dfded6379e0d948ee4a23a17a768367c86fe0e565d9a38084d93eafab7,17657191564
20180808,"PAYMENT RECEIVED",1262964337,0,794054a0a23070b44eead2aebb1ce3962b3124fe27a494ccdaf4ca2ae9256d14,16406949522
20180808,"PAYMENT RECEIVED",1257971771,0,85d1793adddbf2611849f25c84da291dc8c0d4b0d476537e7330dbdd9b83d858,15143985185
20180808,"PAYMENT RECEIVED",1283998201,0,e0052a7d282b4c795f08be2cba8327e954952bb218fa6c0203caa5a1b4a6cb14,13886013414
20180808,"PAYMENT RECEIVED",546,0,77c225e5edd8e5de8a4121ba2c8cc243f01c8fa55ccc3a3f6de2498f6cce6941,12602015213
20180808,"PAYMENT SENT",0,-27753048167,a2d2e10f6add839699c3fa602fe3278fae73f60babc5f9e25033b1308f9f8a46,12602014667
20180808,"PAYMENT RECEIVED",1266508470,0,b443dfe50d543d339440786ece2f9a739f1c95c38a4d72791a50964ad57680a4,40355062834
20180808,"PAYMENT RECEIVED",1255659756,0,93a2d9e811b4c2cf9cd6ed498fe94a5ab6a271fc9da57cdc5268b2a3706df778,39088554364
20180808,"PAYMENT RECEIVED",1259228265,0,682d9b18a427c416b8e0192cc3e22e55aba1ffba44b90f27c864424bbfd010ea,37832894608
20180807,"PAYMENT RECEIVED",1250130086,0,dc7a81b1fdd5c552a67e1ce18375c2000b1f7ce403e4eac11a92edd7e41c948a,36573666343
20180807,"PAYMENT RECEIVED",1258325963,0,942471e269ca9271db847796f41e5782191e04c29c14ffe5b6f865ae17a2ec9c,35323536257
20180807,"PAYMENT RECEIVED",1255860265,0,835ca57255094930d9e54b8d736d26cd610f76c5a9382e537933a1d8a51999e5,34065210294
20180807,"PAYMENT RECEIVED",1251556631,0,443f72e60dfb36a4689b3d040be66f7136343cf5bc017aa739bdd450a763d570,32809350029
20180807,"PAYMENT RECEIVED",1263706070,0,919fd059a16c25db9afb80353dfb34d1c78de1cf1a2405e1999e3cf1ac7ac38d,31557793398
20180807,"PAYMENT RECEIVED",1263626125,0,c40aef83b4fb6c70349eaf4da9a8df17a86a8b18c8546c75a3652c01f3310118,30294087328
20180807,"PAYMENT RECEIVED",1277413036,0,44ddb93257b843cd540a7cd89d9605bdca3f6a457e559c83e6bbfe89d02da651,29030461203
20180807,"PAYMENT RECEIVED",1269899118,0,d061f73800d02533a5439427822806e52f310e729c239bf1f0841e34ffd65eb5,27753048167
20180807,"PAYMENT RECEIVED",1253152420,0,98c952a546760fe05fc071a5b599be67163604898b614c9098628bb21256612c,26483149049
20180807,"PAYMENT RECEIVED",1257026296,0,dab094d2bc660c5ad614e43484cfe1a213f17fef77350a0904f144ca4e18e346,25229996629
20180807,"PAYMENT RECEIVED",1268537490,0,5e1b12605011ff611393acfe7ad4a64d4e25c27b4aace96e61518f726df1bb67,23972970333
20180807,"PAYMENT RECEIVED",1257908552,0,5623a4f1cb39f1687fba241870ecc923ef09dc2ccd941e41dccb5bc4d3ec2a20,22704432843
20180807,"PAYMENT RECEIVED",1278707953,0,666a6627ad4a2aa8bfba43d037b98cf29c4b5f36bd9e3d45bb325f97b3d0174b,21446524291
20180807,"PAYMENT RECEIVED",1270707120,0,000b5c2e54e8715be80469c9807caaf15debe669c0d40c26fef077ebd5812d3d,20167816338
20180807,"PAYMENT RECEIVED",1252869406,0,6331c9c0e5f5a7aecc4b5586d061f56a893f16fddec32b2c04cbee79430b897f,18897109218
20180807,"PAYMENT SENT",0,-23904309901,8153a3f44fecb13686e33ffa2b733bb9203185b9fabd7c8ec7c328db5b2c8103,17644239812
20180807,"PAYMENT RECEIVED",1255289129,0,69a32796ac785b2041686e63ac4fae52c167ec490b69d7af38610f43a2e1486a,41548549713
20180807,"PAYMENT RECEIVED",1263718185,0,9daef10762642ba091a3b03dd96c8271ab854e644e3f27854678a5e04f47dbe3,40293260584
20180807,"PAYMENT RECEIVED",1255920028,0,e261745468a4dec3b12944b05ee4bcd0cc315d5ed12085fa32ab80e8fa8bb0e8,39029542399
20180807,"PAYMENT RECEIVED",1269860794,0,eb165fd691acc36c78c3e217579caef34087692746e5768efe17f7dae320ebb7,37773622371
20180807,"PAYMENT RECEIVED",1252056298,0,4212dd113fb529f67ac3e1304ac31ea561aa3cd8433a016e9691e508eaaff866,36503761577
20180807,"PAYMENT RECEIVED",1252020112,0,38033743797c1dc03a4ee370aa673b1db9470761d89546617ba5e4b32bf7d329,35251705279
20180807,"PAYMENT RECEIVED",1253106158,0,fd0d88a42539f04fa386b52189d5e64ea042ed999b12aeb50449acc1bfe02bdb,33999685167
20180806,"PAYMENT RECEIVED",1254865660,0,000a5e67fcb06d9d22cad7da9b57280a529c5c7f58648cc6a73e17a8987f83c5,32746579009
20180806,"PAYMENT RECEIVED",1259221980,0,58ab6016cc39a063577e40d3074832b639ed48a6d84dadb6c4273989373d3d98,31491713349
20180806,"PAYMENT RECEIVED",1254245064,0,af76ea9fb7737e6bb8398508a06a32fdcbccefd8de0da7a2fe104298c21eddd9,30232491369
20180806,"PAYMENT RECEIVED",1257462764,0,3b0864c315c8dd6a01b141f88de07598fdd4eaf08dd927a779db551f0e463298,28978246305
20180806,"PAYMENT RECEIVED",1281390329,0,cec6ca9fd3a8e9a6c65e11f165cbd2370bed6cd8f327fde42e519cfe123d73e5,27720783541
20180806,"PAYMENT RECEIVED",1265084458,0,f6a9238c36d4050333ac9819e799156164f2dc04871e9f40d4a7ef8bf45091b9,26439393212
20180806,"PAYMENT RECEIVED",1269998853,0,78b8f917912f08f60a0034a765ece4f417502412068516acbd9c8fcbc8e49597,25174308754
20180806,"PAYMENT RECEIVED",1253524528,0,e8cb6e6bc0bc0c5922c5751974b14d154c1e6579772fcfc1445c4137e95bdd14,23904309901
20180806,"PAYMENT RECEIVED",1260329562,0,0fd13595c3a278dc8cbd061e4ba6ffae5e1f87f74ea214cc54af12f32a98d3c3,22650785373
20180806,"PAYMENT RECEIVED",1266454313,0,33700fc8275c711f8d0db288a2d1d03f871052111da3e21f4c4433ca57a71b9c,52804732500
20180806,"PAYMENT SENT",0,-31414276689,6687d55fd2930343ac6f129f05a4b2409c5e7519f2848c7190483ffce18404e3,21390455811
20180806,"PAYMENT RECEIVED",1262775143,0,1402b46dd98c4080e62c0610e68c52fb69127c9e9f31ec3e07e21342ede3eb94,51538278187
20180806,"PAYMENT RECEIVED",1254523760,0,d5231a935b326bc46a588c2e5e6aa30d0170de0eeb6510a8f7c8640d1228b8e3,50275503044
20180806,"PAYMENT RECEIVED",1271270414,0,1552ec1c4eba776cd009e66b416dcf9c6bfa3a70c65200163c0a76a2e0fae2fc,49020979284
20180806,"PAYMENT RECEIVED",1256127399,0,3b672c91e5c72c064fb711c963a22eae8e93e18e24902c59f431bb619ae658fe,47749708870
20180806,"PAYMENT RECEIVED",1251106415,0,ef2c702591deeacf0f46ac29af8790d3ce46d9de65e6a8b9dd650431d94cec2f,46493581471
20180806,"PAYMENT RECEIVED",1251642503,0,902e838d58e62c8a3b6d690bfa55c53d3eaeb0ffbdc5c83d310fb7d493b40186,45242475056
20180806,"PAYMENT RECEIVED",1255423918,0,da998972cfc2e0c2ca5e83ac2c682fe87c1eb367526ec418856e92a2fbd575ac,43990832553
20180806,"PAYMENT RECEIVED",1278534362,0,521319836cdeed3a805cd34df4d2e50b009e6d3fa188b38dc458e6165269f21c,42735408635
20180806,"PAYMENT RECEIVED",1250031470,0,cc8267322e045f0a7608b69ae659d137701baa318d415bea62523b0e5127d2cd,41456874273
20180805,"PAYMENT RECEIVED",1254718380,0,e295c3ab31e0ab6cfa064114fe6b033c3ffbc81613e8162af65ece00f9b63db5,40206842803
20180805,"PAYMENT RECEIVED",1251700217,0,c696ca7db9e30cd30ecce2d0d8325646008e23b1d268c4342e2a807fdb283324,38952124423
20180805,"PAYMENT RECEIVED",1259749321,0,5f899d6312a4040d73e9101e82f898692c4ba4f231908926ba2288dda137f9fd,37700424206
20180805,"PAYMENT RECEIVED",1258687512,0,7bf57213bd290d240cde7b4f53c99da7bd994e790032933919f1bdfd1a9d1924,36440674885
20180805,"PAYMENT RECEIVED",1254807679,0,145de7143b91b5c981f1cf0a7380d73a59d940fe26ccc0054b2a8a12f3a91d68,35181987373
20180805,"PAYMENT RECEIVED",1255361365,0,f540423d5a90f7cd973bc1b567425f68ec8d9ba85934093b9296ad499878dd3f,33927179694
20180805,"PAYMENT RECEIVED",1257541640,0,cab3438037496041c219231b56dd6a3be684f4cabe17c03d24489ae61e93ace0,32671818329
20180805,"PAYMENT RECEIVED",1251681198,0,aa8f71715643a8188d8cd041bfa2614f27b0994089804a54c4aed5ee5569a1be,31414276689
20180805,"PAYMENT RECEIVED",1250326255,0,b46432282a7617831ef64dee218b678495857f8e10bd9bd96137f5726f2569f6,30162595491
20180805,"PAYMENT RECEIVED",1253923745,0,77f599fa1d80e0256c9990217b5b891171287526aeff167d293158a51738ace5,28912269236
20180805,"PAYMENT RECEIVED",1252767111,0,0b1492c928af26d0cf0141f4d6b541bfa7cddcaa88f89110c96d4b8e32430a97,27658345491
20180805,"PAYMENT RECEIVED",1274132207,0,267fe9488b890ca56711b3e0eaeab46d3e358f4fdcd6de033d4a220a1dbc6acc,26405578380
20180805,"PAYMENT RECEIVED",1251096494,0,4b8cc9dcb64b58e94c212ef1ac5a4ed1b3c6e3f1927c6749e4177b112ce455f9,25131446173
20180805,"PAYMENT RECEIVED",1255879091,0,434de10eb647f9845a2a75cbd34aff49d24249802e41c7a752409e0906828572,23880349679
20180805,"PAYMENT SENT",0,-1250014639,34fc960ac0347f4e5a45e99a769bc83984a1e7d9719f429e2b203dad3120d829,22624470588
20180805,"PAYMENT SENT",0,-17674660941,aa3df8caeea270cd014d3d086c4e8b69b2a4cf0762a60c83e4478ecd236c5180,23874485227
20180805,"PAYMENT RECEIVED",1252700666,0,2623921caff11bff1efdf660a3eb705776d7c99eaddc8d35cc00f03a1963e6bf,41549146168
20180805,"PAYMENT RECEIVED",1256576243,0,afca0717715ebef597490fdbab16af39e380694d01398fb6d413afec0a084551,40296445502
20180805,"PAYMENT RECEIVED",1253948265,0,427b44478941e5b2ae70bdce7ff3b708108353f78a33da63a2f5c8a0d8233326,39039869259
20180805,"PAYMENT RECEIVED",1254249922,0,64f00bbb54fcd67393da105801021219b8408e545952e0a1825a6ac1c6df63ce,37785920994
20180805,"PAYMENT RECEIVED",1257912575,0,7a5d1c2772c31616b0f8061433466254631e460e5c6c8e6179001d93eace9fe4,36531671072
20180805,"PAYMENT RECEIVED",1257310399,0,6180bf9d95b8fd464a665ddc24c12c72ff67f3891289890986d7c0100003883f,35273758497
20180805,"PAYMENT RECEIVED",1250440265,0,d03cca32a7135c12cea97a85e7598917d354641a1fd47f4ac2b7528ab47e08a7,34016448098
20180805,"PAYMENT RECEIVED",1275223030,0,5d2e87c6b8dc9765773519f82d97fe9c60daffbd6789bccb751c38a7bf183785,32766007833
20180805,"PAYMENT RECEIVED",1262506449,0,0fb7e747e78b0f9a056a9855fe63cd0d4dec48fb84aec8da9887a982a9118f11,31490784803
20180805,"PAYMENT RECEIVED",1255212759,0,979a35b560cb525bb24eb8d9cce0d03367a1d6061ea2b938dafd91a5887cb512,30228278354
20180805,"PAYMENT RECEIVED",1253080910,0,56152abd9cf916dcd128e5c1677ee39bb2db0e2baf02af1375f46b9beeebb297,28973065595
20180804,"PAYMENT RECEIVED",1252471544,0,183280c68840d263c0b22740bcb6574ec82e5c682967ed73ece81c965b8e5206,27719984685
20180804,"PAYMENT RECEIVED",1258205831,0,788c84db485edac1b552c01b77a64382587b7d5114df6f14999d1233b8b9542a,26467513141
20180804,"PAYMENT RECEIVED",1263120218,0,c9741120df4c3da9eb3a41560dd9fdd964cc317dbeabd83ea4d24a30b46ae326,25209307310
20180804,"PAYMENT RECEIVED",1250970066,0,6be1419e62e18f26e94b62f1473299cee4fe7969a42e5744e6951b953977a6be,23946187092
20180804,"PAYMENT RECEIVED",1250000000,0,a65f3ec513e10348e4d2b454847d640c17de262d10cdb197a5b13fcbe756b684,22695217026
20180804,"PAYMENT RECEIVED",1260207647,0,84f0a91c75d0acdd6ab77c3423600a8b2144094cadca928621e03a3d1b03026d,21445217026
20180804,"PAYMENT RECEIVED",1260333799,0,794d9681fe85ffde412f0431fa73fbb80f5ad6a030cfba9e8a7cd564d54bba82,20185009379
20180804,"PAYMENT RECEIVED",1250014639,0,e386b732813e59ef3e3735f0269cfd0b82e270c15e6bdda8c6d38093d7a187e2,18924675580
20180804,"PAYMENT RECEIVED",1266998967,0,c240926fced983b891618574459a0105ade4a5751026fc2f12be9cfa18ebfc90,17674660941
20180804,"PAYMENT RECEIVED",1266480382,0,78bdf079ab093caf9caf999f8cd7eda71dadf52077588fdfa4e5ee0c27134b5b,16407661974
20180804,"PAYMENT RECEIVED",1273490573,0,72a415166da4277fceaaead26052cbbb87bee2dbdd5abcf02adc049b79a89281,15141181592
20180804,"PAYMENT RECEIVED",1258748269,0,804a9b2abad82efd4a501472d3f3ee6049672cb1d5822fc43c2425ea6a3061b9,13867691019
20180804,"PAYMENT SENT",0,-20203655911,e1f50a407a5c013fa5f6956e64a9088ba48de409af7ed18c9fd6ed75499c6519,12608942750
20180804,"PAYMENT RECEIVED",1252907183,0,602178ef9a882f8ed924bdd47e4bbf9c87c6fa43feba54f4c4943c012b34caa2,32812598661
20180804,"PAYMENT RECEIVED",1251667050,0,05bca269b65f33c905138f825ab7de1c84d1c970cdc9743044ae1c07b33713e5,31559691478
20180804,"PAYMENT RECEIVED",1266606533,0,b59d176fb5440aa625f114f3d7b08216a0c6141de74b482ff1a9cee92a0b8e23,30308024428
20180804,"PAYMENT RECEIVED",1257275908,0,9f1f12de23871923e8e31c1ef98452c8aa1f24f6b9efe2cef4e100dfadda2bb7,29041417895
20180804,"PAYMENT RECEIVED",1259396547,0,e9f45884c273f15404c9a2896b31bbb4de0646d24d83f3ad4d4805c9ab5c3078,27784141987
20180804,"PAYMENT RECEIVED",1264676033,0,6639c64f47521745519f02fd048cf4650aca9276870f44f713a126afbb02de6f,26524745440
20180804,"PAYMENT RECEIVED",1253497070,0,31109a1e4035a346660b44e5dc8a1063e164c02836548f5d42cacdfa2c5fecb8,25260069407
20180803,"PAYMENT RECEIVED",1252785272,0,774d795c7a98a6da1e553cbee7d46e3d17ff73d32315265ba47fba87e4e1a877,24006572337
20180803,"PAYMENT RECEIVED",1275114154,0,130d9c47e0412d3717380dd67560a58d1e71ea814d2b20d5775f236bc3fa326d,22753787065
20180803,"PAYMENT RECEIVED",1275017000,0,644746c7930036d9ab18d9f582f56a86838170646b0fc30f78365eda7f956efd,21478672911
20180803,"PAYMENT RECEIVED",1254232156,0,7b6c59f7665207e94bef8d5eb868dffc82847d0d518055bc921c2f056a7d2bab,20203655911
20180803,"PAYMENT RECEIVED",1257124948,0,3edc07e4010210529ac5e35fb013b9e65ef3745a26416319bf7e58b4ee404f0d,18949423755
20180803,"PAYMENT RECEIVED",1256608791,0,dd72f0f4f3f84b2178c5703835fc59dedb3dfe79d49df6aef41117a35b9c2fc3,17692298807
20180803,"PAYMENT RECEIVED",1257341472,0,921ffcfb972c1733263ff40017791d5dfd8a27e10c55df0d72f42699c29af10c,16435690016
20180803,"PAYMENT RECEIVED",1257788045,0,ddc35e46116e52f2e6c374100f8aa2513b667676b82693024b46ffaa1e4685cb,15178348544
20180803,"PAYMENT RECEIVED",1281863244,0,5ace58dc59e6fa49c020378766ec062d2327749e29d23a060007b1290fe16162,13920560499
20180803,"PAYMENT RECEIVED",1286976213,0,a4ba42faf86bfce23652a3b24b5e182c6d43422ca87ae8def85527244ddf7316,12638697255
20180803,"PAYMENT RECEIVED",1275543335,0,029c7f06a230bc6de743780242653df735d919c684e64c7ed1dd5915e34a6f79,11351721042
20180803,"PAYMENT SENT",0,-27951340960,ee360daba35c8a85de25060ad59a2069cba77ea3eae4bee29960e11b5cec5841,10076177707
20180803,"PAYMENT RECEIVED",1274928153,0,33de0da56c8e3131d9a44ce96f9f1d572ca35f2efa58b3c1de419e0b311b0c54,38027518667
20180803,"PAYMENT RECEIVED",1259614518,0,d9a4aeb6d4dbab1e2860f58daf8973191765892e8125b0170b8337292478afbe,36752590514
20180803,"PAYMENT RECEIVED",1250636764,0,e47db7aaa1c863232a9d6a41bc00a433f764b25049286a62cc011363ed2d6d76,35492975996
20180803,"PAYMENT RECEIVED",1255047276,0,a040970cdceda786768e7bb054de713a0fffc65bd4eca346dae5c3b05f99436a,34242339232
20180803,"PAYMENT RECEIVED",1254877250,0,6e51117a6a768d0b5ebdfabd231d3a8c9bdc31e56068a161aeb11e47f966a6d6,32987291956
20180803,"PAYMENT RECEIVED",1257899661,0,c8c70f2230200dd9776a19d4b1725488f229ce5eeb43d5b2ae110bd5cfcf8d40,31732414706
20180803,"PAYMENT RECEIVED",1251334771,0,0989b0c93fc9b8705ca3eb03a836752b52714ce940b68636c2c2e6143f488055,30474515045
20180802,"PAYMENT RECEIVED",1271839314,0,e575e50df2a80debded639b4b6a3dd374db5c7d22cc601dcb2ee83648939ea14,29223180274
20180802,"PAYMENT RECEIVED",1253520372,0,6684617826cb2d7c88f1b5fe16647f9f91f3ad909353096acfec7df4a767d8fa,27951340960
20180802,"PAYMENT RECEIVED",1260116058,0,a35e2bd54cf53d3d610b2cac2cdd8d575ed3b5716ffae191cb8e166b984971dc,26697820588
20180802,"PAYMENT RECEIVED",1263222680,0,d6d68e32f454c247ed7f00c03a23f863093a3728cad86ebf01eb9a8a9ff4b9ff,25437704530
20180802,"PAYMENT RECEIVED",1252934721,0,03818e2da7c65554f409e8eb25f3b9471326a931226cbfa6fb46ed56d6688591,24174481850
20180802,"PAYMENT RECEIVED",1254518567,0,725a0bb8c750bc5af84448e97641e257e0baec7cb4614b03803d7d109b891892,22921547129
20180802,"PAYMENT RECEIVED",1281195453,0,24bee8e74e236ae9018068936308199adf90505a90ab8bef15c3f6ac683ff616,21667028562
20180802,"PAYMENT RECEIVED",1267536013,0,658734d1294f1b54f28e576e0f7ed5e8d25da163b808a1b972fb28d5afe60546,20385833109
20180802,"PAYMENT RECEIVED",1288777250,0,beed813bbf910eeaf299d69d72621002a355d9915045e23befc9c749d6e0cfde,19118297096
20180802,"PAYMENT SENT",0,-25290108131,c390d0f35259d211c6a643dc864a1e1a38839d7a1a5e8be5deb9f81060117216,17829519846
20180802,"PAYMENT RECEIVED",1251494021,0,9b316e7a54559834a851bf5bfb9d7b7aca726c0145f04d597cbafc00f45c72e0,43119627977
20180802,"PAYMENT RECEIVED",1283883354,0,cf0986a64b657b176def09899aed4c4fbf76f5caeac28251a1e19c5749cdc900,41868133956
20180802,"PAYMENT RECEIVED",1260242546,0,d62e31fdaf32c424177a177dc0cf7c083d016108dcb63224403332cf8d9f5004,40584250602
20180802,"PAYMENT RECEIVED",1261575956,0,11cc94cfbeae776cc69834e5916449d3d32a9c82f467681397d66a66647f3da4,39324008056
20180802,"PAYMENT RECEIVED",1353996836,0,137891edf09ac4d16ea7d220f306f5ea1c33777910a2bb4878785b7ed7889025,38062432100
20180802,"PAYMENT RECEIVED",1289339726,0,9d940ee529d1bf77325b936429bf36358a3c530f1cb5893c0e1eaedd1df0b1cb,36708435264
20180802,"PAYMENT RECEIVED",1351272567,0,20b9a9f5f960dece325950f21948c81a14492ae1d0166bf01254ed3865a94987,35419095538
20180802,"PAYMENT RECEIVED",1251733873,0,ddfd43e5485f493b9ae9071730e7e92ca66be03474189ff5df0d33423f668927,34067822971
20180802,"PAYMENT RECEIVED",1251362918,0,668d0c5ea3735ab1ebe587e441fac78a89027e3c2ecc2ef67f7ecdf3f9ae1e9c,32816089098
20180802,"PAYMENT RECEIVED",1252554662,0,d03e7c323e81e4c36498d27b62279a23035fdd38adbf1ff6168c99fd7a9b2ba3,31564726180
20180802,"PAYMENT RECEIVED",1251705693,0,4e16f67cc680c31f75220074827d43c5c4c90576fd5a6c4aa44c5fd17515e39f,30312171518
20180802,"PAYMENT RECEIVED",1255119791,0,0d31c12b877cdedf722546f698d988227d10fcf2f6bd2d057aa785acbc8c3ad4,29060465825
20180802,"PAYMENT RECEIVED",1257795673,0,ce2f125b51b5233565b25afc6c9f2eaa531942e7c718e7d31836a7db04fe81f1,27805346034
20180801,"PAYMENT RECEIVED",1257442230,0,f2e2e8b38147ff9fe2675ed2c3b9313ed95e41ddceb2205cbb42cc4a223d800e,26547550361
20180801,"PAYMENT RECEIVED",1255973430,0,c7d5593587211d207fd92b5145bc8d6ac93345b5cc6d7754fd3bdfa50e39ea12,25290108131
20180801,"PAYMENT RECEIVED",1259832509,0,12fdb478077520f20cfcb25155c78bd1ec1d0f21449376cc57f725a03be3f8aa,24034134701
20180801,"PAYMENT RECEIVED",1275339704,0,cf61029e211568dc381a3cfdd48619deb52277d79a7d0db7cd4291f4a4921db6,22774302192
20180801,"PAYMENT RECEIVED",1263920736,0,b4f9e158b4be83e95394e8b9d029af7bbdddaac444de31e415082e6dca8c4d87,21498962488
20180801,"PAYMENT RECEIVED",1321743138,0,9e8d69d185d767e8488b318c55a1161758cbe02c9bca41342d6aceb34d3bf2b7,20235041752
20180801,"PAYMENT RECEIVED",1257946196,0,a8a95a490ab1b61f50f3778d58a3cc4982269adcd8286465792ca9534fb783a5,18913298614
20180801,"PAYMENT RECEIVED",1275425904,0,ec64d95b4f2fcb9b8542111281e0e6930804396bd978a6dfd55f0bafa5f282aa,17655352418
20180801,"PAYMENT RECEIVED",1283427864,0,42b0af6c01f8094395213f3ee533f8b8afe87d06a850d2879e158a84af310af5,16379926514
20180801,"PAYMENT RECEIVED",1251670832,0,558e24088c16194498935f43c63fa1bef97bb497c72ccc20ee64ffecc2851fd7,15096498650
20180801,"PAYMENT SENT",0,-29231140640,84529fadba2b0364c5092e15e4f6722bd9c5bc65e98dd39e423142d9fb3fbb73,13844827818
20180801,"PAYMENT RECEIVED",1261623370,0,b0b5d6372922ed8c022fe857df979686942e5c639381cf3bf372da137312ce12,43075968458
20180801,"PAYMENT RECEIVED",1263137141,0,31ce7a593574dff9a274af0b679218d5c02f7177f3e2ef288583fef572f1e795,41814345088
20180801,"PAYMENT RECEIVED",1262641233,0,bad7a5765714b5b2fb8266812ac5d280b7f94db169a6c4aeb9da2d8c53c8e27f,40551207947
20180801,"PAYMENT RECEIVED",1260465447,0,b1f72c120728ad3da36c4d8dbe989966632a2d999bd003b5d91b355c4546b6c2,39288566714
20180801,"PAYMENT RECEIVED",1257218422,0,274c4f97cf7f843a9c7115f1cd753dfc2d4946ba28322a525672ac7f5ac0207a,38028101267
20180801,"PAYMENT RECEIVED",1266535696,0,68e0e7fe2c871b8e5423b923941a219e9efa67fa99ec85cd3266e57557062e77,36770882845
20180801,"PAYMENT RECEIVED",1252449080,0,1837445b0f4d93bdb78cd378a956f7a5ed43952dba9c532f2f338591429adaeb,35504347149
20180801,"PAYMENT RECEIVED",1250477008,0,f7321b22bb805df0e532f3d344e34bea7b75066bf7ba513290ff149849013609,34251898069
20180731,"PAYMENT RECEIVED",1256704821,0,ed0a42531d17ca1bb9bbe880d7c205fe91e993c0ff899c7f6108169468d3e3c6,33001421061
20180731,"PAYMENT RECEIVED",1253154465,0,a60bd5210d6e0b0968e9c507a2267fbe61f5ba97305d748a47a9114024c2a8e7,31744716240
20180731,"PAYMENT RECEIVED",1260421135,0,cbb13b51cce660ad73e8d6ae45dc11e4b1d57d8efbb4ca98a60f3f9a3a16319a,30491561775
20180731,"PAYMENT RECEIVED",1255369582,0,17911f2521a34a5db391a54361bce652352f027dd22bcf927c689e9c74b8deb2,29231140640
20180731,"PAYMENT RECEIVED",1255786337,0,3035c70283b8e84d1407b615be8751aa7116ff7812cc8de6e4be65e90651c439,27975771058
20180731,"PAYMENT RECEIVED",1287215302,0,6976d7f593f259b5b3a48e4a30ce2ea6d3e48b1146896398023adc417e494041,26719984721
20180731,"PAYMENT RECEIVED",1296707207,0,30b2069abff1d3d435cf3d5693885e6594426e51a5157499d2d83eb9347f6f25,25432769419
20180731,"PAYMENT RECEIVED",1255050236,0,a700ae1a18ad1fb5489029e8578e5dba75e7b8d3fde035bdac050a1138c62fa6,24136062212
20180731,"PAYMENT RECEIVED",1288067380,0,e0629fe23c6a339113642bb66693d9b78adf755145638b7429b39dea8e360417,22881011976
20180731,"PAYMENT RECEIVED",1266792720,0,51f940d6b6813dfcfe29f5c5e8e2f0a845631e02e25954b435c45aff399a1b78,21592944596
20180731,"PAYMENT RECEIVED",1261065250,0,339b08dc396313c355eca2277f26a32a359bc2a1fb397eb121201eaf667c45a5,20326151876
20180731,"PAYMENT SENT",0,-7580471748,7a1f13164ec2a853268f593997cd15432e2cfc887c223595cb7b1ed49d7a4d86,19065086626
20180731,"PAYMENT RECEIVED",1265738433,0,24825e5ff1c76efb6bfe05bae83d3cf86c755b35fa760178803df14e3a50bc54,26645558374
20180730,"PAYMENT RECEIVED",1270304074,0,9e05ed5c3b6ef4555ac155a0b09d36ad970de7d6abe531ad0ccf98812f7cedd3,25379819941
20180730,"PAYMENT RECEIVED",1255430403,0,6482516d3f9a3a720d4048a6743f0770bf09916c8fd8cd2506b598291e8aa3a0,24109515867
20180730,"PAYMENT RECEIVED",1281221339,0,bb28a7770ff7aeff5844bd10c9d986bf227211d2bac16cd9b388562ef66dfe8f,22854085464
20180730,"PAYMENT RECEIVED",1273272267,0,5264a707ba74e303e052177fd9e0166a18fa6851af6dce5bd3588fc2757f3707,21572864125
20180730,"PAYMENT RECEIVED",1259466786,0,8910a86112d05f3cb4d97fdd49d16eedbe5bc7c01b3a11e3c2e0fb74c0dde2b7,20299591858
20180730,"PAYMENT RECEIVED",1322371426,0,87ed38f5ba8242585707da52cd76120c7f3ac20af8777d51ad6e35c8cd554366,19040125072
20180730,"PAYMENT SENT",0,-2503899241,68aff9f431844529be0430e84a596e37e2e5fd916450d0c9418bb011e3bfb093,17717753646
20180730,"PAYMENT RECEIVED",1253953975,0,37b0322e2ec0c2c2f1cb1df758faf372342ed97bb2d089e27e8936936df0a9b6,20221652887
20180730,"PAYMENT RECEIVED",1265367100,0,52f01e7b5e38842a1af1dd0a5dcda0365866198bd29c28f3da6822321c189377,18967698912
20180730,"PAYMENT RECEIVED",1278997510,0,28a2a580338ac76bf9001ef43d1f24fec25d3683f752cce9d4e50acaf39e4233,17702331812
20180730,"PAYMENT SENT",0,-20070466218,1027221eb33866b750a5b60b4ebf008e3dc24223a18ad23909aa95543e732cb8,17676874825
20180730,"PAYMENT SENT",0,-1253540523,a6f0d42eadc74575a83a817fceaf37324d3d8cdde133d395d428237e7c9f2c6a,16423334302
20180730,"PAYMENT RECEIVED",1278793051,0,b0589f45387e80cd3ff8519e3bd291cb4e2d5f751b3d8b3bd1cecb49f7d7d926,37747341043
20180730,"PAYMENT RECEIVED",1260507442,0,9b24d9103f8075991e3a0b6198b7cc4dbba6eb3f501b8d59eef886d58a72dfcb,36468547992
20180730,"PAYMENT RECEIVED",1274749771,0,e03a37211d848bcc39e4822b349917864741dfa4db261e0d710cae36dcf34a8a,35208040550
20180730,"PAYMENT RECEIVED",1257225436,0,f7ddb7cf57bac45ed3a6c890c0c03f76eb0ee2576f64843bc0ecdd04729bb264,33933290779
20180730,"PAYMENT RECEIVED",1267687613,0,30d0af839b8227f7c25023eaf2dfb848c632d2fd6bcc7ea4919fa1c8c9c7193b,32676065343
20180730,"PAYMENT RECEIVED",1272973707,0,f3b6b0f8fb227bf17d10fa7f27138dc64a7a949d82e24d7f27b2079ee357454e,31408377730
20180730,"PAYMENT RECEIVED",1250694225,0,452491e7bfefbb5823e23006a7ac7e2f0898cbecd5c6dc6b3d34522f5252a142,30135404023
20180730,"PAYMENT RECEIVED",1263557523,0,cd86a2cc70949e48e45fcbfde4039958e469167b292c8e4df0327a4547b41cbe,28884709798
20180729,"PAYMENT RECEIVED",1250331410,0,62c9f4edc8587f90113c837521470488efc60946374983608152a9f8ece7c99b,27621152275
20180729,"PAYMENT RECEIVED",1259616705,0,22374bcdfcb9f1d6d96f8e0c216975bc6603f1508ae7f6cb9974f44c1e551fbc,26370820865
20180729,"PAYMENT RECEIVED",1283298178,0,f8569012de62a3d84d936bb75173d4b56b685dddba0ba9aef41350ee5ebb2c47,25111204160
20180729,"PAYMENT RECEIVED",1250349490,0,a3fa26ae5e5b102279eee9c23b8e3f08a235dd50b5f41ad7cc42668210735a1b,23827905982
20180729,"PAYMENT RECEIVED",1253549751,0,f498e2a37c448549b370d1502e71ab12e7691fb1de1144aed9671ad3dc747dc4,22577556492
20180729,"PAYMENT SENT",0,-5017393875,bca24949d51e321394b57a73c687483102220fa44d3dc43987970c3a6f5e595c,21324006741
20180729,"PAYMENT RECEIVED",1253540523,0,a2e83c0076cbca0ee166f81f18602c78e71fedeb11545709f0c34fdf72a756d3,26341400616
20180729,"PAYMENT RECEIVED",1257564651,0,838727a6e99f5b5750d463baaea25d3f6baf89f8f32f349bc1c74723062458fe,25087860093
20180729,"PAYMENT RECEIVED",1264395631,0,55ba780a07f24cadbbcb533b24d5bf7e770ed5a6fde4e032bfef945e672f51d2,23830295442
20180729,"PAYMENT SENT",0,-1250111450,36474a87b5df2faa8bbe32e1e08bc21f05682f762611a9a25d820a1a7845b400,22565899811
20180729,"PAYMENT RECEIVED",1253523753,0,160986f230eed8064e31fff5756885432c30d1656b050418684b09621d215c6a,23816011261
20180729,"PAYMENT RECEIVED",1252316284,0,f6649d3d83edf9b94d2cfb38212f08a752db7041f66c01c19917204c63bcd934,22562487508
20180729,"PAYMENT RECEIVED",1251926782,0,4148984f213811cbca8c8de4e4fc236ba4028204b7cc315caefa9e62e86b3b63,21310171224
20180729,"PAYMENT RECEIVED",1252153235,0,62465622f73e33de42b9060a59bf3dbf541b9f26c27bc7b52cab8b8b88538d20,20058244442
20180729,"PAYMENT RECEIVED",1257925060,0,d940b6a67331e942dd72bcb9d798cb96275854e569bb1788074a2b431ae7e160,18806091207
20180729,"PAYMENT SENT",0,-21446864491,85b253716d7f8bb257a6a2fab0cb5d0101baa98a94e8b9861464e86ad2b42a98,17548166147
20180729,"PAYMENT RECEIVED",1251526477,0,db97ec96fe0aae8fcac89a9bb06d1f566e1fc9ec50c8f9101875eeda9fb4085c,38995030638
20180729,"PAYMENT RECEIVED",1258617631,0,604755e322f7ecdbc46bf82355b3c9a96e88a4aa6aedf87ccab09d079649c3c0,37743504161
20180729,"PAYMENT RECEIVED",1252660983,0,2a09c7eab0dc3f2657051bc93b45cc5e19b55a01875c8b47ce835d59e5bc44f6,36484886530
20180729,"PAYMENT RECEIVED",1255603998,0,d0d0f34d638c6b5e22357f6807f4b75cd35e0b6efcafe61e757f6aa07534c6c6,35232225547
20180729,"PAYMENT RECEIVED",1250168010,0,ea81a252f52e72c2c708304c0c8c7e89e8e315c8272f1899cbf9245ad39584eb,33976621549
20180729,"PAYMENT RECEIVED",1258262537,0,821297476eec1ec5093afe4a0df96aeefe8b8d0c59094c530d9376a20ebbb780,32726453539
20180729,"PAYMENT RECEIVED",1250000000,0,072b66f9dff71fe924b834ba8279d52092631b398a89407f3368ca0bc560bf0e,31468191002
20180729,"PAYMENT RECEIVED",1250088907,0,b04962bd84c37ee1eae973e21e3dfc7f3fce5343858bd58367a36c43a00965ca,30218191002
20180729,"PAYMENT RECEIVED",1253732279,0,c77ebb16ca0448aaad582121289f1a9653498eb74aa8c7eac4d75b5f2024a655,28968102095
20180729,"PAYMENT RECEIVED",1255555517,0,c080fb7e520483a634e341ff0789e6d31a18b1e1dae9808ef9ab721af90bfbc1,27714369816
20180729,"PAYMENT RECEIVED",1256766188,0,71f0b4301fb106bb5d0ccc6911093d6e91b0a2f0068e9d8262db267e5e1f4b23,26458814299
20180729,"PAYMENT RECEIVED",1254844234,0,ff8d2f72af4e99a190d98f438a43e81fd16640e477678bb9e497a6eda31db882,25202048111
20180729,"PAYMENT RECEIVED",1250227936,0,1601d757feb735762ed1206289e6d4e34ccb19e330be64b0cf25dd0a4b2966b5,23947203877
20180728,"PAYMENT RECEIVED",1250108450,0,c031a5a30dfa0d430e7abd8659f2dbb83b77b0767bf4bc86c381cb7487d24357,22696975941
20180728,"PAYMENT RECEIVED",1261834868,0,c7b1efd33bfa346cde787af93853d763d334b4b02647b7eb662aaf47b56add9d,21446867491
20180728,"PAYMENT RECEIVED",1281690100,0,22c1c02ac489986e3f4f85563d4325e99db46f95cf0b7a1b11d91ca2e9fa3fb7,20185032623
20180728,"PAYMENT RECEIVED",1256200146,0,9b8d3125e1d05d35506134875333de766b7983bd9c39e50e5441f6d8f39fc320,18903342523
20180728,"PAYMENT RECEIVED",1271075841,0,c235458a5fff6820f4ea501824cba5ab936220e70aa1c46e0102c8c3522a2dc6,17647142377
20180728,"PAYMENT RECEIVED",1256748699,0,0c9697b6316753a30ea2e70990548be33fce79d4c5cc5a94d3828b4b1178e938,16376066536
20180728,"PAYMENT SENT",0,-17650907979,5875f17eb734c16f1ffc9721f14a054494b65a9e9390b5dff2b9a4a9b083bd9d,15119317837
20180728,"PAYMENT RECEIVED",1259151839,0,4fc7d64dfbee0bc8ce1fc04759df153f09fc35ddb6fe930dded10e9ccd1ed011,32770225816
20180728,"PAYMENT RECEIVED",1261471967,0,58920afd0b7d704599c7b6f854b4c64e6556a2d58caa1ea0bf9e30b10a44df95,31511073977
20180728,"PAYMENT RECEIVED",1259411904,0,313dbc0b84c401ec681ba533e8b8a94326ec0d968ed09ac090dde921f593df6f,30249602010
20180728,"PAYMENT RECEIVED",1255947507,0,f0583528d362a8c893a282a7370b1a3b111e5e4fc7aa157e874fd45e30b00b71,28990190106
20180728,"PAYMENT RECEIVED",1278465975,0,8fd694c09c8a44f31083c53a83e83d63d6a0cdd511fb45635e082aec64833605,27734242599
20180728,"PAYMENT RECEIVED",1261392703,0,7eababcbb8dc17a45b27944612897ba4fdcc7300fdd19140c5864f266e676111,26455776624
20180727,"PAYMENT RECEIVED",1264856968,0,8c5e65cc67eb7f5001d506cceb592847a85ffde03dd90c1acc8e34fb98dabedd,25194383921
20180727,"PAYMENT RECEIVED",1253309909,0,3f9f2306a86fc3181aaa9196a81d86ead615b17c8b02b04c528fb89c04d60e74,23929526953
20180727,"PAYMENT RECEIVED",1254265366,0,d27c8884258fbe2054cba73a6c6f2f04ebb9cdcb588a7ee45a6796122685e7a0,22676217044
20180727,"PAYMENT RECEIVED",1258454407,0,73a1779553366ccec8adc039776d51db705f2f261673d1c2afe6fd016517d1eb,21421951678
20180727,"PAYMENT RECEIVED",1255125349,0,d9657a57f7ea0a46ee9fa7b1391e205f595b3939956049f681578e04f790bb41,20163497271
20180727,"PAYMENT RECEIVED",1257460943,0,bfe04011c7c5550518cb06d505aeea4daba4daad2c1b2f86b6cf900006bd60b4,18908371922
20180727,"PAYMENT RECEIVED",1255502648,0,13beef4073e4a2f3031e06e4949106a9015877ced034e4f996ac5971e95b9fce,17650910979
20180727,"PAYMENT RECEIVED",1259047987,0,7aff367d1df9fe6f26a7d938c4ca54e099744ed8be85815cab8389f3776a27bc,16395408331
20180727,"PAYMENT RECEIVED",1292965908,0,35d28b70570b2cb17a443bcd0a45f8682aac814cd1b47d5ace9dfb9fbdd18fab,15136360344
20180727,"PAYMENT SENT",0,-30361567558,2e706cf42794f0ec71ffc6a85e59fddac77eb8af73653d43f5548a120a8b87b8,13843394436
20180727,"PAYMENT RECEIVED",1267292630,0,2ccc18c7ae0f9c4b96001313151a538d23acc189378be5b508b76d3ddea8b5a4,44204961994
20180727,"PAYMENT RECEIVED",1257730710,0,c5c004b212a61f0a8b037460b5455acb235db25222391350d60c0cfa0fc2b72d,42937669364
20180727,"PAYMENT RECEIVED",1250422407,0,d68db212d3710b9a91f347e220669240881bb361982199a0e56da2bce5774c69,41679938654
20180727,"PAYMENT RECEIVED",1264428698,0,3140049bd5f61cc6153810cb339a9bb12e87007d6b4ca835a535602a776e3158,40429516247
20180727,"PAYMENT RECEIVED",1252166157,0,e5f4f0489d44ece5634f2def0819a8133867325bdd0c2eae85f4c635531ed6ad,39165087549
20180727,"PAYMENT RECEIVED",1253473864,0,28da5f013219ad88125af93278fc667b0ad0ebaad7fecb6f26a2e2159e78c323,37912921392
20180727,"PAYMENT RECEIVED",1277440732,0,a8baa216ff07171b55e7b324247ae6446ee37321620362dbb5fe33ac49d7550b,36659447528
20180727,"PAYMENT RECEIVED",1258286363,0,16b5100f516871ea1edd32e70a86092e4ff22b84caf3a0d571a0a88ce8d19790,35382006796
20180727,"PAYMENT RECEIVED",1252129191,0,5d8d5fc78ba9621ae4c45da2c32edbff3cc67af89a517564f4f7c61a940e58a5,34123720433
20180727,"PAYMENT RECEIVED",1259699231,0,f926b0dbaa6139f7e8e87c8ca490fd64e8040f360d2eaca6174ba5056e1844fc,32871591242
20180726,"PAYMENT RECEIVED",1250321453,0,4aa37b4a6500cf15fea648e85f62ffd4ceb2caea4fe230c795e210fa2b7e588a,31611892011
20180726,"PAYMENT RECEIVED",1250925203,0,d903840dadddc00753a31add36fe5b655c31ae6bbc470ed269bed49808def1a5,30361570558
20180726,"PAYMENT RECEIVED",1258290330,0,7b10898b78c767c02c3d23a4404164eac9d5c74eadd8ff87d25328292991e49d,29110645355
20180726,"PAYMENT RECEIVED",1272405609,0,6524f9d19fccf52784bb2f85f19a6685fcdb1a231b17ca79c4503dbbadd643f9,27852355025
20180726,"PAYMENT RECEIVED",1268495114,0,11ad9826b99d98b7b44d00e008dc8740272deb9ea626b15b94dce79996949f38,26579949416
20180726,"PAYMENT RECEIVED",1269820048,0,88e618ea41dd132839cdc9df0e34bb8cab1178889a16dc1183238dff6986aff8,25311454302
20180726,"PAYMENT RECEIVED",1293774750,0,13f0fe97e996b6942a96a62cad972c8161cf9766242fded7ca65a4369efa2eeb,24041634254
20180726,"PAYMENT RECEIVED",1263540884,0,f09f3a9c97ed61df71ccbf4faff5dc9ad21d625c4079252422a8643f7075acd6,22747859504
20180726,"PAYMENT RECEIVED",1284421647,0,b99b9a1994c1f1142bcb2ba9fdc17993465496c20037b10c7466592c022d089c,21484318620
20180726,"PAYMENT RECEIVED",1258087739,0,8828ab5f6d074501cf0e349276e260dbb1b67a037ed43d21aa3679fb5623c77e,20199896973
20180726,"PAYMENT RECEIVED",1250183497,0,93edf1b92b63f7bb68d91ed2613ad21385b38065d4aa8a23d22fdff128a2aba8,18941809234
20180726,"PAYMENT SENT",0,-20182330153,08b853583a64c51221056a51d7cddc940188f02041e5db1f76fa20660988c051,17691625737
20180726,"PAYMENT RECEIVED",1266092753,0,104e7b4591a2cc39319b864483820ed02339c406ea4fb456fc3821cceffeb07b,37873955890
20180726,"PAYMENT RECEIVED",1260832793,0,8213f7b5fd511c82acf5ee5234b7b69922fac84db54237c761a37bfe7374b547,36607863137
20180726,"PAYMENT RECEIVED",1266204078,0,6b5dd98aa882f63641b309581d567a33e0419f09ffd8d61f6379285ff58c81e9,35347030344
20180726,"PAYMENT RECEIVED",1285574720,0,d2f85cb2061bbfdacb6cb9aca649876a5f0f046e3be8df4f8a2bf9890539c746,34080826266
20180726,"PAYMENT RECEIVED",1250000000,0,0363324418df7b331fe493153d53a7cedc9f5549b3432d2e4ba34af08baea6d4,32795251546
20180726,"PAYMENT RECEIVED",1267538753,0,17c8435e62664d786bbce730e50e6a11ab3167fd18b365984e0cb2705325d855,31545251546
20180726,"PAYMENT RECEIVED",1272803441,0,aef6e9942105fb1a0b8125c56c94026443013fd4f4b3fea5c04c8bc479f423db,30277712793
20180726,"PAYMENT RECEIVED",1250132186,0,b942c4039b7ce86f7a7886e71c5a2c314aad78ace48bf7653f2e664ece1267df,29004909352
20180725,"PAYMENT RECEIVED",1260417719,0,c1260a87f480933c9220ca6e9e496bcc0c2aaff422a0cd834164a52f000c00a9,27754777166
20180725,"PAYMENT RECEIVED",1257047891,0,67c588399129cb70915de63f5eb06bafa4719c4efeb1922f57e05e294f05514d,26494359447
20180725,"PAYMENT RECEIVED",1269030468,0,7324c94dfe42c979c74c683bc770c8f3776d03a05fa26057cb047cb66acf6708,25237311556
20180725,"PAYMENT RECEIVED",1252326714,0,5b57bfc442096fd5ca90f4e4fcbe7680008ae817b73c7478475f35d1bced1e46,23968281088
20180725,"PAYMENT RECEIVED",1272559356,0,01dc2999e2fe438356d2b9edbb43cb716d38568a7899b19f180c56a5ca920169,22715954374
20180725,"PAYMENT RECEIVED",1261061865,0,f8fa28ea33759da7e228dfb01f5f2127b57acd5b26f7fc36882d9e5c42924619,21443395018
20180725,"PAYMENT RECEIVED",1283424835,0,28f50735d287484a09ea7448e3875735d964599db5da1486f92b065ffed539b5,20182333153
20180725,"PAYMENT RECEIVED",1276645008,0,01081fe8aed9d563a252aaf1a1feece2e68c83e73450c6c05e430778433739ce,18898908318
20180725,"PAYMENT RECEIVED",1252932291,0,e809b9762605d2f81181c4ab23e7709d91abf77b57975ce9447995ecd1dd0778,17622263310
20180725,"PAYMENT RECEIVED",1271685449,0,6bbbaf1d5e7ca06372f344255d5558fb6645c79497b880dba234dc382f1b181e,16369331019
20180725,"PAYMENT RECEIVED",1267358594,0,0241802fd012a84d9780dc7ade103c8cd220df15f9ebda72f4ce58549f5f79c3,15097645570
20180725,"PAYMENT RECEIVED",1264325213,0,b1469c944504901753bb6d5981f5c8ff8a0da18305d6647860b43161791a33ea,13830286976
20180725,"PAYMENT RECEIVED",1257460866,0,aad85723e16e3e6b7aafa2ffb12dd419490cc518f0c2d2637d6ed0e6b1d14a77,12565961763
20180725,"PAYMENT SENT",0,-30481559096,500c9966b9e7710e90fd3aec9b03b37b982625619ca2294927c589980324ddd4,11308500897
20180725,"PAYMENT RECEIVED",1253578962,0,f138678a4107892ff33c536e22cb2f9571f87b2f65f65c7639b810603465e50a,41790059993
20180725,"PAYMENT RECEIVED",1255402203,0,0c56cf2270008352f76a054b33ed4badf9a5f52c18886f5776d669639d668d70,40536481031
20180725,"PAYMENT RECEIVED",1262934934,0,0b2d204325cd7c7861938dd523979f28365cd35c473a8c943193931b2d365da3,39281078828
20180725,"PAYMENT RECEIVED",1258505673,0,603ecf21e4c96375f795c3c8982f51b44f4266ac77514e8315bebd9a1e1972d7,38018143894
20180725,"PAYMENT RECEIVED",1253073881,0,1e2e08c3602bac9b748550660d6f4428ad4e2cada50fefadd056758bd236f672,36759638221
20180725,"PAYMENT RECEIVED",1257631869,0,3de71b7639edb10631db954b00ffef90f7770b2fd4bce78351bca743a941e396,35506564340
20180725,"PAYMENT RECEIVED",1251390851,0,4494037ab829c966c03d15500d2304304da7ea9517d442ae0714f91ede0586d7,34248932471
20180725,"PAYMENT RECEIVED",1257544265,0,b7f4d31d5f28be5a387c9cf90d8b5631415c4112c6a21d7a8d0c725cb0bda04b,32997541620
20180725,"PAYMENT RECEIVED",1258435259,0,c9605893e66192874b0159556fadccfac33d88be3332c002d8c78c75f2da578a,31739997355
20180724,"PAYMENT RECEIVED",1285692996,0,81a78c7b7ba5713b092a45778023d551f98a4adfcb68dc4f089ac60390418c44,30481562096
20180724,"PAYMENT RECEIVED",1252831756,0,c9d4524451c0396791ce446b5ae284e01ac0120df5cfb40c82a8b3d4c2cd05d4,29195869100
20180724,"PAYMENT RECEIVED",1256145722,0,137787597c788d169312359316251aa84d6f8a132cc279c8b46bb2190b804baf,27943037344
20180724,"PAYMENT RECEIVED",1308208755,0,a901cb86a4237e02925fabdf65370dd97175ace54a619962a5329d4b59c6f5d2,26686891622
20180724,"PAYMENT RECEIVED",1268610720,0,9e4da52dcd18a10c31b5a9057142b98e450c027fd06f768b9a12eabf9482fd88,25378682867
20180724,"PAYMENT RECEIVED",1275510785,0,d4fcc662791624b71c5bfd6124f366de7a6041a8dc0f2e1878af75c6cd787f23,24110072147
20180724,"PAYMENT RECEIVED",1294663927,0,fd55623840d10b4202e8b37635b3ef56f6fe56462c00204255f91a58a24b632a,22834561362
20180724,"PAYMENT RECEIVED",1284475562,0,74874c8ba48fe44d38dfc26d659a3b1d0ff266d3b5d89332b6c7d6ea1e6f0760,21539897435
20180724,"PAYMENT RECEIVED",1283701789,0,7189939e09f521716872ab48ae9b3d42affa9b7b0250208536e4099a24dd362d,20255421873
20180724,"PAYMENT RECEIVED",1263716921,0,d9b38226f1618f75e3196ce92e59cdf409dd52fabdea2da8b2a2dc1d7f8c1f66,18971720084
20180724,"PAYMENT SENT",0,-25223980075,d6ef066260d25218009433000e1b3aa33790f18de210e56af79b9a6e527c6ce1,17708003163
20180724,"PAYMENT RECEIVED",1250181835,0,93cf1105f0b4418de4cd66d05e787b76ee15c0623ab7f0d3bf9f64fffab53e7c,42931983238
20180724,"PAYMENT RECEIVED",1287399901,0,10147990566431a9fb9b8af3261f89463209c576eaeb3ee22733986064e74c32,41681801403
20180724,"PAYMENT RECEIVED",1262963983,0,5120a76a38cbfe734cd7151c29dd16a0a82736db71308227afacec99636628bc,40394401502
20180724,"PAYMENT RECEIVED",1285958558,0,d3f2be0f72d284a8c5aaf803d6a76cbb6ed9540fb8d06eb84d9576372f0d0924,39131437519
20180724,"PAYMENT RECEIVED",1251633195,0,1b405eb63b45fced6c267277c5d55b08b5268797c210b965dd56fedbbb78db70,37845478961
20180724,"PAYMENT RECEIVED",1268677554,0,3219f6376c503fc3239650d18fcb13f39af29f124a4725a6c65bfc67c3c7a7d7,36593845766
20180724,"PAYMENT RECEIVED",1253540713,0,dd4d2f5c9fcf5773eb827cbebf2738c1690ca510cd37ff565de41191e906abbe,35325168212
20180724,"PAYMENT RECEIVED",1259657328,0,cea057d37a6a1f67a57805bbc8092ee73c511b6871fe658198f52467f1d60c3e,34071627499
20180724,"PAYMENT RECEIVED",1254969130,0,eae4b1a36e2847e0c55f9d2d95da25786ef8587e7f2956ee3c4c8df8fe1ebd2b,32811970171
20180723,"PAYMENT RECEIVED",1290414053,0,2c8ce0493477358ac9b3227fc437f6f7af5ddc1fcbc2df865adaac891dea304f,31557001041
20180723,"PAYMENT RECEIVED",1256667637,0,e2c06cc7a8ce95fa2baad9825518631b4c9ea1dc42fbe5cb70a0f5f261d67048,30266586988
20180723,"PAYMENT RECEIVED",1254705704,0,2d2ab38c07c3740b422940a23c13bc67df196cc84114e619e0f6851b21e1443c,29009919351
20180723,"PAYMENT RECEIVED",1279754102,0,5b8cd943dee8b7ffd1d47c61ecc2775743dac7dc57c3c54e1398a04577ce24c4,27755213647
20180723,"PAYMENT RECEIVED",1251476470,0,38451696693f4e15a2fe5c1d58bc4b58a9fcace1e5e2220b44a28d3ec6376bee,26475459545
20180723,"PAYMENT RECEIVED",1280382477,0,5f1787011458371350356051b420a30173b2bfb967f828efa169dad930810551,25223983075
20180723,"PAYMENT RECEIVED",1290170841,0,4cd2e586e5933d8a1826fb99eb4e5b82a9208da269228a5e076e272ae7837ce2,23943600598
20180723,"PAYMENT RECEIVED",1256739423,0,d1bf2a0dc80b841a789b718d4013506ecfb885a1a68bac95fe651f4acafd634e,22653429757
20180723,"PAYMENT RECEIVED",1284034302,0,28bd76f55da46c0474c2d09b796758ed11e521b3f3e528409dbefa3f420e7798,21396690334
20180723,"PAYMENT RECEIVED",1253176337,0,4ac655171f7231166e3cbd48cd651e884bff4889f46853a5980bcb01e0b1d327,20112656032
20180723,"PAYMENT RECEIVED",1252255200,0,8110689187c44c653799c8df8fcb0082eaccd571229b1a43a50a921ed5f453a1,18859479695
20180723,"PAYMENT SENT",0,-36555863274,fd14198febfe1f46112c4415c4d065fddf4c79b1e00b078229be2e5593d54ca4,17607224495
20180723,"PAYMENT RECEIVED",1252062475,0,adf366d4657dccbd5375771f4231e3973a800adb65b393b275a87e4b6148ce1a,54163087769
20180723,"PAYMENT RECEIVED",1257080596,0,d20ca305c1790c96527f088f084ed112c2220f82e3012f3f83308416370373fa,52911025294
20180723,"PAYMENT RECEIVED",1268017799,0,95bf46e9b3c23b2368e0314550ef91446a1d09f3c0138033e3198dc82da91f87,51653944698
20180723,"PAYMENT RECEIVED",1258552327,0,7699fbd04bbb3c6040cb94302872820d54de501740790bdc9b7558f7c7ecdf08,50385926899
20180723,"PAYMENT RECEIVED",1250725186,0,48fb7dbf41989c0255a53a2ce56043c9415c27d9b7edef329d6ef3a991d53f69,49127374572
20180723,"PAYMENT RECEIVED",1268370463,0,cf7b7c4f85a15c7c8eb7ccbc2e2cba9718b0865fcfafd4c63a29e7739357f4a9,47876649386
20180723,"PAYMENT RECEIVED",1262294712,0,326a6274fd4a415fed238b7e68e5658ce86f3fb8ff0d24132ee40f9d27eaa10e,46608278923
20180723,"PAYMENT RECEIVED",1253915006,0,2e01a371b5dcb17a8077a92287746d877598c8e393cf1e6e320b5302c2ca6181,45345984211
20180723,"PAYMENT RECEIVED",1257755281,0,fdbf2a6a696a5399231d79a781e7bebe64ff0fe6bb77f31844998870555e9355,44092069205
20180722,"PAYMENT RECEIVED",1252169723,0,0366bb1caf196e25df1c07518ce5229185abe9fb1474a6df918c9157c551098e,42834313924
20180722,"PAYMENT RECEIVED",1265146023,0,9c734d8aebfa604b8a69c390c54ef1d02a51350ec3f9ee0dc46ac65483340416,41582144201
20180722,"PAYMENT RECEIVED",1253725728,0,201ffa5e1e7b44740cf808bf145f62872b402baac74308220856921703579823,40316998178
20180722,"PAYMENT RECEIVED",1256302453,0,f9aca1e8f67c9e06009f5c5b93534fd0d2a6f9733671dd0e088b06bdee061629,39063272450
20180722,"PAYMENT RECEIVED",1251103723,0,83578c3eb3c8d8c5bdc5bd9caa77fc2c2e574650f86eb1a7ce4e660b64c5741c,37806969997
20180722,"PAYMENT RECEIVED",1250114369,0,50ffe8c622a6d05ed250a81e39b9d4ca6f6059b44064ebabd0012acffe184dc8,36555866274
20180722,"PAYMENT RECEIVED",1257840820,0,499b72244df974d13f88a194fc7a1aa3756cd1d110049c5af3bb11f9f7388d96,35305751905
20180722,"PAYMENT RECEIVED",1279001036,0,e87c6ce3b73ea0ed31f01475f057a56ab7c06859f0f23ce5e7ca61aac93907d7,34047911085
20180722,"PAYMENT RECEIVED",1256537566,0,20e62a8b244d50f5ce056a2e631c260c94c78bc9b535bfd8ca3e2b4bb017f0a6,32768910049
20180722,"PAYMENT RECEIVED",1252208972,0,ccef571ffc8be525fb31231c4e67bc7eb5e7603f82e5187bbc2f97284b1885c9,31512372483
20180722,"PAYMENT RECEIVED",1256942740,0,6d866997575ce9cd17224a7f94575b4e019597c0e7547e9ed2774927c38bf19d,30260163511
20180722,"PAYMENT RECEIVED",1257818799,0,91b6eab983cda408769eea4acf3df23be8cf5c843e78a2667e1df4926e64a35c,29003220771
20180722,"PAYMENT RECEIVED",1255358742,0,a38b204d20f5508d41d43c7a41fdee621710cc45e846991a160b379fd4ce598f,27745401972
20180722,"PAYMENT RECEIVED",1250118229,0,86749ed3555c3b9802cc180fc7f9d54c94ff4c91d232ce85e1f3e715a8742bab,26490043230
20180722,"PAYMENT RECEIVED",1256028529,0,0d3cb46c1f3c28c54a545fe42b100b6ba6e2803edae0ef8e9aa3ee3696cf4271,25239925001
20180722,"PAYMENT RECEIVED",1266717959,0,442179f62538a2bd3bb4a8eb1d33e8a60c852a1b158ad5641cb1562753c4456d,23983896472
20180722,"PAYMENT RECEIVED",1260812415,0,7ef6f0f8377617a25332b5b7b3c599c8dbddbf4076dad82888717c72cc4bf202,22717178513
20180722,"PAYMENT RECEIVED",1255859536,0,b9077f5ddbb8d6c0df318c29fb5ef67a814b286485a84d94e13e9e9fed8c5c64,21456366098
20180722,"PAYMENT RECEIVED",1251754902,0,231c8f81115ecd4e44120d425147b5cc4daa09995ce204b3d177b9b7c99d6133,20200506562
20180722,"PAYMENT RECEIVED",1255030392,0,7cba09e071996b1273ebcca9874b98e60db55f15b80625cf8aba7170cde5b406,18948751660
20180722,"PAYMENT RECEIVED",1250413931,0,6c16934bb96b1727f92fe774efa844f5c07cf93342c19fd42f1cb1d8b50c19c9,17693721268
20180722,"PAYMENT RECEIVED",1253066620,0,22bad11dc09cfc554f6d9f0fbc4967d6fa63e90a0024fc3b5dacae1dc913b388,16443307337
20180722,"PAYMENT SENT",0,-32735761164,170f6fb9035fe0537c59977abf209331e4f4a546d8c50f05d35e8442f71a6008,15190240717
20180722,"PAYMENT RECEIVED",1263280469,0,fa4c5091872cc194d61b05bf7b8427616adb48ef256a70a0190da8ff1ffa92be,47926001881
20180721,"PAYMENT RECEIVED",1258993957,0,6822483b684fe4e96ba41292c9ccd4bfa96eb1c19e85fc2329090696265d72cd,46662721412
20180721,"PAYMENT RECEIVED",1253866587,0,8e8c2e639b7878b7b995be1d67ca460e43a9d0add77b78d59e18e364c4268a6f,45403727455
20180721,"PAYMENT RECEIVED",1271336672,0,a09b398e3db809bf621c95626f8d9c364c96fbe47984f7f46310fc2d7e5e8dfa,44149860868
20180721,"PAYMENT RECEIVED",1268422615,0,4dc6c5a5884489f28b8aee18b570ea6eefe8deec53329666fcee9c7c2eed4cb5,42878524196
20180721,"PAYMENT RECEIVED",1324562543,0,7c27fc83ecbb3ad8231e95a7ff4c386b74a50cab359d069905b9ccd42f75e09e,41610101581
20180721,"PAYMENT RECEIVED",1266907254,0,0f50e335167625360872cfc8963d0520c203cac506dbe02d4ac65a26a01747cc,40285539038
20180721,"PAYMENT RECEIVED",1254726020,0,14292dea6a7ac19a9a3d9a6a83954158818edc974f5096ecbca44b0fbe54b802,39018631784
20180721,"PAYMENT RECEIVED",1254175822,0,8c1743a5202fa25ef471109b041a029edb5f3db06ac8ea185e1db9d624c899f9,37763905764
20180721,"PAYMENT RECEIVED",1257936272,0,e9221f8a282bdee2c877e156d0cfbded643b027893a958ef8091bda7d71ac297,36509729942
20180721,"PAYMENT RECEIVED",1259921259,0,88cc412e1a80f7c58fc09ec559680cfcf89aa7e165486678a1a8a7fecefb2637,35251793670
20180721,"PAYMENT RECEIVED",1256108247,0,b9f9fc4c469be169536858cc3a87201265fd982db50501d17690bffd49947c11,33991872411
20180721,"PAYMENT RECEIVED",1255946763,0,35f1a9694a74d7d5d6501b1de9cac7e90cb92d90ad3421776119d3c0ac6399d0,32735764164
20180721,"PAYMENT RECEIVED",1251392469,0,a2f757ecf9ab378f2cf04f3bbc9b0e1607c6393d79b66632c9f330db47a42352,31479817401
20180721,"PAYMENT RECEIVED",1257842481,0,a70eb479cfde3be36436e115daad9f5df0f5ca3b079fc2cfad72c96e04b788d1,30228424932
20180721,"PAYMENT RECEIVED",1251913543,0,19486d81a1439d8556318e88acdeb7d1ec6d8d2b2d6b629fba3f0f10e0342734,28970582451
20180721,"PAYMENT RECEIVED",1252575110,0,4523ce0d5818dc76a6775fb48cd7ef238effcf87abd20507de5be6ce269b0444,27718668908
20180721,"PAYMENT RECEIVED",1260495235,0,2250b9d99808676ba8bea2ed1cea007cdc6992c1a699e3187389c39b29bdc4e6,26466093798
20180721,"PAYMENT RECEIVED",1253272395,0,05203e0a2e90f3fa2eeea2eced00754559ce94a25afa04061d01810327cfbb38,25205598563
20180721,"PAYMENT RECEIVED",1259957366,0,b79aa7334b1e214a7fc5b900390b59e36e7ac5ff1030cdd6137c9a23e96e74d4,23952326168
20180720,"PAYMENT RECEIVED",1261511700,0,2adf1bff98d10414706ff91b4b766a9bf5b7ea54f57cbe1d6dcaecb3616f1347,22692368802
20180720,"PAYMENT RECEIVED",1267269498,0,fbcfe12d87995e7bb665990736ec26baf4fd30f292cb7675a4eb1b9f710e0228,21430857102
20180720,"PAYMENT RECEIVED",1255757252,0,3aac28fb5e20fb63361f1af03f80c8d8958b542c53b4decab2867246c820827f,20163587604
20180720,"PAYMENT RECEIVED",1277509323,0,a4d3b1aac453764c3aeaa53023ebe6e27f7c5070ad1787750ed1f822a90e1a1f,18907830352
20180720,"PAYMENT RECEIVED",1270775035,0,5062e9025c2238f31dde5283bdb56452c1ea0d6e992b4d6753a5444aeab3eedf,17630321029
20180720,"PAYMENT RECEIVED",1265491586,0,1fff74b47c27a1972a7cd3827db06a7cb4428570a75435ec890dccc8ad7472f8,16359545994
20180720,"PAYMENT RECEIVED",1266426200,0,3fd56f9455bdf5e4bb7340e7279424d7196f8dd96d2027f82b6b1f124b32a087,15094054408
20180720,"PAYMENT SENT",0,-51900220676,dee7429c58ccd79128f2c5754ba9ee6e4abf902ffe19663d84741143633e4c30,13827628208
20180720,"PAYMENT RECEIVED",1250555112,0,7f38088383a35141299c006adf52dc0f4e5c3b862ab6c0e55e0464f67763debe,65727848884
20180720,"PAYMENT RECEIVED",1257227049,0,8a2a4647fb72cd34ad3a2981cab5014c4789306bd1d5424cf5d863488b8440e6,64477293772
20180720,"PAYMENT RECEIVED",1259412272,0,938547ebeca83a2057c4263b7a649c66327f170e86c791bf7c2c38f1951d272f,63220066723
20180720,"PAYMENT RECEIVED",1251339018,0,8790c103b3c38923714db9208e2cf10e8933d5522831103172ab8cdee861360c,61960654451
20180720,"PAYMENT RECEIVED",1254154641,0,b4ab160650ec161364fb2fe63fcdcb7488a40a613b6bfe2a805e14fd7e57a4c5,60709315433
20180720,"PAYMENT RECEIVED",1271879060,0,1aa3fb505401881925b65b50812eb7a79439f7ce1742bcf8cdc5dc7c887497c4,59455160792
20180720,"PAYMENT RECEIVED",1250000000,0,2b5c04b274563d3f3c4e5a49eaf919fcbfaffab6f8f7a66a92f84a5b09bb3f78,58183281732
20180720,"PAYMENT RECEIVED",1259529336,0,1b7dee9b3ee0ad2e47286d090c69f01484e79c638544e424e91f8a66f0b0f562,56933281732
20180720,"PAYMENT RECEIVED",1257148964,0,28494b6d6a61573d87b30e78f01c92309da577130bc57de4d94df0d2eeb58e81,55673752396
20180720,"PAYMENT RECEIVED",1264346250,0,8a707d5ceb73f6ef7f65ddbdd1c13b5e0f9f9c14fcc85803a77a661315786923,54416603432
20180719,"PAYMENT RECEIVED",1252033506,0,3922e4ebcef7c72fcb42ae625060ec327fdda01149ddfc32547ae7ea5a7bd7c7,53152257182
20180719,"PAYMENT RECEIVED",1277822036,0,6e19b8eff2c9b64746796f68900d04250fa634799b5b9400db3b5684fbc27271,51900223676
20180719,"PAYMENT RECEIVED",1268469231,0,d07dae11588810303683cc15e7beeee4a5bde64ee3ad05b6f88ae0879c6f04c6,50622401640
20180719,"PAYMENT RECEIVED",1264342286,0,e54aeb010283abb2ce5722b0f722b702384e7c9d55ee690a76dea8a344331bac,49353932409
20180719,"PAYMENT RECEIVED",1277574076,0,17681ecef966d8d9e4cf5930bcad93c24c9bfee1914af9dbe6151764ecf2efd6,48089590123
20180719,"PAYMENT RECEIVED",1298001110,0,2689b622a689abcb9d9489b3660b93ff87188b2df58454845b6a64cdeb8b4242,46812016047
20180719,"PAYMENT RECEIVED",1258477018,0,f2dddf284af9e6aa405aa92cceaba653a89590c37a6b49ffddfbcae93fec87aa,45514014937
20180719,"PAYMENT RECEIVED",1256594895,0,8a03ab393470db7f27ba2ddfbf184fff1aa0c1257d6e3b88c181988d67fbb4c7,44255537919
20180719,"PAYMENT RECEIVED",1262511192,0,8a1d1a9f372663888e58f0b7b5700f6e78089c9199f570d344855d6cad0a445a,42998943024
20180719,"PAYMENT RECEIVED",1286053924,0,ab178aa09e28d102a13f525bd7f58a563be4d462cd1817bdf3b82a77a8a19b9d,41736431832
20180719,"PAYMENT RECEIVED",1261984330,0,724154e57f70543c9ceb7ba919be8f0373c40c808a9abcbd343c4a7bcb8c7291,40450377908
20180719,"PAYMENT RECEIVED",1264127854,0,6078e2084b47d361461cd6f4c45a54c8631d18884d73c52bfb5f641ec7d3fde1,39188393578
20180719,"PAYMENT RECEIVED",1253017924,0,ca74d414ffb1ee3e12bd34f7b57508eb4c872506c4e6b7ee895c74b3d161607d,37924265724
20180719,"PAYMENT RECEIVED",1253295116,0,8dc114c0d82e046a144756f77e1e7d0ed67764d6422304c2af5598a8ef1e8e3c,36671247800
20180719,"PAYMENT RECEIVED",1263982629,0,6eefa6fd764217d493ea26ada0f1e64b233595bf67d7561de9405de61a246166,35417952684
20180719,"PAYMENT RECEIVED",1256107656,0,48abd86e795ca12df40302f8bf177875d99d1e8e3046b8a2331a2757dc9a9273,34153970055
20180719,"PAYMENT RECEIVED",1250095631,0,e2edd9c25cdbc7519762b025bec1b1766e986ff4abd7b96e3a1d7097899d1085,32897862399
20180718,"PAYMENT RECEIVED",1255359765,0,e44b5ac73666ede2b1e8e8d5fbbe9834b874ebdab924a50228aa0e670881842a,31647766768
20180718,"PAYMENT RECEIVED",1257037968,0,04469aa47bbc31279d20964e9eeb2f74c0830d4e8e884a928d980565a731d8e8,30392407003
20180718,"PAYMENT RECEIVED",1252584194,0,c24b2fad5756ba8e9b9213c595f8e9ce493a69635f03087c3d80e7b466f77bc1,29135369035
20180718,"PAYMENT RECEIVED",1257015311,0,396658076ef067d671c6ae979beeac39c150b7164f58436e16a62b3e190c206e,27882784841
20180718,"PAYMENT RECEIVED",1252897368,0,a625ac72400150850f28f63ef54c0f6427b8836b9061f85ca8800911bbaaf529,26625769530
20180718,"PAYMENT RECEIVED",1250000000,0,04f6f128e3b8a760e61c63d2cc354da5b7878fea65cd00281bc24cc870d8eb07,25372872162
20180718,"PAYMENT RECEIVED",1272161352,0,a00e612571281129df0cbd725e577655422c2e2d5850c343a54215a6e2e883f3,24122872162
20180718,"PAYMENT RECEIVED",1277361756,0,970c50b8d1e2196175256dc6e27976299c5a2a18ce00c84d601f69227f3cec47,22850710810
20180718,"PAYMENT RECEIVED",1316814510,0,c6317c65935deaa34818a2295bb9a623be76f7066b7287caf4da68d6b627866c,21573349054
20180718,"PAYMENT RECEIVED",1300748695,0,61a36815fb97e4bb40490bf507945af3603f7f0872067c854da1232caa236c55,20256534544
20180718,"PAYMENT RECEIVED",1251872222,0,19c3ef68ef0dd5164c1b91befb9cc4105b1922618c8239fe63022b7b6f0a7afa,18955785849
20180718,"PAYMENT RECEIVED",1252494237,0,d66e5d53fad7290a05f63bd1a664f81d1705fba8e7b9caf8c68976ad80ad30d5,17703913627
20180718,"PAYMENT SENT",0,-64365216483,262ccded85346d4d139a20c6a31563b98354edd7199295d8571264f9ce0111f3,16451419390
20180718,"PAYMENT RECEIVED",1264369382,0,3a7789d6df6aa3391dd4442865975ecfa548de195e6aa094810798cc7690b395,80816635873
20180718,"PAYMENT RECEIVED",1265081842,0,d7d2c73215291ce6809b6b6c367215f4220b2317ce19a1b6bab4e98f4d7fe058,79552266491
20180718,"PAYMENT RECEIVED",1253804693,0,b60f24697c68e4222c4fb246dd63dd484502628e065097a9bc019b99fa274575,78287184649
20180718,"PAYMENT RECEIVED",1273327035,0,2bcd76d3f0b7da36236d618c0203de3a4392f7c1b22eadeb7a0ca22989519b5e,77033379956
20180718,"PAYMENT RECEIVED",1253086106,0,b0d63936cb78f748efbfec80154d6bdac7850fc8708a784a281e1afdc1114a61,75760052921
20180718,"PAYMENT RECEIVED",1274491773,0,0400b46155b1bd84f811ece7fa90075349a2466316cfe3de0712e94d8138f758,74506966815
20180718,"PAYMENT RECEIVED",1284615685,0,4da0fbd711212696d5ae3674857e97653f904228188b0e4a14b9fb17eb006c80,73232475042
20180717,"PAYMENT RECEIVED",1259370458,0,c18b1647be1076057366587a71753e80f959dfddeeff6be37c2c4f0a55e6da64,71947859357
20180717,"PAYMENT RECEIVED",1266270564,0,4adde8bde470f2886846a513c512c719237dc9013521e2f256e855936961a6bc,70688488899
20180717,"PAYMENT RECEIVED",1260201851,0,b383eb31b97ef999781ce089dfc2a27531f26e64b04bad5b1723847acf256017,69422218335
20180717,"PAYMENT RECEIVED",1271144155,0,48e929e1a2f3696b12ca436119565fa937c66c12edab3a2b933a1d3bc203b401,68162016484
20180717,"PAYMENT RECEIVED",1262852751,0,0622b2b5d1351973ace3f842906f395f2efe48976e0544dcc887aee6c4f99b9c,66890872329
20180717,"PAYMENT RECEIVED",1262800095,0,a7968460ba6aceb0881c733ba95b4d84ffed2604938b5e5ab51161ec474390b8,65628019578
20180717,"PAYMENT RECEIVED",1259243941,0,10b45ae3c9960b173caf18e901ce7a68ff80d886d85e870f4035009026a4e7a7,64365219483
20180717,"PAYMENT RECEIVED",1260717377,0,f7cdb7c94b9f9fa0d1955b2861abc610bd1c32f7953c12bf022e2c08ebcf8a9b,63105975542
20180717,"PAYMENT RECEIVED",1250309842,0,fa8980abc2cfd16e108f53b3fd9e3feb934cbc3425a0587e1d8c5c64a69b50ee,61845258165
20180717,"PAYMENT RECEIVED",1261353409,0,7144b80750fe195f6c7287008d90c6f63476ff6a011d8327bd23fb6722797fcb,60594948323
20180717,"PAYMENT RECEIVED",1271140782,0,08accfc5415550125e69fb4ef929fb123b4f3672e26b601c3fae2865f83f563f,59333594914
20180717,"PAYMENT RECEIVED",1255271935,0,6d291b37bde38e36c8691b17f1f22fc3717e3c9abc2b92e074942d95c4291d7e,58062454132
20180717,"PAYMENT RECEIVED",1251115996,0,ca32244d85846ab2f591b1e5ebf25342a2943bbcd20632716da606e2a366df6b,56807182197
20180717,"PAYMENT RECEIVED",1268874860,0,24f5afacdf2e551afdfc4fa5401255f9a5e3681afea0ca1453a1267a4ff6d8f4,55556066201
20180716,"PAYMENT RECEIVED",1272684208,0,3b4fad10894618a7ae9c36ce59841606eb96ae0afc877550902862d9079d7f0a,54287191341
20180716,"PAYMENT RECEIVED",1254437759,0,d8af7058febe1da093d1dc07693bcf6cdb592e8e7a5b00ccfb944c9d4e0385eb,53014507133
20180716,"PAYMENT RECEIVED",1293631085,0,7a1b96fe20dd1d3f746b871e0c95b8a8f6c3273afcb1e1ef9f7b89b9d35d7f4f,51760069374
20180716,"PAYMENT RECEIVED",1257262711,0,760e33d77ce2b76da58d87e7c6a87a4c9f081ddc848793e81e6c193aef686fd9,50466438289
20180716,"PAYMENT RECEIVED",1267432104,0,0efa965553bfcc8fc82f2973ce44194a2522fbd05bf87a4a37e489f0e97e6c4e,49209175578
20180716,"PAYMENT RECEIVED",1254224108,0,ecfdaa8188a820267cddd2aaf5cea52ffc7e0bfc266c598f0ac134ddaff74d1f,47941743474
20180716,"PAYMENT RECEIVED",1274679423,0,57ca9c7683d5eef8c52d66c44b17f67b7e899cb9c0ec43a03b84c9b913f3d0fb,46687519366
20180716,"PAYMENT RECEIVED",1289061042,0,2ab269a2ab147e6033a1d9859300a598d401904e0b6ceb857e88e41757bb97a8,45412839943
20180716,"PAYMENT RECEIVED",1250378868,0,4d8b8ab24a92f9b4ede35b209faa28b338d4534984c45d66734ef21fb2a06214,44123778901
20180716,"PAYMENT RECEIVED",1252509195,0,4a5b2f387758212963aa55e6862e5901d56ae7103ec578fcb99a59b98aa6f9ed,42873400033
20180716,"PAYMENT RECEIVED",1255904406,0,92158c77c2325a8019a1b08399a19aecaf80f69abc9264687b1c41cdb6d22897,41620890838
20180716,"PAYMENT RECEIVED",1261932637,0,c7a8c1e4fe76d30528813338768014517d348be793a7a426b7a0a34fd2d097da,40364986432
20180716,"PAYMENT RECEIVED",1270686588,0,cd162a2e5b0a55eb5fe366979c7e67805a1714b5a3684fa10554e56d0ac58414,39103053795
20180716,"PAYMENT RECEIVED",1255647424,0,ed3d124984ad6b766c4f73c922844a3b4327b4ca5da76f22c5b4c066b5a286c9,37832367207
20180716,"PAYMENT RECEIVED",1263169807,0,3277e1647a43f6d924b7daa22c7b92bc43ef504bca743469855303f9a99691c5,36576719783
20180716,"PAYMENT RECEIVED",1270182892,0,6002b8346c252a50b33a683873d353dc075f8b976d6751398daff6f829636c5f,35313549976
20180716,"PAYMENT RECEIVED",1262871655,0,3f93b26f3a7136002fd28ef7788f9c10edb601d35fbb0599a4c940e2f1ba4053,34043367084
20180716,"PAYMENT RECEIVED",1266998627,0,1b3595d45c86a5c19c118a7ef1b04a3c44aa16d889b83d3bf7a5605efff79774,32780495429
20180715,"PAYMENT RECEIVED",1262016550,0,aabb1d2dc212dd9f21e2c9dce6d0be10c7a9cc52aba5a26c90427e8d3aaab8ae,31513496802
20180715,"PAYMENT RECEIVED",1253813825,0,de0de11d726689cda23fcdfdcee504ae73c85385b73d943d9e9b149d839009b7,30251480252
20180715,"PAYMENT RECEIVED",1251029611,0,e0a20362f8c4a732254f747dfc2e8e3b728b16fb52a31e230518b27cc8674ec7,28997666427
20180715,"PAYMENT RECEIVED",1282993940,0,381f8bf76234b89ef29d42fe9e46af89cea89a7a736c20651969c4c3805a7aa5,27746636816
20180715,"PAYMENT RECEIVED",1250907471,0,b581e7755fbcfdfd634812a51c43fe73478945f0639add0466d698155b2f2910,26463642876
20180715,"PAYMENT RECEIVED",1254589933,0,c428079fe93323397f9feb1f5e3b77bcfc5a3cfc2955de2062b902b1507f6ff0,25212735405
20180715,"PAYMENT RECEIVED",1262015165,0,0ad9d46df4f7d310a43a32a15a4a89591e6f33c8de7e13a139dc31905b287850,23958145472
20180715,"PAYMENT RECEIVED",1286113660,0,21a11af6e50c62c6cc7dce3afa338a02d5f42650973a9c9a6e1f5bc3384b149a,22696130307
20180715,"PAYMENT RECEIVED",1259496082,0,f52b930156ca421739f85a2e7d18303b69abb65cc1fd86be6b02de3ff06cad2f,21410016647
20180715,"PAYMENT RECEIVED",1265167554,0,1817708da1993410da88f160f4e750ffa1a22d837a88bdb26f1fd8d5a4aa8f32,20150520565
20180715,"PAYMENT RECEIVED",1261317329,0,53af22a26bdcdf6b775fb2d344296b6a12b490772315ed9ec41627859f80dd05,18885353011
20180715,"PAYMENT RECEIVED",1250485357,0,988d02bb994f6be3ea438ba9e4636ce2a684a500b632132656d8e764f6b5209d,17624035682
20180715,"PAYMENT RECEIVED",1259326215,0,2661a86898b5b99860ecad3276729f77d44f2429c215c2bb5672563a0b86b9c2,16373550325
20180715,"PAYMENT RECEIVED",1259100746,0,f9b3d2f9527fc18a48205c0b3054aaf5d7c3d95799817b06280b7a32f4912a67,15114224110
20180715,"PAYMENT SENT",0,-71900814298,15f45b225e053fdae00a29009e2f55955c9a99cf49283815a5f1f3b711d425a2,13855123364
20180715,"PAYMENT RECEIVED",1273307380,0,fa7ee13943450295d9c729a5374ba3b99018f6f77a2ab9162d2356ef6bc1e038,85755937662
20180715,"PAYMENT RECEIVED",1257422740,0,b04318ba61dc3791250c504175d9279d1b4b57ef202fe84f22569d52697d5b86,84482630282
20180715,"PAYMENT RECEIVED",1252927028,0,13cb3925d94ce01006ee0e09fb8c3e39fdcbb2f970c5fdb9bc8d7bd55d2ec9e4,83225207542
20180715,"PAYMENT RECEIVED",1254155531,0,b9660c849ccf4142a4ae5baacebc94b55aca1c68320b248c0ed2c9949aa888fc,81972280514
20180715,"PAYMENT RECEIVED",1250080515,0,535b8031552cbc7dd05bf4179d3bd7c9d6143ead57156fc208770e9ca01a60ea,80718124983
20180714,"PAYMENT RECEIVED",1271471296,0,c698a6e1e47f84d7891d478ecca3ec7273e1c2f502c6c36cf83dc731343d8cd8,79468044468
20180714,"PAYMENT RECEIVED",1264326389,0,9fd5d2e49816a59b33b8da25f130cf94cf3e55a955a780d6a57ebc5a14a861cf,78196573172
20180714,"PAYMENT RECEIVED",1268030327,0,2a7e455ec94248b620385473765cc51e730a3b5df23ef2cf05f1f51085718419,76932246783
20180714,"PAYMENT RECEIVED",1257266034,0,a60b95c043ed0ec9f42cd7738989ae50291f7eeede7818162f40d614aded219b,75664216456
20180714,"PAYMENT RECEIVED",1253514804,0,f230f450544fd1115045f45c0cd25b386cff6b67ce8b7c0e5fdf66397df7839b,74406950422
20180714,"PAYMENT RECEIVED",1252618320,0,90d24d5f9065fcb7eb24f5c1c4833d71d5abbbbbba61c061c60f1d4a83a9a2a6,73153435618
20180714,"PAYMENT RECEIVED",1263818341,0,b3117af2354975a3c847fc5e577c46b79f3ad4cf5d0488a37aab67b902ee98fb,71900817298
20180714,"PAYMENT RECEIVED",1265146325,0,5ae6341b7709be444a022a02f99e8cafe885c730fef10ccca65b1c8aa14f3fb8,70636998957
20180714,"PAYMENT RECEIVED",1259627864,0,2391fa16fd644090dae13f73d3c7e50b637306386c6924b62c8ff121071f4b11,69371852632
20180714,"PAYMENT RECEIVED",1254207523,0,d3b0a51a0efdbf8e43f14a196bee47a9432c4fc6de6eaf1d84ef3e20a128d207,68112224768
20180714,"PAYMENT RECEIVED",1264788874,0,ffa633a133885e11be2299952c0d47aba8bb590a6dcbcc0eb9fc7d30ede6d282,66858017245
20180714,"PAYMENT RECEIVED",1262413814,0,344d392a13c0984e71c00d96601718cb928d322846b68f65cb8ba974760e5385,65593228371
20180714,"PAYMENT RECEIVED",1260485923,0,00685effbce2a39a00da2150ca6d9f7bc4fb9b66201732f0c5a7fb23b0d6fda3,64330814557
20180714,"PAYMENT RECEIVED",1263396033,0,36970e6024f2f235807ed6f26e09c53beabb23c5c8714ee806dd5b3ef061720d,63070328634
20180714,"PAYMENT RECEIVED",1251905777,0,88136709f3002095b3ecaecbe7530cd9699e12949870433ba21233a912ead9e5,61806932601
20180713,"PAYMENT RECEIVED",1262126824,0,cde12b5900acd83f076b71ffea0ff13b4d0dd2463698d25e5dd5c81ac40f4b8f,60555026824
20180713,"PAYMENT RECEIVED",1264184532,0,93d5a34377da11d7ee4352fee62e0e34207b3157e3b153a46baa25124e763872,59292900000
20180713,"PAYMENT RECEIVED",1260651045,0,f7f5b887814615786029f12f2f37a56fea1a04780bfe775d8c02ec1de972c22e,58028715468
20180713,"PAYMENT RECEIVED",1257359401,0,00f2a49fbb5829ef229e826de1141b702c4862201fc284575833782d073a3bed,56768064423
20180713,"PAYMENT RECEIVED",1259397723,0,02d865c0a4cdbc5524d2c41e7f8248207fb97c12f4da3889ac0dbc11bc11e901,55510705022
20180713,"PAYMENT RECEIVED",1253749222,0,c918799d0bda4458c4824019b217159409362d0fcc8112b6cf2453269f401921,54251307299
20180713,"PAYMENT RECEIVED",1260810515,0,162934fcf25e40662b014adc2863f44bcd7323cd8b02dfa62cae3d041e3c1454,52997558077
20180713,"PAYMENT RECEIVED",1280353010,0,1a2972149089427e2ca0ed85402c0c041b66ed1e2698e352a132fb75e43ad1b6,51736747562
20180713,"PAYMENT RECEIVED",1282154252,0,06c7ea9fcadfe3723d317f88d68360af66dc71cafbe22ceab6edb96922913acd,50456394552
20180713,"PAYMENT RECEIVED",1282381597,0,d2debd1ff9b4f3d1da79bd6db87d4e883cdf56bd09506d9e8cbc1fd74d7013de,49174240300
20180713,"PAYMENT RECEIVED",1251786707,0,36aac8637305216b7d6e0673c69d356dfe6d790a01ea3841a2daf829438cc6b9,47891858703
20180713,"PAYMENT RECEIVED",1265982875,0,b3c1b847d041592e4b8594b3d6eec69c985472379cf3a6bcb991e1340c362b99,46640071996
20180713,"PAYMENT RECEIVED",1253067783,0,c972edc11212d5c0c4fe899beb34d2792334f4e24b1bc5c394a7984534ce833a,45374089121
20180713,"PAYMENT RECEIVED",1278248762,0,aba09707566f6ca271a29382835bc2ad649dfcbfa07e5ed76491ff8c8eeee8d5,44121021338
20180713,"PAYMENT RECEIVED",1269462834,0,e7f221c123e102427a0f3fa598b88ed07403c4a7d94b35ab305293f8b7a13dbd,42842772576
20180713,"PAYMENT RECEIVED",1266491035,0,3408d8b8279b6ba242467923d518c1ffaddc2738d8d00155a435c78995566c7b,41573309742
20180713,"PAYMENT RECEIVED",1251786520,0,7264a2a829e259b4c0eb053d2f0ad45f9be3d41dd5c15539acc476988c54a519,40306818707
20180713,"PAYMENT RECEIVED",1251331149,0,b18c4400e319bd6461499ed8ba2bce08fd4a5f2aab8a90363b13efe6c39f9b5e,39055032187
20180713,"PAYMENT RECEIVED",1255712595,0,64e6a82cb4756ed4fefc123464208994bf6c32bca3d5636fb28fae486c8b384e,37803701038
20180713,"PAYMENT RECEIVED",1263324098,0,11bf568bc131438dfa5949a2eba604f7e48421b4a14fb9813f4f06c2cb4664df,36547988443
20180713,"PAYMENT RECEIVED",1253131899,0,f342d92437f2ad3ecaf96bdc16b05e288ab990db9279614be9f764d7e6dd012f,35284664345
20180713,"PAYMENT RECEIVED",1251679514,0,ead6c432ccbda1c0348eaacbb552d20f55fbb4a4d97a9a109f60ef3d6f3e1b77,34031532446
20180713,"PAYMENT RECEIVED",1257511209,0,a0dedbad6668ee062ccde8e506b1329058b22afdd2ad0e8afbe4e4a402c1cafc,32779852932
20180713,"PAYMENT RECEIVED",1261903841,0,ccdb48c5ad84878a0442c659e8ab2e737ca2197ec2d80cc9688c13b04b5683b6,31522341723
20180713,"PAYMENT RECEIVED",1252465431,0,25dffd267daafc4261710334e88d516008a0bd79aee91d165f4ec1511ace6b8d,30260437882
20180712,"PAYMENT RECEIVED",1273984638,0,73ef61f72596be27f01937ead4cf9a5b535821d9a5a6ef9c33c58d9988417c77,29007972451
20180712,"PAYMENT RECEIVED",1252041021,0,b0e19c8ca8c43f840f5bfdde15d2744a708f1f28a8cd1d1b0a771b8af95f0fa4,27733987813
20180712,"PAYMENT RECEIVED",1251207367,0,7634c6d52fbb55a621bf964ce361e19f4383dce72a566a5be275b467b55a4fac,26481946792
20180712,"PAYMENT RECEIVED",1274165284,0,928106f76830219fc63aad002bcfc908f39f37989b17cf5d8cc750e863b6c1dc,25230739425
20180712,"PAYMENT RECEIVED",1262747045,0,0adee9ff428e21dce56c2d0a3aa6c06b31fba314336d3364c248fa5d3aa3d9ee,23956574141
20180712,"PAYMENT RECEIVED",1259006772,0,7fef2d963356c9cfa2944da79b76e8e91347cd33e2e4b0794eab8bac885a539e,22693827096
20180712,"PAYMENT RECEIVED",1257551742,0,e285a1e287515e11e4d1a7eed54a22391b3abf3e128a12b6475b1f680405104c,21434820324
20180712,"PAYMENT RECEIVED",1270311315,0,a2d05255696b7ce02254ec303b17b3011660a8a577da3bd54e7f820db9ee6e46,20177268582
20180712,"PAYMENT RECEIVED",1256470055,0,d06150f835d33541c2e5542cd5bdd7a165ac4f1b61dcae1a9d2a3a4aadaef310,18906957267
20180712,"PAYMENT RECEIVED",1283568589,0,efc70b7b8a20c86c0c3e978dd0985c52925f40bb763ee806cf0b3874d959bd32,17650487212
20180712,"PAYMENT RECEIVED",1261951101,0,024be09e66d8ad1d23a326a649d543ad9ca424cdfe3f9e5f3866599a88b0522e,16366918623
20180712,"PAYMENT RECEIVED",1251517586,0,f487f6931d235dc907d4e44ce602c771e3e0df2f4d4720a7b044976697b5f933,15104967522
20180712,"PAYMENT SENT",0,-63169170869,bf0b820535c9397a2e096ab7758a78f48d704ca9e4959b0bf472bbf3dd5004a8,13853449936
20180712,"PAYMENT RECEIVED",1251336392,0,ba420d19f4e68dc75e2bf71601e89264141d9efce7f859628f50fa32c60eec5d,77022620805
20180712,"PAYMENT RECEIVED",1254051955,0,3a7d4334322de808665e055c7e105d93f8a2df42367011ed7753c155e40d6ac2,75771284413
20180712,"PAYMENT RECEIVED",1283311975,0,f324f479fb5a1b152b1f8d7134b441021cea3e5b52387ea27717c514ef600cba,74517232458
20180712,"PAYMENT RECEIVED",1259622519,0,3187cb5d81c5bb27f08a5b8dbd9532cd2c832bcb8622e204dbb79b6dfe8f3cce,73233920483
20180712,"PAYMENT RECEIVED",1259809610,0,f82b0ed1c9301c97827d18349873c88bb4e3509a3e7ff99be1449cf3320305ac,71974297964
20180712,"PAYMENT RECEIVED",1253311358,0,2d19956a88d7c368bc3d304d93e4a201ac5cb95b9e48a570c7738a59311ba230,70714488354
20180711,"PAYMENT RECEIVED",1267593025,0,352c40ccb89daacb46eccad1fc1898ffae9e94d1787394a4a03c74aa56c8e2db,69461176996
20180711,"PAYMENT RECEIVED",1251909108,0,1ac6f10adf8f726c8991f84407a36d55620e68c7318f9e72a1880cd2a7519023,68193583971
20180711,"PAYMENT RECEIVED",1258539387,0,2e072d73c83926492500ea53c5d5ba51688e5684f65436a8aadbc3ea11743f98,66941674863
20180711,"PAYMENT RECEIVED",1255379389,0,cca9d616d273c5b63d9f5a5df2f54c3d3b5d51fc27e66f92c855bd21c084c3be,65683135476
20180711,"PAYMENT RECEIVED",1258582218,0,a107f347623711ef8b1783651782949932fcb79be61bf0495c4ba7a7cb3f895e,64427756087
20180711,"PAYMENT RECEIVED",1252249918,0,efe8b7f1f87b91a438fa8ef5c458512b1bf731e770c876dabb9e0f314537f543,63169173869
20180711,"PAYMENT RECEIVED",1277464626,0,9e1e5ab61859644a8439529f15b64c7380d90ec095cc6aee49713b03dd9c5074,61916923951
20180711,"PAYMENT RECEIVED",1278889630,0,9a8a22b644b69b6cbae98986ebce68e404337ff880eeaec6d4e868d7124398e6,60639459325
20180711,"PAYMENT RECEIVED",1250000000,0,f538b64b10ae24f6ad0ae6eda594d8f09bfe20ae16b15a147048f84d6bb6d84e,59360569695
20180711,"PAYMENT RECEIVED",1284267951,0,e00b329118b98280ac555e63b6226ed4fcd0b4aeb492b469d2f46a85620d018c,58110569695
20180711,"PAYMENT RECEIVED",1269485281,0,41b5f40db787b44ab29bbd384b14d78671be9c2014417431e2228aab32544f3f,56826301744
20180711,"PAYMENT RECEIVED",1265060846,0,8a1102d1f030389012320059d90a809d3a1c28d90cb89de5eafbcdc2cc4a6dc9,55556816463
20180711,"PAYMENT RECEIVED",1250339495,0,c44e879a534ac173106d1cab339e16836e58d30a00897b930e799330c6243436,54291755617
20180711,"PAYMENT RECEIVED",3000,0,be3e027f18ceefbd096afa75049077ba3f8500dc8b89745810c0d1a70fae95e8,53041416122
20180711,"PAYMENT RECEIVED",1252134442,0,832c67891d4bbea2f9f337a2591fd29b815a5b2a9bd8700cd828f912f95168a5,53041413122
20180711,"PAYMENT RECEIVED",1251281165,0,93e576fd1a5a6237a256675acb204a566bd852be24011a7a8bd939ee9059dbc3,51789278680
20180711,"PAYMENT RECEIVED",1254335878,0,895df8f04118cc381fec69a86c212b67a23a2ba748babf570d567b6d29621a83,50537997515
20180711,"PAYMENT RECEIVED",1268306350,0,89abafaf26125c865cec955121ea33bac4e0a47ba71ab4683de40af667fee3cc,49283661637
20180711,"PAYMENT RECEIVED",1250716783,0,48f5589aa69957ee2c32a4cb6caff66eacbbdeb855ead500f29b4209ab8f89f3,48015355287
20180711,"PAYMENT RECEIVED",1252339712,0,2a892be8e39f6c004dc3b70820e385d202451f6a2716cc15efbec1a1eae5f868,46764638504
20180711,"PAYMENT RECEIVED",1271641722,0,c52ff3e3d43bc3054b6f3d0a6a108444e35aec4be6c85bd7b79047d2d32e5917,45512298792
20180710,"PAYMENT RECEIVED",1275348285,0,97c041a0f305b555c752ac1920b9551bbd347163260cd37ea0abfe1605959e26,44240657070
20180710,"PAYMENT RECEIVED",1269143773,0,a9da0640810643fd331a9d83f8361f8ac266a989e40735fc7bf7611f974a57dc,42965308785
20180710,"PAYMENT RECEIVED",1250242826,0,ec9d25440cb09f5d116658ba65ef3901406c4c9c048463d90ece5315237d9ea7,41696165012
20180710,"PAYMENT RECEIVED",1250739147,0,553421131022ec081d2053f6ddedcf8493eff622ba366b72d01ad2c3c40c164e,40445922186
20180710,"PAYMENT SENT",0,-40371750491,d7bc1a49d993ba0a30c48538f87897aebaf097ce723c7b96b2427086827f7a2d,39195183039
20180710,"PAYMENT RECEIVED",1254461035,0,3e07c442364fb69d83591ca77b8399d1df873655732d7c8fd0bf5fe915de1609,79566933530
20180710,"PAYMENT RECEIVED",1277282880,0,7a5c6459f39029342c64c55ca545ef56fef689db9c5e72582be945c44456edbc,78312472495
20180710,"PAYMENT RECEIVED",1256471106,0,2a46200fcfa936c339baf89f5302a64fb518261e38c53378eae3e17a6e937a8c,77035189615
20180710,"PAYMENT RECEIVED",1264739439,0,7cc47ea3563249b3c26a3a44ad35e0663fce4c126941edb6fc9bd92b15eb4dfd,75778718509
20180710,"PAYMENT RECEIVED",1303811060,0,b28ca612e6231e15754260e68cda873d8acb519ba3085e301f23b8353b5ba443,74513979070
20180710,"PAYMENT RECEIVED",1258391664,0,f8c67dabba6cbb9581fad6cdf09e85d2704b554db456e55adfe9636656531807,73210168010
20180710,"PAYMENT RECEIVED",1306128944,0,2da8f881440092d96e6aab3a778a41f8618d448b7e407eb3b173a19daff4a541,71951776346
20180710,"PAYMENT RECEIVED",1253907580,0,15e208d9b865b7f23914e90fcf66fcabf47abcf51c926463944d3d8a0f0a4f2f,70645647402
20180710,"PAYMENT RECEIVED",1268070161,0,efcfe23423bf8575bb732202a7e7107c9c09ebcd73e682ffc17123d41e694f21,69391739822
20180710,"PAYMENT RECEIVED",1268405280,0,ca3d3af62e33e06e622086275e3650855b068f90cb823caf47e08f9122c1ce7a,68123669661
20180710,"PAYMENT RECEIVED",1275458396,0,1320b4028c94c378b2b0b7ef82771588f74f75c15dff1ae79d1fd8f00b03a137,66855264381
20180710,"PAYMENT RECEIVED",1281693146,0,983ebd43d16d33ab118945466c6c74824c1ab41e67bae770ed01b7bdecb02116,65579805985
20180710,"PAYMENT RECEIVED",1255189978,0,8229952a76836cf28b45e6403315f216c2f0b453ef44e8f3cf45f44e0979f7ee,64298112839
20180710,"PAYMENT RECEIVED",1266019550,0,addb0c0c53f606407fb88ff89a8451ce21787b38e9b1872f6182a74a16de6e87,63042922861
20180710,"PAYMENT RECEIVED",1260945950,0,7544c7c4dcddfbb49cdf342824f95c93ca9983537421cc4961f9b748588c6fbe,61776903311
20180710,"PAYMENT RECEIVED",1251562453,0,b2bcb6797c31c01920af82494e9343c7f1e3b4166f567f1687e1b41f2ce8d728,60515957361
20180710,"PAYMENT RECEIVED",1256899129,0,18599e841754137b24d7dee64a0646e4cd2336e3efe57ebc5d422d47c4c32479,59264394908
20180710,"PAYMENT RECEIVED",1256281562,0,6fd0513ac3467e8b559b8efc491b8fa6da2707123db856411d57103f5cca0a49,58007495779
20180710,"PAYMENT RECEIVED",1252251474,0,20132df8ca3df20000067c3209c6a70ce1cb42ee7dc3a9b1f2c907dc2efa0fa0,56751214217
20180710,"PAYMENT RECEIVED",1266512072,0,dfcde4c1bb10c4b76a8f9d755332c9d0fbf83869d18d79be2d926c5799d7d364,55498962743
20180710,"PAYMENT RECEIVED",1251153623,0,9c7993987298f9fdab349a3bdceeac7d5738516fca642e6e633d2f6dea7d33ce,54232450671
20180710,"PAYMENT RECEIVED",1281882339,0,8fce6f74fba10a10fde04012d2fe47c683edc9c8336cb655b1b4bcf0b6f97d62,52981297048
20180710,"PAYMENT RECEIVED",1264673365,0,48464f3344f41bd98279d16f0b40fd10fe5652ffea3173389d17773d16d75391,51699414709
20180710,"PAYMENT RECEIVED",1251401371,0,7c6b38d58e5d859f11d769cd581140a5274c0499dd8d8ab343613a4c3a7734c0,50434741344
20180710,"PAYMENT RECEIVED",1260454428,0,656da01cfa3fd9f2e99283d1544776675a548eeb76af32fd98f02a5912900eba,49183339973
20180710,"PAYMENT RECEIVED",1257463570,0,254462045fc1c13e64b938bf58416d8d778cc4f8bda620cfc7be9f35bfdf5944,47922885545
20180709,"PAYMENT RECEIVED",1281667494,0,4919f0050a6a3765e99e01d5e40c7451af32f32cde44a8c4bfc10a5f5258ae9d,46665421975
20180709,"PAYMENT RECEIVED",1263977177,0,09e3c0749fb9b407389137fc6024d31d18ee85893dc1f29327325d23bc0e4860,45383754481
20180709,"PAYMENT RECEIVED",1265345794,0,c0f90e7ca510d331158e0063dcdd8e3b0230bf4f8a952f9e0e453d0369b09256,44119777304
20180709,"PAYMENT RECEIVED",1255343268,0,bb039ff440dd7d691fd557e67867183bbbe4b04d25078167b668172eef277a81,42854431510
20180709,"PAYMENT RECEIVED",1256576524,0,2c746726a3a136b140823c142e42aa7745976542d83e624411ecc04db702b4ac,41599088242
20180709,"PAYMENT RECEIVED",1278949072,0,da52bd6ca347721916c3afd13432fd18f0258038a919511b573d0f5f64eed69e,40342511718
20180709,"PAYMENT RECEIVED",1253254539,0,f5b45643e60c61485808d87967f5985b2b31cef70f99cb41e493ddc5f1da469d,39063562646
20180709,"PAYMENT RECEIVED",1252882740,0,1ad3f98794b330ba93c419839619d0ff804fd9d431c90833bb5b3f327a4bed64,37810308107
20180709,"PAYMENT RECEIVED",1264914446,0,6b794a3098b2a927346c61e0af74ea2272d337aa0519bd05f408d0a51a1619a0,36557425367
20180709,"PAYMENT RECEIVED",1262885224,0,7dbfd8e34a65fa0640046762bd4c5ba987cf22a7fffe9991cc0db699e8af871e,35292510921
20180709,"PAYMENT RECEIVED",1261421696,0,0b2b563fdde8369847d10f86dba12c327082a94668561965035ddebda3134805,34029625697
20180709,"PAYMENT RECEIVED",1257400126,0,caf296b877336d0e628ea67da7cbcb2234c4cde7db902641d218c00ed8027b69,32768204001
20180709,"PAYMENT RECEIVED",1263510052,0,576040112704da924eeaa15bb80f6b9737a600e404c92fb9b16b1cc85d135aef,31510803875
20180709,"PAYMENT RECEIVED",1265987822,0,a4639645948f64253480871561509facc157fe030c84d0e583c2023a83a5b84c,30247293823
20180709,"PAYMENT RECEIVED",1250000000,0,16ccb12869ae6ee1a7f47ff08cc14d31c26afb87e07594a4c0dfd55a71563598,28981306001
20180709,"PAYMENT RECEIVED",1258221794,0,834cd4582c80a2a377d7bcb5d6f640024d0a64c71e0a910ae4df2a3d6c0dff48,27731306001
20180709,"PAYMENT RECEIVED",1253360956,0,a1567a0e2f2516d1366a89bdfa59d8030fa2cc2d97d72fe1a331dd1c3a0993ea,26473084207
20180709,"PAYMENT RECEIVED",1268293928,0,c487860d1693d74d9493bf16829f5180f7ba606873dbaff7ca3930ffe98bdb7b,25219723251
20180709,"PAYMENT RECEIVED",1259679047,0,6b6dba79fb0004a4a134d765d519ecd7cdf930489ccf4e29fbfe062cb5f9c7e1,23951429323
20180709,"PAYMENT RECEIVED",1262688795,0,ba7817e3b557740fc757644bd6bac4bef89c5c409d49f5086e0dae4dc95a6cdf,22691750276
20180709,"PAYMENT RECEIVED",1255345661,0,f3280bea7d368f04601cde7edbf70bd74bfbbc65fdf6bf4436327d4ecf178a09,21429061481
20180708,"PAYMENT RECEIVED",1259342058,0,1c81e25e3ea0149990476d1b21333c0ca59d18f9bae884e2258e0dbc358b9d38,20173715820
20180708,"PAYMENT RECEIVED",1258492187,0,44f79a92a63012cf0300f0c7b8f5aaaec267a2db662c55b1dcfc364e36100b78,18914373762
20180708,"PAYMENT RECEIVED",1256411160,0,8dc6edb7c9163bff5f22947c786a79ade47fda76531502e3dbad36b3783c2b88,17655881575
20180708,"PAYMENT RECEIVED",1265169269,0,206e56e84e0c6b4354f4b37de530c1dde4607a4a24a46b90300a0bd3ac82aaec,16399470415
20180708,"PAYMENT RECEIVED",1261758428,0,b30f74bb335173503323f495b9c6868c4f59321b1129074bf7957ab6d66c22f7,15134301146
20180708,"PAYMENT RECEIVED",1250126329,0,0993293fcf370f09f08034ade1de060ef89150fb21b42967e063546b77eb6518,13872542718
20180708,"PAYMENT RECEIVED",1257087231,0,81bb09653ca021652908419f3d61aa29ee5408b821aa4f36822395593b793d61,12622416389
20180708,"PAYMENT RECEIVED",1264783940,0,97374f429e7fc73af44624fe71c5de3f743cdf09cc4cf9037126ae20df69c0ef,11365329158
20180708,"PAYMENT RECEIVED",1284649826,0,a5f0288fa0729bff513ca04d2b83f29a8893b8aada44572e093bc0c44a6b9059,10100545218
20180708,"PAYMENT RECEIVED",1251029750,0,464f1d58fc660526c2f1462b9cc3aa9e92ef2ced979595ebff7e28b8566eedf4,8815895392
20180708,"PAYMENT RECEIVED",1254059187,0,1878b19eac25304471d7aeb3506970b5b1fa0245031e5f2368bb1b52e61da83e,7564865642
20180708,"PAYMENT SENT",0,-65466460610,448a7c6bd4be70873636fbd1ebb5ceb2075073d2e23c3c2c7781d672abd3ade4,6310806455
20180708,"PAYMENT RECEIVED",1256817523,0,35debeb44b6afaba81ab7c439f4f04fe1c0a0ca20377809b09ca289dd1020958,71777267065
20180708,"PAYMENT RECEIVED",1252592295,0,5f24cc298c715a49892272e370c7ef18ee612be1bca30953d2fad5515cbf8968,70520449542
20180708,"PAYMENT RECEIVED",1273880581,0,add16735c7adaaeb8bb30c3d5c93c0985b2f76d36f4f1907fd169d3e7665ec2d,69267857247
20180708,"PAYMENT RECEIVED",1256564396,0,1d0f8c7cf150a4566a2be99bae5e396108ce52a72defb3c4497756251646a502,67993976666
20180708,"PAYMENT RECEIVED",1270951660,0,a52abe7cddfb831ad6db072039deeead6bdb668859ef400bdbb8e7d4bae59d3d,66737412270
20180707,"PAYMENT RECEIVED",1255645898,0,2988cd7f2ba4bc99f476edd90c07ce7f26d466334edc01dde7f38c3a49c5fa94,65466460610
20180707,"PAYMENT RECEIVED",1254769977,0,fd79c49a18838b3d52325f9630e1630865ac79274214ea0675c7468423ce40a1,64210814712
20180707,"PAYMENT RECEIVED",1250031278,0,d34db2f0bdeb4b4c38beb0d4ecc83fc2cdbf4339c088adcb3595793608f3c3b6,62956044735
20180707,"PAYMENT RECEIVED",1250902971,0,46c1a20abbcecf6c35a239c85645fe9c9069ae7caf2b2205170fbbb5739b98c2,61706013457
20180707,"PAYMENT RECEIVED",1253926494,0,bb78688b29ab790657d827081c3ab5248dadeffca1d6190fb2630efd58c4ab73,60455110486
20180707,"PAYMENT RECEIVED",1258219660,0,5af57e75f949993c77a370466132db21162d0ef25d85ce14cacd8e30e40eb3f6,59201183992
20180707,"PAYMENT RECEIVED",1252088005,0,b2ce40523c21ccdc27c699808ab6d458ea1360dd94fd99298f5849fee51950db,57942964332
20180707,"PAYMENT RECEIVED",1273432931,0,bee303ec75691448d2e0d40c10fe9fd7348d7151aad90c62570f07ce70e295d5,56690876327
20180707,"PAYMENT RECEIVED",1252357192,0,09898d42d8ebdaec54d6caa8ac70526eca9c410a88de06709516b0d42f1b2cf7,55417443396
20180707,"PAYMENT RECEIVED",1257132933,0,0df456bee4e5445370be06755a5eff2e5f5c05e0aa55cfcab0160780710aac90,54165086204
20180707,"PAYMENT RECEIVED",1250080251,0,9563b3b5eed8ce77a2f9c63f95e4f7beaf26ea72b93b3f48a5132eb4cdcc1113,52907953271
20180707,"PAYMENT RECEIVED",1252190222,0,d481c858ecd197a2e55e43068f1d4e7710caa10fc82521290b38933869764ee9,51657873020
20180707,"PAYMENT RECEIVED",1271307854,0,524d69935fe066cf85e56b1840dfd4c9c350c0db505179783c0406bda100d225,50405682798
20180707,"PAYMENT RECEIVED",1251362239,0,acfa28da9bf74bb507578c08458a978427017ab99d3ab5286d40e867065c1afe,49134374944
20180707,"PAYMENT RECEIVED",1264824097,0,b65d1496a7647decbf3891bd264c72186e16825624e63d7e61a33fbb69dd162b,47883012705
20180707,"PAYMENT RECEIVED",1250000000,0,f48184101eeb5f5a0049ac0f9f46c4175be2e13ad465a174c14cbb10a8922e99,46618188608
20180707,"PAYMENT RECEIVED",1250270675,0,43d78109b358221f412ca3d3d8450481cd8f93e680acc1d33aadab560e9c5906,45368188608
20180707,"PAYMENT RECEIVED",1257714160,0,c88560f5edc980599c68e1803a95af26efa68c9dd5aab059fb81c2723431916f,44117917933
20180707,"PAYMENT RECEIVED",1261630643,0,d89053edfcde4a373a46698e71699abcf4aec66c15ad155bbaaa653858684914,42860203773
20180707,"PAYMENT RECEIVED",1255317961,0,72e5ede457b18ba85c23d196cee54ebfa7956f1ea7cf40671e54e6927f228e3c,41598573130
20180707,"PAYMENT RECEIVED",1258995373,0,14f6bf03a1ebb05020267fa5bfe7ca6ceb6bab0447cd74dab72d55b5b19fbcd9,40343255169
20180707,"PAYMENT RECEIVED",1271639543,0,5913411699fa459f868f00e996588676bfe28d57701d6c298b1105d517cb0fc8,39084259796
20180707,"PAYMENT RECEIVED",1269195668,0,3d62edd1262849d8a9f91a963adfde755d702d2629e14e61a1b599c2a425da1c,37812620253
20180706,"PAYMENT RECEIVED",1251691153,0,736a28655895f779212a23c60155249ab2b0ae0a57abc66f3616cfe9ea0973af,36543424585
20180706,"PAYMENT RECEIVED",1251956653,0,b1bfefbedc49344ca35f379128399a8aa544b4fed9fe1f748bf1034f17f6728c,35291733432
20180706,"PAYMENT RECEIVED",1250546415,0,62acd1f7530855f1c56616dbef119f74b8d5119a59d75d2b44f390ed1c966930,34039776779
20180706,"PAYMENT RECEIVED",1259654732,0,9b6a44e920a76a7367db84dffe4b2a1b226590f8f061dfb03256a955958e9e61,32789230364
20180706,"PAYMENT RECEIVED",1259251848,0,8c9cafb8229274169606ab423b9f0fcd3678b5de34ad6cf424322af626560916,31529575632
20180706,"PAYMENT RECEIVED",1259700938,0,cc5b2e0edd1c4310c719c96b9931132d4ad2903e78cccf2f4cb84d12b0ad89aa,30270323784
20180706,"PAYMENT RECEIVED",1269883924,0,d5865332924d20a8926550a9a672bc8c087ae697547cb98bab6546bfe9f62955,29010622846
20180706,"PAYMENT RECEIVED",1252251282,0,42bc8618c3f0f8ee6b8bb221c746f3975cc2cc43ce5a41878b3f1abdb9b5d358,27740738922
20180706,"PAYMENT RECEIVED",1263959929,0,086a548aa0e46b62bf90d7afa93f03069b302e6b4dc72e33c56aebca5c52d170,26488487640
20180706,"PAYMENT RECEIVED",1260927392,0,2c67a2b332a47122bd73389c62671b308f7d3c366efffefbe4d0e4f5d87bec2e,25224527711
20180706,"PAYMENT RECEIVED",1252456267,0,23282108282bd08e6b0d80897cad49499b11c40dee817a11856c2efad2189e8c,23963600319
20180706,"PAYMENT RECEIVED",1258624873,0,a21fc91d070bcff5b5442f09c431bc5ed1eef3a35777bc614ff14f85b54408d8,22711144052
20180706,"PAYMENT RECEIVED",1310674578,0,19e90ed58b1e6a9eec80496312e3e14668287a6a91cfde2853d21c8cd7139236,21452519179
20180706,"PAYMENT RECEIVED",1255470825,0,cd6fc675dcd0418328ed37922334989bafb836cb581fdf8d94db2f79d4322e0a,20141844601
20180706,"PAYMENT RECEIVED",1273858684,0,0a87cd267ab6dc2fbdceb68ad1e7ac59c31aa4f4d5099754f31aaadfbde450ee,18886373776
20180706,"PAYMENT RECEIVED",1262806670,0,8f417e1f2b1a9c384b66505ca6a7eed6ff1940f4c5f23aec8c50f5217ab2d5f1,17612515092
20180706,"PAYMENT RECEIVED",1253160760,0,9915a0c6bf0d18e3dabb70e8cdb9afadf69cf0fe9777f0e25a756a2c68332c02,16349708422
20180706,"PAYMENT SENT",0,-34294964780,04df8607ac20de2114c2e1dbc48ac14faa24a02f4889a1e2ce22fd1943a0be1b,15096547662
20180706,"PAYMENT RECEIVED",1257617328,0,184ed8fa14f3a10f911b98c13494d766f65dd55d63e37f7b916de94547e22e9e,49391512442
20180705,"PAYMENT RECEIVED",1250788596,0,1b4d07755bb03c31ddc71852c6ce7aeb09f46a1a9a22ace23aaf3c83ad9b5d67,48133895114
20180705,"PAYMENT RECEIVED",1273167800,0,137dbd12d47c4069a76249210bfd0d510598fcdef99a9a1f8db44c92e84e6c73,46883106518
20180705,"PAYMENT RECEIVED",1265731394,0,9fae38c5ae26e189c9d19c5d3fcd190ca419f655f2a79ce6153677865cea3d4e,45609938718
20180705,"PAYMENT RECEIVED",1254822178,0,e4ddb29df0ada65439ec3ba57447b92f5110d4d53285622fc8c098df349a2b2a,44344207324
20180705,"PAYMENT RECEIVED",1265830272,0,89d1cf8d70f928dfa238daca00969cd816a44000f88f05de35d81850b9b23a06,43089385146
20180705,"PAYMENT RECEIVED",1266637625,0,2211694af043cd3b05d2676331f89b85179ca26246bfe39164b22946cf7554a8,41823554874
20180705,"PAYMENT RECEIVED",1256093089,0,f8a1bac4d160d8365600908c4f4249580847a554b55b80da9edaf123306f8f64,40556917249
20180705,"PAYMENT RECEIVED",1250062373,0,66d90328057700ae66cebc48216715e2b630f3dbcb533974deef0d960c1197a9,39300824160
20180705,"PAYMENT RECEIVED",1250717790,0,a91fe95d5d2c2af9ee97d91a3bbee20183922370da795d2b9e2e16767e9957cc,38050761787
20180705,"PAYMENT RECEIVED",1254842787,0,070567f381ab69645b923a18e4936114f4fe43152e0fa5cf567645849d07b0bb,36800043997
20180705,"PAYMENT RECEIVED",1250236430,0,2d9b368fe951399699769cc4a6fb36876c1a2e2bc9f99058a854e936d76c3150,35545201210
20180705,"PAYMENT RECEIVED",1252433707,0,73beb25b1241aec9ad63bb2eeeab315c427a7cda68826fd1500c4c3fbab29492,34294964780
20180705,"PAYMENT RECEIVED",1276395080,0,af89e5ac01d42f9e310d8f0734418dbafb9122324c5d1aeee25d34b172ac435c,33042531073
20180705,"PAYMENT RECEIVED",1253474894,0,db70fdd2fdd99b89195f83f186b5df87b1eddcb2394cb292df3fe711383130df,31766135993
20180704,"PAYMENT RECEIVED",1277005242,0,9596cd666272467f70d9e01823972e72374c1ea28e5b5dc2a09214c3647bf48a,30512661099
20180704,"PAYMENT RECEIVED",1258800565,0,176e6daf0adc1730f2bb39847fcf80c0a67067800926ced418eb85aef2d6acc4,29235655857
20180704,"PAYMENT RECEIVED",1262691969,0,58dba73695321b2507e7f95b6c268080aad70927736def915ebaf56503cebb13,27976855292
20180704,"PAYMENT RECEIVED",1253872588,0,a94280093fbe0d695f554ba7ff26f2a1f5e990edd94e3064cd1fd92eb1b7d8c4,26714163323
20180704,"PAYMENT RECEIVED",1250064203,0,4092fb681ad46ffa5171dab106cf049b6b6413fba65050e7e9e170987b444383,25460290735
20180704,"PAYMENT RECEIVED",1253719548,0,ac077934742f8ef2516bb16ae8753111fc60cfc6f6d9ee584eeeb0319ad6a305,24210226532
20180704,"PAYMENT RECEIVED",1290964566,0,7763eba923c91ce1280203750f49e37442b8963864217b522cd107c72a454b76,22956506984
20180704,"PAYMENT RECEIVED",1261361745,0,5b17da6321124c685ac9bff0e06d84ade06841440b589b96055a9b375c9bdda1,21665542418
20180704,"PAYMENT RECEIVED",1259185674,0,c968a16c4f7b206c9ab870fc68f3378fb6188677af86d2bc7bee33e2addec9e6,20404180673
20180704,"PAYMENT SENT",0,-40721316356,97b371268795427b7d57016e5da103d443fe2c1137376ae8bb69859592c9b3cf,19144994999
20180704,"PAYMENT RECEIVED",1259960891,0,c9b71fedd4bf5e3939c46196c01c591302103aadda562a515eb9b975c32aa612,59866311355
20180704,"PAYMENT RECEIVED",1266277937,0,90335dbbcf2b50f98c080f817b326a59003858230da4829baa017f9d111f02f1,58606350464
20180704,"PAYMENT RECEIVED",1253480030,0,e827a28f24c16d5e58445ece6dfb254cb7d0a33b03d7f1aa945b9d7a375ea1e5,57340072527
20180704,"PAYMENT RECEIVED",1285047058,0,783743d2cc75b7bf734390947fe9e8d1968b38de99c646df8210a22421470440,56086592497
20180703,"PAYMENT RECEIVED",1275481724,0,8444ca0758325ac36acac1ca2376a60b469318dcd66343c7a87756d64b4ebf2f,54801545439
20180703,"PAYMENT RECEIVED",1259040259,0,067a632eb68e333241607282bf1794dbeb8a78558b2f74f5157bf467aa07c6e5,53526063715
20180703,"PAYMENT RECEIVED",1285951253,0,ab362816fb78942576378244ef75b8870c567d58655dc02bd02663e5065bc86a,52267023456
20180703,"PAYMENT RECEIVED",1254139566,0,e725d9f7b31985855564b4b1e5481325b2e2bcbe2a87708b43351c356ecd1f8a,50981072203
20180703,"PAYMENT RECEIVED",1264229627,0,07dbfa5e00d1e373d1d8c2668db2e1e6e453c1c0defe32c110525825f28b59c5,49726932637
20180703,"PAYMENT RECEIVED",1286504757,0,69fbd0c84859c16c5a6dc38ed5cdad600acc04551c6d6605de68a1c575eeb8f2,48462703010
20180703,"PAYMENT RECEIVED",1299577905,0,b979914eb6ba2d1ae174f3f930d181df55d6de9ad9fcc336dd7f54450892ce22,47176198253
20180703,"PAYMENT RECEIVED",1257905038,0,a54beb7470b41e49b82902cd1cb6c98a735ad1c8ef6c8a28af11053d46936861,45876620348
20180703,"PAYMENT RECEIVED",1328373409,0,7ad67bce9caaff8685e5e8ad76400e48b844b18152562f36678493cfcbd49c03,44618715310
20180703,"PAYMENT RECEIVED",1300007611,0,f9324f93d0840bc7757c2130fd8fb0954a44d9f9a60bce09d51ae6b962d3c2be,43290341901
20180703,"PAYMENT RECEIVED",1269017934,0,d53f785c3a7e123692e30745ff2b951bf966ce8095fb6366050f6b84c217e5b1,41990334290
20180703,"PAYMENT RECEIVED",1327704106,0,c01a3a172cf8da3aae2fadf4e3725e932916d44e910a35863480f7003d216b77,40721316356
20180703,"PAYMENT RECEIVED",1262567930,0,96d4d3246b65015ca9dd0d3f73a499314e99b8d1dc5b384ffe4abcb050eece67,39393612250
20180703,"PAYMENT RECEIVED",1258985019,0,e436cfa9cb65b12ac1f8177b2552ab7bf50b19ebffec95317d45d79c1e810044,38131044320
20180703,"PAYMENT RECEIVED",1298617592,0,61404d52c9a9a80e022b6be0a5f13fcd99476832e7d2bcc19a52aaae0069d739,36872059301
20180703,"PAYMENT RECEIVED",1255815712,0,f9edaf8ebebd46367153a79119b35dd3ea67ab546bf0d0a8f9b03c4006b7c7a2,35573441709
20180703,"PAYMENT RECEIVED",1280205683,0,ce657e459ce4f081877fd95c0c83534b8c65b3f2cc09f091b46ddf489ce982bd,34317625997
20180702,"PAYMENT RECEIVED",1280794572,0,8f0bb2df34d8f3ee44a552d223ae927dac16f31b41a441d8e9823a5adafef37b,33037420314
20180702,"PAYMENT RECEIVED",1271680363,0,9036bafc6d464512dd6717b697e6cf3db4b7559d07417c34f9a63f8abfd09232,31756625742
20180702,"PAYMENT RECEIVED",1265472496,0,f10f4811f1f53dfbe0c6645d2b56a201a0da7b64187ddf1f034e570cca0de373,30484945379
20180702,"PAYMENT RECEIVED",1262126516,0,e9e7b4440728a6eba9870b3cb8249a4c52f16af984dc3a3ef6a1fa8e335264ca,29219472883
20180702,"PAYMENT RECEIVED",1275850845,0,b7759306ba6120efeb68ecc0f040dd8f8034d880e1768022749935e35c8c2b23,27957346367
20180702,"PAYMENT RECEIVED",1273611635,0,91802ed9cc876ab49493dae144ff9bc5d69fc378c50b436b0dc40d03871815cb,26681495522
20180702,"PAYMENT RECEIVED",1270649971,0,1f18775d88b4639a36f94830dfe1829f6b1a5a833e9c655b03649f95f4a51477,25407883887
20180702,"PAYMENT RECEIVED",1276484250,0,255bd8c8757ef69d3007471e3385ebf7953fe0eb57f7a73283f5da808d1fa4a6,24137233916
20180702,"PAYMENT RECEIVED",1332965435,0,a520a544af582e05bfbc141a9b20ed73c0a56b0d64a0924281e198187732d95b,22860749666
20180702,"PAYMENT RECEIVED",1298609786,0,a3b2849abf7fbcd6277bb72a09dc7241e664dc66d6581670f414e9031e426774,21527784231
20180702,"PAYMENT RECEIVED",1260038323,0,c5205a63f196c4ad13672fdaec1cdb8af186f17f27a33bbdb514cd8165b1dc4b,20229174445
20180702,"PAYMENT RECEIVED",1284390632,0,9bbf47bc31c957dec20a54752fd054a39df2d6480f63b839ed4519ba19b71526,18969136122
20180702,"PAYMENT RECEIVED",1271821724,0,eba5f6eb07fa1279ec95f3b9cbd82482574eaeb2d4f550966d040a84a0662158,17684745490
20180702,"PAYMENT SENT",0,-69559501492,dc85f236f0af4b0c7b09bcfc0046e499be61791fc2860b60ad069cedf5099858,16412923766
20180702,"PAYMENT RECEIVED",1252372588,0,980d1e2d90b0283ab88d15ad9e264db2c776f7dbbedbd80be9516765ac522ef6,85972425258
20180702,"PAYMENT RECEIVED",1285247134,0,a228ba7c4caa25ac7c5c13cb635dec21fb7395234b06263d3a5fc64f0821d4ce,84720052670
20180702,"PAYMENT RECEIVED",1270930722,0,7ec2562ef8c779ea84ce46f12ebc067fdc98b5fec02f9ba4d0dc2979456157b7,83434805536
20180702,"PAYMENT RECEIVED",1252494098,0,2222695b50acc25622fe209cde2e32a5978fb841bc77e845bb8e5a88dc571f8b,82163874814
20180702,"PAYMENT RECEIVED",1275997938,0,34107426b93d6cdeefea73f4c001369b14de212a04ba9c777047e9560a06f289,80911380716
20180702,"PAYMENT RECEIVED",1255236159,0,8f2bfee2ef4a6e9cc5b68f18a53f01cf87bc3e41bf75316975dd727ec5fe6ed2,79635382778
20180701,"PAYMENT RECEIVED",1259604057,0,77fb38f63f6548e499891706324fd42dca5a64ac4e1b0badcaf042b45d0e1e7c,78380146619
20180701,"PAYMENT RECEIVED",1254342669,0,d69f992e36a8b33a3f0500a8ccd1170a9f964d53e961c3964ad87ea4b04ff5a9,77120542562
20180701,"PAYMENT RECEIVED",1256597841,0,fd78a6faefd673a0537df45053bf045e92d3dabc5b32cea28f09007e6a67310a,75866199893
20180701,"PAYMENT RECEIVED",1256010887,0,8cf133f9a72b4583d046d64bd9b113194615fd8a9b5d15f835679f67e5ccb622,74609602052
20180701,"PAYMENT RECEIVED",1263371629,0,2eccc305ced876c90083414e917a84f1674ec5cd45b01a1e453c5a1c30c0e47f,73353591165
20180701,"PAYMENT RECEIVED",1258198434,0,368f889071d5e9d71a97701da8a62941a1a9b9ac867e654743e062eb650778e2,72090219536
20180701,"PAYMENT RECEIVED",1272519610,0,fd4c3c2375f4cc75378037f17de1fe76d4aedfcc4beae509aee205f990c001f7,70832021102
20180701,"PAYMENT RECEIVED",1253368078,0,dff89978e9ac992fb4c74bec732982beb495ea62a152f5f4c4133c42169add31,69559501492
20180701,"PAYMENT RECEIVED",1270506172,0,0c28c78da4cc3c76181d98fe7fbd71b705cefd6e5c5721c24e46736b040ea842,68306133414
20180701,"PAYMENT RECEIVED",1252278054,0,245494630d9722be1ccd1726f316ceb125b5edeaa08519f9a7a3bf6b0ba56c10,67035627242
20180701,"PAYMENT RECEIVED",1286211500,0,0d9ee779e5f5d1c1c6f8cffee10531ba2b86ba7f894fb8ff563c384f3cbc4023,65783349188
20180701,"PAYMENT RECEIVED",1284848786,0,805dc9272d6e774545d906b5a9dd5320ccd8645ec233bcf68a7011fb011ea6c2,64497137688
20180701,"PAYMENT RECEIVED",1278758068,0,cc1197f0108ead86970c831bb7d7037a8c3480f64900a853973bf7ea93ba0154,63212288902
20180701,"PAYMENT RECEIVED",1252002984,0,7664abfc8ce3d3716dca939d177b80c98b493c225a845ab42f3eb715b50858ad,61933530834
20180701,"PAYMENT RECEIVED",1255023914,0,0c0472058a2225569b202bbea45cfe45ea0dcd909e431cb124fbdfb74bfab317,60681527850
20180701,"PAYMENT RECEIVED",1251480161,0,10aa1dce1b4f707e070458f3ae59ae1d83b61c8791e52e2564edf1d189008bec,59426503936
20180701,"PAYMENT RECEIVED",1250193871,0,3181ee09d5696c55f021a7bb167464dbea8b15b3b5b791ff318f0658a701ba21,58175023775
20180701,"PAYMENT RECEIVED",1264609714,0,72d05f108b2d041a27696169ee596c74622774dbef85d9fc912573cd40276c3d,56924829904
20180701,"PAYMENT RECEIVED",1251476505,0,7aa0a3bbd58c0e9ca22846e229b7a03ede8a0eda8323fedf922e39f67da5bd23,55660220190
20180701,"PAYMENT RECEIVED",1251676645,0,14b3223e00780907f6ee1d5d66ff78e10044e8d993a00ac1e5cd7bb23a99d882,54408743685
20180701,"PAYMENT RECEIVED",1265487943,0,4fb0a72056acfaf498497c8e27b875ca39e2a7f3300a08591eb7a887dc6a4cb5,53157067040
20180701,"PAYMENT RECEIVED",1251762494,0,d99d10f8d77e153051d74b5df6763d31460653ebf18d194c0f052b65073ea3e3,51891579097
20180630,"PAYMENT RECEIVED",1250668522,0,2e515bc3f8e28b91a68a0590cdcf2e16f11f3c6a7bfcff9f2a6ba3ff0121b268,50639816603
20180630,"PAYMENT RECEIVED",1262097702,0,b8542746c663dec4e9810445cc29638215e457facfa67db13531cc0126f1e362,49389148081
20180630,"PAYMENT RECEIVED",1251815310,0,2bdb24efeb15531a49bf8766e077c92950e6a7e2fb0af5f916f7de58391b77c5,48127050379
20180630,"PAYMENT RECEIVED",1250598905,0,4bb67967113b9a3894c0096689aedf26ae29fff393c1d38f9ce1bbfc5d8513ab,46875235069
20180630,"PAYMENT RECEIVED",1261913958,0,e70a533af1a1496e18fa6cc43b2f185bfc00aa362984e63e37cb3b9cc0068384,45624636164
20180630,"PAYMENT RECEIVED",1268335075,0,d954ce4dfc691b771c80ad067eb70c65692036286236fb1baaf707fbe9c1ef09,44362722206
20180630,"PAYMENT RECEIVED",1272649019,0,187ff416b2d9e02588133b288426672a771f664b127e4f44d7c372fe68408d8d,43094387131
20180630,"PAYMENT RECEIVED",1301926638,0,aad33bcfa295f006c9b83597b250655eddb97ca042ee0a44f9e0b7b1dd5ce410,41821738112
20180630,"PAYMENT RECEIVED",1252294672,0,9f4a0a1ca1bcceeb7bbede6df938a0bcde0b289a0d32289e0f7b66a76fdfd971,40519811474
20180630,"PAYMENT RECEIVED",1257724049,0,e22276120e6a2f29f967e490bac0f822b4fd7d02aa6ddb6836e2fa800efd338f,39267516802
20180630,"PAYMENT RECEIVED",1256418610,0,35b2ad113dc56a4645d98f92b0ce8361c0481eda5f32430e9434485efb377a2a,38009792753
20180630,"PAYMENT RECEIVED",1291368551,0,e7d5ecdc8354547e79113085dc14575fe3af3470d91007f347d53bbf1a3a68b5,36753374143
20180630,"PAYMENT RECEIVED",1252455878,0,ec4cebc5494099c13d9b340a8a47b1802a7207a68bf76cdeb999e19debb985eb,35462005592
20180630,"PAYMENT RECEIVED",1258825190,0,1e828ba7c6d0d00b85f0ae97f32435acc3cdeeb314ba57752da2b9673371370e,34209549714
20180630,"PAYMENT SENT",0,-79718661649,93e72fbc1b6cbae4112f663b7172c5e29ea250e8a1f702e7b94a99e197f482f2,32950724524
20180630,"PAYMENT RECEIVED",1257175999,0,9e4c3bb5ee0a41615de35751b540f51118cc4be1d78d289522d18beaa4f61daf,112669386173
20180630,"PAYMENT RECEIVED",1274745583,0,f12d829ca7208640ead0b57fd50b252ea57927838c53da7a3781f7e6839a8be3,111412210174
20180630,"PAYMENT RECEIVED",1282247620,0,4d6f4659ba567a0e9c2497c0e2b1e83597541b8b51189354de19cd162f29f2ba,110137464591
20180630,"PAYMENT RECEIVED",1267625066,0,4a2a2683489cac0146968b6c3034392534a96e6c95893ca45405f07efa4cb4ce,108855216971
20180629,"PAYMENT RECEIVED",1263992135,0,276648fb7eae687f5874cce5d12572222396fdb426a688301661d05fc5be013d,107587591905
20180629,"PAYMENT RECEIVED",1256539262,0,3b837d53cb14a7562b3919cd8aa3b73dc78f940d40b24c56474d1ea864e88880,106323599770
20180629,"PAYMENT RECEIVED",1255107933,0,6aa6d4392a549bc29d75ca7f4f99798bcfd386926a6a6e9bf8f2e113779a7025,105067060508
20180629,"PAYMENT RECEIVED",1296375176,0,7208da59d0d53b7aee421398038026a11b9cf0adcd008cf6ca2fa1b59fe1f867,103811952575
20180629,"PAYMENT RECEIVED",1277018672,0,a61688073a5480374f6106983f9989eaa894f20806a0dfed1c6f0169d5dbd0e5,102515577399
20180629,"PAYMENT RECEIVED",1255316314,0,883ae08950c3c249ecd9c71b1ca1a04c237757684afeade5da796739de1308ea,101238558727
20180629,"PAYMENT RECEIVED",1259360697,0,b825e98c01f05a06e36ad6eb2966780a23dfa9e1fe7f0a13bb2017e8f24d1cff,99983242413
20180629,"PAYMENT RECEIVED",1293829274,0,01ec64130214b34f36ed03a7902bd3e945c1c1290579424a5714fd0fd98ac87e,98723881716
20180629,"PAYMENT RECEIVED",1259080738,0,907e763ea7bfe09c7c311f91a0e554d6cd99354c0fd142fb0ca412c160c927d8,97430052442
20180629,"PAYMENT RECEIVED",1300030570,0,3b7f0f3816c687ceb0aedd263a66ee1c23ca646534b86c9041cd445a649d948e,96170971704
20180629,"PAYMENT RECEIVED",1288988454,0,6c395f08f1602a8dc8097e16e158fda32bda4ab42bbcfb3837ebd745dfe061f8,94870941134
20180629,"PAYMENT RECEIVED",1268755335,0,0d369a11ba61efdbdc09f8510c44c26a129fcc4f7e79bf33680388b1b2397fb9,93581952680
20180629,"PAYMENT RECEIVED",1261666560,0,0a3c071c4097221b92b06e3721430c70baacb673bd688ba8885aec0d41d5d50e,92313197345
20180629,"PAYMENT RECEIVED",1272906736,0,67fc639b286bb5caf5acf559a5f3e4b7f092199c014ecaec111fdd4202e03abf,91051530785
20180629,"PAYMENT RECEIVED",1281855765,0,262c91b2b6568ce58178796475b8b5377045ec252375f773d04b0887a6e1afd2,89778624049
20180629,"PAYMENT RECEIVED",1257311259,0,76d07661744426f57ea1060d4d4e0754847ca539dfe022bbe23d261e95e7efca,88496768284
20180629,"PAYMENT RECEIVED",1285210333,0,3790d4251be16683e06728bf0e03995f8aba9edd80dd38d8723bca666eb04428,87239457025
20180629,"PAYMENT RECEIVED",1261002541,0,fe5b0e6a796653a9c800bfee4566e0500b6d34da58ca069fc726a07e7f06233b,85954246692
20180629,"PAYMENT RECEIVED",1259920352,0,96806d9905d0b1bb724ec955e92042266992a24de9def2bf75b1ba3de3c4bfa1,84693244151
20180629,"PAYMENT RECEIVED",1250000000,0,a3a1d723490b3ff99d5a1764d4fa315e9e686196aac874093a63ed7a7ee1156b,83433323799
20180629,"PAYMENT RECEIVED",1253766251,0,7af52e7f4caf612a29a341c1ed4b57c0597662b0743e2e9c399b46aa94dc590a,82183323799
20180629,"PAYMENT RECEIVED",1254051401,0,c49581bc4f044cf00c486e0d213764b9521e3438bc9f381cb0da9f750e483126,80929557548
20180629,"PAYMENT RECEIVED",1266515759,0,337ed8f1a7974db7eec13b009434077458793473eec307bf0d3da063d4064355,79675506147
20180629,"PAYMENT RECEIVED",1262409831,0,26898e1e4044d5f46bfd008796acdf31f2b4d8daf288062630d26742864d5f52,78408990388
20180629,"PAYMENT RECEIVED",1252373522,0,0596a98c30502c0a3c1f62fe18aba45654fd375b83a1036d728abf876a3fa375,77146580557
20180629,"PAYMENT RECEIVED",1253944451,0,eacc1bdc2e9118ee33678805f65c0e740a85692cc0e10003081e94060af26976,75894207035
20180629,"PAYMENT RECEIVED",1250379818,0,93880dfbddc0a711eeef53a258258a374c4b65b3792252c6708e1e177336c2a9,74640262584
20180628,"PAYMENT RECEIVED",1275002656,0,0fb39b735037abcc56120b5c7657e25cd69b9fcfd3f404dd0ca739843875171f,73389882766
20180628,"PAYMENT RECEIVED",1254163048,0,bf243ff66d799294c0951b3bad036c6e0ea616074970abadb9d35ea497659256,72114880110
20180628,"PAYMENT RECEIVED",1260334155,0,edb0057ef4320926458255e26409fc6ca870b53ef7397a10a3c6fa343f07a6ab,70860717062
20180628,"PAYMENT RECEIVED",1259314390,0,c7c2e2d43aa02df8db89c906b68cd6d571af61fbb9b15fb9075d2d3eb14c8228,69600382907
20180628,"PAYMENT RECEIVED",1292699902,0,eaee9fcf3706833b39f9ac7b23e93ce467763304955004ad1345aeb468d8b4f0,68341068517
20180628,"PAYMENT RECEIVED",1261296515,0,a44db2c6579b3f571055b643714be5831832ff7da61b5682cbad907ec5174ce1,67048368615
20180628,"PAYMENT RECEIVED",1255634492,0,a46be1b6e6fceed264a96f343603c4354320cfc1391290120895de1dabb32834,65787072100
20180628,"PAYMENT RECEIVED",1259393465,0,16e545a2fffc8299df902402d14dae108c90adf66d64636888e79a953dfa0e77,64531437608
20180628,"PAYMENT RECEIVED",1271931104,0,64a2a1eded332c6ff3df0dc39a30bf49701209155d66dd33dea28b9c3557aa93,63272044143
20180628,"PAYMENT RECEIVED",1316989096,0,53fa9d7e23cc6e299495200d7053aa888d0603bdf348d920f4d0343e85c1e542,62000113039
20180628,"PAYMENT RECEIVED",1250971498,0,b446c5e992bdbe618647ea5eda014ea1d8acc04a836a948c14186fb8913e4f9d,60683123943
20180628,"PAYMENT RECEIVED",1250142738,0,636941892b83b81c61545f0bce1a8bf5853292a61ff81d9f74b60fe3a5e44fe0,59432152445
20180628,"PAYMENT RECEIVED",1252035450,0,89c67b7e040fb67954a166b222a1b1383db82cd338d6a8036c8d3ee21bbdc1f4,58182009707
20180628,"PAYMENT RECEIVED",1269148537,0,fd00b14d43f8e5e110c43278bc6c3c82d428ba0d9ba7c6a68db32c2b2b20adb1,56929974257
20180628,"PAYMENT RECEIVED",1291749310,0,845f6da6b11e0b131109c691042f27fc7b56e514bc8e3802863696e61d8e1cef,55660825720
20180628,"PAYMENT RECEIVED",1277513616,0,dfdd909f5f78de14dcc9012d198cd26a42c85930b7d662d9aa4379a6c0c441e0,54369076410
20180628,"PAYMENT RECEIVED",1264133997,0,5e2897e72ca6309f921510fc6791c400dafd56f6de433a3e3ce6c13df0684a1b,53091562794
20180628,"PAYMENT RECEIVED",1279317641,0,cace77f64f900067d497420edc93bec02084f32d53c3d3ac6f0b47718238f970,51827428797
20180628,"PAYMENT RECEIVED",1256246770,0,35557b7f993167637bc22ac52cac678f50f6e5c8db5dc4a63a563354e29938b0,50548111156
20180628,"PAYMENT RECEIVED",1265878806,0,bf93aa0c76fb1ae6ff65009760a6e8e3ef8b83c73b19cfafdc79ed1fcec72369,49291864386
20180628,"PAYMENT RECEIVED",1254191869,0,92911a3d74ce7e51068417c11b3440b2a746b1d573706dd0f55661200039f338,48025985580
20180628,"PAYMENT RECEIVED",1258808637,0,e5ae2274707e4762e447a417d235e1635cf0b9d91e7ea632b48bfc681fbf37da,46771793711
20180628,"PAYMENT RECEIVED",1258007129,0,ce057d06c1d1305933fe49739a8ad19348dbbf347313c33d706fb002ce83d3cf,45512985074
20180628,"PAYMENT RECEIVED",1250693762,0,7ff0d440410b3fcbf56ad8959e7c1ccbec1d04b3003af5a126c7fa2c2f5b68cd,44254977945
20180628,"PAYMENT RECEIVED",1250000000,0,247a5919b055ab64928dabf3c1a8ba18d25dc35826d00c843d8e8a75033d03f9,43004284183
20180628,"PAYMENT RECEIVED",1261009718,0,0e061ab5a262a85e442cfe44c5899b4e1ade3a07a698031c551913c827654414,41754284183
20180628,"PAYMENT RECEIVED",1287033461,0,d2fef587ac03678f3a2e244e9172f0e74b50e4f0a7f14810b52c6821238b6bcd,40493274465
20180627,"PAYMENT RECEIVED",1254620044,0,f0cb678bf8a257df4caa4a9325a1b7516b75c54a1a7bae1eb5b16383745927c2,39206241004
20180627,"PAYMENT RECEIVED",1263182196,0,3fd09c01077aaaceae0c6c74fa13a481a7b60b6c9a8cb4958c3dc27a66d46af2,37951620960
20180627,"PAYMENT RECEIVED",1276285933,0,aa7b782eb1dd032561d8719d045ea71c3c9ee6a424a3e3c7295f9a213dae670c,36688438764
20180627,"PAYMENT RECEIVED",1286301729,0,0c72bdb9c39e0686eb6cb3fa352daf36c839b67d60c01718b744f0f46eb9c962,35412152831
20180627,"PAYMENT RECEIVED",1279760811,0,d5d4360f501d288fe6dc848db5e3dc6b0b89b8140236dddfe126153c41f6e46f,34125851102
20180627,"PAYMENT RECEIVED",1261443714,0,e08ff1139d8c837e602c1a9ec79e942767aa265d375b91b0f435ae0928ab2e39,32846090291
20180627,"PAYMENT RECEIVED",1277613692,0,7e6cf1112a296fe20bb0420b613ebc561188599d7326ef8b8b695966aa6846fb,31584646577
20180627,"PAYMENT RECEIVED",1280746260,0,fc858d1d7c22e1bd0ca38053f7a2ba88675534a7ac546c680e994a247f0812ba,30307032885
20180627,"PAYMENT SENT",0,-78549172139,87f69bf8873ed769b424690f42e1c38055b725d9ddf65d270652ccfdd9185e25,29026286625
20180627,"PAYMENT RECEIVED",1278855812,0,e296d75daab282ece66dbad38f3f93b991a27666e4f157019e4dfcca0348737c,107575458764
20180627,"PAYMENT RECEIVED",1252116022,0,2da4a77db0b126d0d610b41c2f8dec14c2015032737c748f7a91633f56b50689,106296602952
20180627,"PAYMENT RECEIVED",1256051610,0,d497d88883ee8e2e94ad771cb437d64fa41a968b992136bc7342e85b01476159,105044486930
20180627,"PAYMENT RECEIVED",1273808216,0,69b51030ab508b937a5c2329762820f6a05795f05a43af81325a7f349677bdab,103788435320
20180627,"PAYMENT RECEIVED",1263267419,0,a2ac7ab45b8696dff80a5dd20ab303d08f93964e351603542b63662d112b1214,102514627104
20180627,"PAYMENT RECEIVED",1263094106,0,cdf7cf5a27edf8cdd82ec8df4cf725940292e57385de3957049e75403c77603c,101251359685
20180627,"PAYMENT RECEIVED",1256740667,0,44d7c1c0e2a286fdb9f3af58111aabc53037d7f48967f1dc280ea98dd1b43a0c,99988265579
20180627,"PAYMENT RECEIVED",1261398233,0,e90a5aea853e016b6c4704d66e5b3f3c3cb9134c173c959fcb0ee00d7afb1260,98731524912
20180627,"PAYMENT RECEIVED",1278170012,0,a21b84b9543dfa4d0da4e1af52e2c6f63139acd369758c43489dc9f3f13c11fb,97470126679
20180626,"PAYMENT RECEIVED",1264188221,0,afdb82721dfba14866137bcb7f3fb086d52d41912bd6dd535eff2e8dfb3b75be,96191956667
20180626,"PAYMENT RECEIVED",1266068903,0,a60f56c474855cd64b2491fb4060cd5602ba1e4587c77d76534896da866c32e7,94927768446
20180626,"PAYMENT RECEIVED",1277323383,0,b8822d0fe8c532a63d86f35f31ba6735f8ba3a26b6e4428636eeca68aad07b50,93661699543
20180626,"PAYMENT RECEIVED",1263336470,0,81c4593d0ff50693e67b79d214d865bee788a91d2a8ac6ea2fc6e2f2ac6257b7,92384376160
20180626,"PAYMENT RECEIVED",1266000728,0,238aca5d40b0130e9966115fd69589f765e373489aa96607712fac88683e4938,91121039690
20180626,"PAYMENT RECEIVED",1251925823,0,872a50bf5dbadf29e69b8c4253b29b15ed47f3ace31ff42d90a692ada5bcfb9f,89855038962
20180626,"PAYMENT RECEIVED",1282270452,0,cf1f808367ecf474d5a658256e43995e0b1d51cc45103fa3be4124f83eae9f2e,88603113139
20180626,"PAYMENT RECEIVED",1285313962,0,cf5209662044f52047e9253402e70180137eebb257abdef780a9b03739ffcc65,87320842687
20180626,"PAYMENT RECEIVED",1253352071,0,003ea4cd6e17d5e81faf8898daacd7e8a8db8c992c0e73c4e8e14f1ab195c039,86035528725
20180626,"PAYMENT RECEIVED",1260489001,0,f8ddf623dd1e79839d687db42592b60976b8276bf6406033f55804028c944ca3,84782176654
20180626,"PAYMENT RECEIVED",1265569981,0,b8ced475c41fe759d30253e221edb9bd226e6d128ed19c1783876e53f9c089fd,83521687653
20180626,"PAYMENT RECEIVED",1256839063,0,82a1882588751acb7e78ba94c8e031fc4f0e0e4fad65f099c93b6150761df3b5,82256117672
20180626,"PAYMENT RECEIVED",1252948117,0,66f958ccd9daea1334e28d2fa681e5e4e1bb0d8790b71609642fd4811708b73e,80999278609
20180626,"PAYMENT RECEIVED",1303165542,0,5e97b7287f63b20f6462888cf8ba8bb24de6ac1a6983995961984810af7a4911,79746330492
20180626,"PAYMENT RECEIVED",1286257857,0,3704500ccc2dbb82a3cfdccc8f818b0320add063ca44bba39513b80a186a0d4b,78443164950
20180625,"PAYMENT RECEIVED",1251443124,0,ccc66fdc0ba1719537d72bb9d49ee654bfc36cc8c3a05ac7e45c95e7badc5cf4,77156907093
20180625,"PAYMENT RECEIVED",1251312391,0,cbd530b3be244adcb158bccb7c66f255e889aaeed1fc5c9919f9cd12fcffdd10,75905463969
20180625,"PAYMENT RECEIVED",1279235390,0,9be9ecc40e19735e0c38890bc179aeaf62cec4a057ed4d5671451e7100831723,74654151578
20180625,"PAYMENT RECEIVED",1255868974,0,7b2c06516bc626cf62c977802240af154fd9945735669df933be336a61eccd7c,73374916188
20180625,"PAYMENT RECEIVED",1252455800,0,a7560515e1ffc21f52431d91d04f35f926dffa5663d76a8b309278d0718f7011,72119047214
20180625,"PAYMENT RECEIVED",1261800106,0,3ee296e2285de2a11fa9ce43211885575a7a83a96e1d40838a485cce83069f97,70866591414
20180625,"PAYMENT RECEIVED",1270511454,0,f4d789a98799097fef36076b86ec6da5adaa69a95ac19ee986352f44b4642258,69604791308
20180625,"PAYMENT RECEIVED",1250000000,0,186ab9b646c80a6bfd23e922c3dd1bb23f39be86a6b13c49e4ae249f075bb50b,68334279854
20180625,"PAYMENT RECEIVED",1298465214,0,be4d59a129631e3697fe4a6ca0b9b45aa127e107693b7a20e112f88677cf24fe,67084279854
20180625,"PAYMENT RECEIVED",1332930909,0,23fe2c149448c04cec4ae45ea68b2fdb073f10df0104a87cdd86ccc145a61e52,65785814640
20180625,"PAYMENT RECEIVED",1317825855,0,8b405d3b5c11a6ca137e14388d83acaa117fbcead1f05171ab9f8ec35e521228,64452883731
20180625,"PAYMENT RECEIVED",1263198016,0,0389042a15cdd0153b57161757ee14b7280a400b8e3e8b9ee10327c3970944b6,63135057876
20180625,"PAYMENT RECEIVED",1286604108,0,31cdde98d16013dc1c38f247c6edf564d45559b56983b96f8b7d326c4a22394d,61871859860
20180625,"PAYMENT RECEIVED",1260052002,0,a700b5fe8081da80050418de1337f781f91d0a4c0070edad40f7bbf0eb1084ad,60585255752
20180625,"PAYMENT RECEIVED",1265651147,0,a63c0c14de2f42e9faa6b5052a0439761f25ca4137abbc291c4bbeace29232d8,59325203750
20180625,"PAYMENT RECEIVED",1253192071,0,512631ca53b684c56ebf54df22ce30eeb97756d7ef56855db59d4ed2d2dccf8f,58059552603
20180625,"PAYMENT RECEIVED",1285949516,0,ab35e8b2ec8e10ba892ae50f378e9d3353599c5860bba112e547c1104f087c68,56806360532
20180625,"PAYMENT RECEIVED",1271796893,0,c4f8fcd3fbc981ad77f6400588431542f443a8459af125dc731af58bba28eece,55520411016
20180625,"PAYMENT RECEIVED",1265327849,0,ecce514321f1c9dc8ae53bb64ecef8ccec246bc1e1f9d4b642954d54b4ec1b03,54248614123
20180625,"PAYMENT RECEIVED",1254434147,0,6fca6007836ef57c8f2673f55b39906e63940060be0822f0164ab89384e77161,52983286274
20180625,"PAYMENT RECEIVED",1255346659,0,4196ae1b724475330db8050a5311cad928a1bf23334201909e441d0274e10b4e,51728852127
20180625,"PAYMENT RECEIVED",1252630611,0,8dd1379174e262d12a32d217e87a7caf09fa1b9e48a6fe010cac219f18c6de58,50473505468
20180625,"PAYMENT RECEIVED",1254165217,0,d89c1b402c32b982a2f5b98ce60d8afca76453b635d40a9fc1d398d517b85565,49220874857
20180625,"PAYMENT RECEIVED",1277261809,0,cb60abb3c5a69162e073e03b463dd3a2ad9935865985f61eada9e2856fd78dff,47966709640
20180625,"PAYMENT RECEIVED",1260943781,0,df2dc60ff7db7db8a616221f9eeade17a7aaa513032ef3ab0eade8edeec6aeb6,46689447831
20180625,"PAYMENT RECEIVED",1250297896,0,701130dcf767c48dac36e7cc69e9acd3e82c63506bd2eda2963e6485be7f3018,45428504050
20180625,"PAYMENT RECEIVED",1250000000,0,725823b1041d4bf6aaf812a5c6a44c0ea3771edf89f9a26803098ee4cf59ad52,44178206154
20180625,"PAYMENT RECEIVED",1254094534,0,4d13407f334c978624d8710a9ba853a8231a272533d5c75da2de60613dacd52e,42928206154
20180625,"PAYMENT RECEIVED",1261426492,0,20a4294f800ea0cda1e1330fb83f887ecabde6aa47c1577518775739b742deb1,41674111620
20180625,"PAYMENT RECEIVED",1256913289,0,d1c4441d74f8e8d97fc1be6364d69c5870907e7b171f79da2a5b09ecca20cc11,40412685128
20180625,"PAYMENT RECEIVED",1253923567,0,c8f002ce5db0c0763e14579804785c545786cce46300d2498b4ec48140e0ef5d,39155771839
20180625,"PAYMENT RECEIVED",1262764966,0,600b37ef5e9eb34279159e83f80a03d5737a44b43bf85e81fb3642bf4baa9812,37901848272
20180624,"PAYMENT RECEIVED",1259101636,0,3af56397e000aecec5c8e7259d041afa05a1878afd5474d9def607c58e98281a,36639083306
20180624,"PAYMENT RECEIVED",1250442526,0,464b748bc0c0041d2cd18c03c9de111001b31b32664d167133c93c35cdb4de7b,35379981670
20180624,"PAYMENT RECEIVED",1251265408,0,3447ce4460cf5fb7d5637627215bed43f3fd130070e7ba243e90bfa214b9c0e0,34129539144
20180624,"PAYMENT RECEIVED",1284038488,0,3b312dbe4ea74607a134e5a4f76543b692bbfb1b7478663b66972a3ec397b32f,32878273736
20180624,"PAYMENT RECEIVED",1258497974,0,097977391a171219692bba319639e5ac1405f44b68f7c4e0edb723079bdf2db7,31594235248
20180624,"PAYMENT RECEIVED",1263434849,0,a0d7f202650a9751af9a967a05b7a24424ec4401b6b0031e3874c092f11e7359,30335737274
20180624,"PAYMENT RECEIVED",1252780584,0,8b3e8bd62a3eaa4009df69a4de09b27651dd98857628079adef5c83a4bc26b56,29072302425
20180624,"PAYMENT RECEIVED",1297465634,0,33bffaad5aa6bdcc71c74f4ec9ea081fe116b4ec2c3285ecfec7ee5d52e9f672,27819521841
20180624,"PAYMENT RECEIVED",1250000000,0,634e4571f075b6eddcd444ed774627884a5f3c8e7f18a9facae4345d95a62a2d,26522056207
20180624,"PAYMENT RECEIVED",1259056274,0,9617dd335e7271516261d57f20653b2df63a63744fd99ee7d3d8dbd024028b7a,25272056207
20180624,"PAYMENT RECEIVED",1271176189,0,a919eeeda19d1f148b7b7561255b7b5052db1bff3a9cf85adc62423aba68ab5d,24012999933
20180624,"PAYMENT RECEIVED",1252081996,0,a2f110ae0fbdc1eb0489d9bbb6abc789f6d009de6c5aff1340c338de333855f6,22741823744
20180624,"PAYMENT RECEIVED",1253880647,0,8c83f2fd0271d347e8087eb2a246f5d43c60a2202fa8edd0c3a26791e2db464f,21489741748
20180624,"PAYMENT RECEIVED",1275136904,0,fc5f6c33b682edd28543bf768dd9a420f38138fe56106df9c7716ecd1dce293a,20235861101
20180624,"PAYMENT RECEIVED",1262062588,0,fc84bc7b6da9491d2abba0d5773e11080ff8464932304481ba8aa0cf8928afcc,18960724197
20180624,"PAYMENT SENT",0,-63101107897,ef214405a8772f5618454d08050504e77ba7f2bf93739e024b8cf10f574d4d2c,17698661609
20180624,"PAYMENT RECEIVED",1293668561,0,32aa5087bb4c03d94d9313a630fa2eec6f80bab7a1ab80516dcff86d733fa805,80799769506
20180624,"PAYMENT RECEIVED",1255644173,0,754bb71bcf68bfcb5583d0bbd9d9c001b6b8a5d228016d90d36fc6234cde8865,79506100945
20180624,"PAYMENT RECEIVED",1263844627,0,5db14bbcd4edc9281832b1e4b1680250984b64e2c2bb4723cec3f465c917a6ac,78250456772
20180624,"PAYMENT RECEIVED",1261421513,0,596b270d8a442e3270c1e83a35eb8b6d9a0120bad895626d3d609ecc960d9694,76986612145
20180624,"PAYMENT RECEIVED",1252430110,0,a7dc28d42362cc69fed994fffb4e3e7117a0c91f18e65fbc10dcc597bbd01446,75725190632
20180624,"PAYMENT RECEIVED",1255436990,0,621a95946bce1bb31ab27bd9404d8b40f467cd0de016581296de5c5be71dcf6c,74472760522
20180624,"PAYMENT RECEIVED",1250492445,0,fdcca6dcd47e47e70e3c4a348a17aa81c037d6cc32454b42d0dbdfe26ff2a1f0,73217323532
20180624,"PAYMENT RECEIVED",1290019166,0,4068fdecb5f9e6bd3263d0c8cd4582ac29308397b7afed09b290b4e9272422f3,71966831087
20180623,"PAYMENT RECEIVED",1270355973,0,5e76fd49f62eef34fc732f020ba3671d266381a4c6f0ae3727a0056d72eb431d,70676811921
20180623,"PAYMENT RECEIVED",1250925098,0,69b33d732e7edf5f93a748600c75bfc8fd070442e8d62ad4bbb4fbee14f5f99b,69406455948
20180623,"PAYMENT RECEIVED",1270618655,0,5e0e569d6bbcd955ba75da9568dc3f31d8ae6180fdcd331213e8f994fd96306e,68155530850
20180623,"PAYMENT RECEIVED",1278118332,0,9d79c77bb4b715e7195489ffe5dc938919043e5ef3537fb0526832dbf1c0041a,66884912195
20180623,"PAYMENT RECEIVED",1251121736,0,e356e2cdcec3042816b867e54207c8d45f1ecdcfff8e21bd4edd6d659a00dad4,65606793863
20180623,"PAYMENT RECEIVED",1254564230,0,1a868a1897592ddd692ad93d1b95ea7a307edad975b20354ef3ee41c539b4617,64355672127
20180623,"PAYMENT RECEIVED",1289956213,0,da02e103ae09da470d36928a19e8ec91732f0965faf7b1b551f315cdc391d871,63101107897
20180623,"PAYMENT RECEIVED",1257961127,0,c3394106cc29a3f696914bc31e668feebe3f0cba743c12c88dea3d39ed4278c7,61811151684
20180623,"PAYMENT RECEIVED",1266844730,0,a8cb3492728bac33a7e4452f5ff9aa1668c909722c072581e445389c76eba348,60553190557
20180623,"PAYMENT RECEIVED",1255412008,0,ad986ef92d445198f1645eeeac420bee9eba9b41398263d50cf47f0e55fda757,59286345827
20180623,"PAYMENT RECEIVED",1276791073,0,1a2a3fdb5a9cc3a2ead2556d3472175f1b616ef285f8dc401d116f897b5957ff,58030933819
20180623,"PAYMENT RECEIVED",1282702710,0,d39865bf86fefa7877a9c444de1441cf0e64445cb101537a03bac4c12605b507,56754142746
20180623,"PAYMENT RECEIVED",1305192564,0,86632347568fa5102a54c9d2a940546bd7c6bd7a36c198a09a5c2d9eaf4ace64,55471440036
20180623,"PAYMENT RECEIVED",1295276956,0,caac5c9dc42f1793615af80072ac49b61e9a505addc75f94df06bf291007546c,54166247472
20180623,"PAYMENT RECEIVED",1300856181,0,56c57e2add3fd335b11ec810ae47dbf6efcf0a70d51ef3b7a77be0d7a358d4c0,52870970516
20180623,"PAYMENT RECEIVED",1266737772,0,ca2ac5a3e0d86d075f737a9d9f37e2e9675704757b6958acf3cc9b308e45fce6,51570114335
20180623,"PAYMENT RECEIVED",1253474321,0,ff186a09e0a38a5c3051dd8675b5096939f4b07770059e064a78f03c55d12cda,50303376563
20180623,"PAYMENT RECEIVED",1252139066,0,6d8a2db22060b5fc598eb5ed33f6ab39530df0528d3fc60a399008f23a76f78c,49049902242
20180623,"PAYMENT RECEIVED",1282483335,0,323b09689b9d07cba624710ef6416db85e3818478fb0c492e0510461e0ee4d2d,47797763176
20180623,"PAYMENT RECEIVED",1303462163,0,066d85abcb2d5d2dd6373c295539c3895ea4c53926fe63182759d8876f27aba0,46515279841
20180623,"PAYMENT RECEIVED",1251351709,0,3d82261297c84105efcc1b9e1d827cf49dcff5646135ea56dc2e4e19780064b1,45211817678
20180623,"PAYMENT RECEIVED",1277444366,0,3954951482ac41e3cbd81d324120a55314ee3ef2e6c917bf0a13fb0c32cf6050,43960465969
20180623,"PAYMENT RECEIVED",1322642108,0,45d72f7f058ad411b9532fed0075299626800af6163b69b53af87bc2ffa9b3f9,42683021603
20180623,"PAYMENT RECEIVED",1278891579,0,6709aabbb922f60a1249919668a277573549076aeb71ed684ac30e89249ebf25,41360379495
20180623,"PAYMENT RECEIVED",1278074606,0,d9a18caab46fa1f255ee82cd81238267a5a88dae377e3d715f045cf803a7d66f,40081487916
20180623,"PAYMENT RECEIVED",1250670327,0,ab438ca219327df4f7bff3004de1041af280e4a24288d7b887ca39487e75b720,38803413310
20180623,"PAYMENT RECEIVED",1329756395,0,fe21d37ab9c6633d8abfebbc0daded16c2915deb0b9663500169c4c0e07b57f9,37552742983
20180622,"PAYMENT RECEIVED",1332570625,0,79ad7684bf97cb2b076d270c56273b31ef9eeda3a1a7ff506d76a6db600c1f43,36222986588
20180622,"PAYMENT RECEIVED",1260591570,0,4e8816f2ab7e9d43fdfe145a222d1fbcb71c3d7da3ab5d520d15160f9f068379,34890415963
20180622,"PAYMENT RECEIVED",1261552892,0,387dc67a1bac81a4685ff65e3fbe3e578b603e06f39ab1d085ecddec565a0e43,33629824393
20180622,"PAYMENT RECEIVED",1264506854,0,676d5c17638832b782b2e45a3fac91cdbfe8a5b5a1c4de4fcd732964eb18990f,32368271501
20180622,"PAYMENT SENT",0,-70813405657,5a329b2ebbf63290283681535bf121fca2ad7a7a8a73df4ff80f86001a208536,31103764647
20180622,"PAYMENT RECEIVED",1328667314,0,16a38976577185bcd86ca8cd3a2af2ba9abe3218650c16acea3131d08181f914,101917170304
20180622,"PAYMENT RECEIVED",1264558985,0,4b1648fea2bb96e78eb6bb4d2f9e35305b89a529f9b79a504381a641127350cd,100588502990
20180622,"PAYMENT RECEIVED",1336773557,0,0b9dfdf8c74e36f5a8471e968b911d9be4e0306a8284f44d825cb48d1aff1ba0,99323944005
20180622,"PAYMENT RECEIVED",1267409117,0,e8c733284d8adb86abb4482258cad3b9b3e0957c298af2a9f73c4095b1fa8135,97987170448
20180622,"PAYMENT RECEIVED",1346601468,0,4d214369503559d310326a7d6dca7a9009a8ed0feb2f9db21ebb1cda6eac7809,96719761331
20180622,"PAYMENT RECEIVED",1306852534,0,78e2bc3e15d253cb98c2898b19f2ad14a1b4633226de616c8e922e6f0f9bdba1,95373159863
20180622,"PAYMENT RECEIVED",1308901359,0,a60e64aee5d1fd9105825ee62665ef9e4a8b51dca929ba7be970cd2bfe30f553,94066307329
20180622,"PAYMENT RECEIVED",1397591373,0,4fa690846d60b53ec0d5e51401dbde79ef7e52ee0c9613b63a330cdd02da44b3,92757405970
20180622,"PAYMENT RECEIVED",1350190084,0,a88566654678d76b9c958eccc804de2c04aab4e40e26c92b7cca819e792bdf10,91359814597
20180622,"PAYMENT RECEIVED",1268748624,0,bf0a78db765e84a71dae36d7a59243f0408dc6fdeac4059157740d4ceb318b6a,90009624513
20180622,"PAYMENT RECEIVED",1321215064,0,5088110b7f63b3a823dce09d1e1e5e97fdbdb202806aa51d98591b1a358d39a0,88740875889
20180622,"PAYMENT RECEIVED",1284514568,0,271209b1e17f9bdcfd8a99dd53a2da185090eb240c372c6522d0c20c75a6aed5,87419660825
20180622,"PAYMENT RECEIVED",1271013254,0,fb4213b29b4cc7ae9d1ea80a1fe9dc7e733b2158f58c10b0d3aceabd7a1427e3,86135146257
20180622,"PAYMENT RECEIVED",1287398389,0,cf4831619f6c3beb9dd25f65a4888694382a7d64f770f7879a042ffb2385e863,84864133003
20180622,"PAYMENT RECEIVED",1256970593,0,87a3e6daac28853f2670d28dc4afbf937cc09f913104a1afaa073f1729d80b05,83576734614
20180622,"PAYMENT RECEIVED",1270671971,0,a36e2270353ea11b0f9c6ca562df0fb299676f17eb5b1eccc218a024ff540dc2,82319764021
20180622,"PAYMENT RECEIVED",1260502565,0,01b645cde013dfa1a339c4ba5b613686baeb1ac770d302939ad950ac736c0d9a,81049092050
20180622,"PAYMENT RECEIVED",1307804041,0,9cabf53aa21a0380014dd5689b359a8f129fe0c94d1265a0b1b72688c0d2aa7d,79788589485
20180622,"PAYMENT RECEIVED",1320918451,0,3cf6da80ebbbacb8565e204529b21cc8e4af426f99cd6bca1f521c3a95999e83,78480785444
20180622,"PAYMENT RECEIVED",1252009439,0,db8d9207dc86104bc6a160246cf5f48cbb5c479d3fbd524ce4f1322675b58815,77159866993
20180621,"PAYMENT RECEIVED",1261333466,0,5d854a846743d328286f7f83a7f92b44df63ca757281fa6df4b37f7ab8702483,75907857554
20180621,"PAYMENT RECEIVED",1276002543,0,b630fa0b599b02a741668e530c756d27d727c328ddbd532cfd710e2b3685d41d,74646524088
20180621,"PAYMENT RECEIVED",1288489149,0,4ae6a63ecb209ad13f84060c84da3b5371ed0e3d4638b6254cc505c9f9de505d,73370521545
20180621,"PAYMENT RECEIVED",1325164307,0,a793c3074c2694a2754edb62956439b8daeb7d311a41836fa4e35a60affc37f8,72082032396
20180621,"PAYMENT RECEIVED",1294833139,0,2319ab3f06da9c1440db5df7069a15ae9cc24973c3ca7b41a76ea772fb58002f,70756868089
20180621,"PAYMENT RECEIVED",1300245952,0,1775e1601b3a3b216b768b15bc3fea3cda83bc2bcafd0ad2ef9f8e680570d8f8,69462034950
20180621,"PAYMENT RECEIVED",1324311457,0,0fb1648f6f0ab7545becfbaebb73100c6667580eeefaaddd4fb33994104e2d2d,68161788998
20180621,"PAYMENT RECEIVED",1401842146,0,ed67325eeda6ec12ab395b7c09ca10331f5ff7b3d846d8034d4decd4732c71d4,66837477541
20180621,"PAYMENT RECEIVED",1272112872,0,8641f46b284d45dc589b89892fbda54f62199ecd8c12481b6881b6e91f240cbd,65435635395
20180621,"PAYMENT RECEIVED",1310553418,0,8471bdecab7373237d1f6608bbc9d17b54d617d54c1abd331a09614b05de2778,64163522523
20180621,"PAYMENT RECEIVED",1330748956,0,9c4f8c14871069d26adb35b25eb48a7b6bb8b135a8e934a49f959a4cea71675e,62852969105
20180621,"PAYMENT RECEIVED",1266735810,0,85eb2b62ca3a368a10ca5ef74287f7bee65f859e02d4963e0df125b2bb3a5bf2,61522220149
20180621,"PAYMENT RECEIVED",1318895869,0,2dd6082fd720fead096e0fabcbb0cd25392de6d13cb326ab5079db06cc9a1fae,60255484339
20180621,"PAYMENT RECEIVED",1337587608,0,e20b55dc1efca26b644bc14848245f868563bc582aef29d869867e7114e73de6,58936588470
20180621,"PAYMENT RECEIVED",1256174609,0,b7a8658e02b62f843b8e788b57635ed7d0c6d2bc66f78cd3f2fbb0cae85a0fd2,57599000862
20180621,"PAYMENT RECEIVED",1257455990,0,521103fd819752ea17dd81825cf4d2ca46d460a40830f21a19ae03e8d7a4a2c9,56342826253
20180621,"PAYMENT RECEIVED",1324942135,0,99d28935fe8c86c6306ffff3bae1682b2d4e2927727ef5593c9034e1fa0e86c7,55085370263
20180621,"PAYMENT RECEIVED",1268774826,0,1adba48109e46bd2e33cc798b2cc94b5485f1327654ec2272a2d11084fdbd35d,53760428128
20180621,"PAYMENT RECEIVED",1251518690,0,aa24c0be454c0359222a228ba6eb1b153d407bf6b9d5495afa02e983747c1fe1,52491653302
20180621,"PAYMENT RECEIVED",1259863844,0,50f8027620572be1da9a7da5b271f0dd58c445e4568f4e8ae1149e7f1afcebb7,51240134612
20180621,"PAYMENT RECEIVED",1297354356,0,3481bb8c46feef36520375e7c7d7e51c03c64007c90c02d0ab4cfcc06c9f0b3f,49980270768
20180621,"PAYMENT RECEIVED",1260311401,0,63ed4e7b10d3d5798e20b29bfab275227e9a5904ce0928c4d9fdab35240ca1f5,48682916412
20180621,"PAYMENT RECEIVED",1265760692,0,7a1fe402f60cf6d0ec1fc4704eae1b50605d8ceec31a7c1c43ecfc6dc83fb50c,47422605011
20180621,"PAYMENT RECEIVED",1310174672,0,07813fba9b24aedf20af6080eb8be38d08c2499715eaf8bc9f78ea2fce6202c9,46156844319
20180621,"PAYMENT RECEIVED",1268626739,0,68ba0f3bae91d0042ae807a7f2d5a6c43251262985d676cd5fd32d01cb1ee56b,44846669647
20180621,"PAYMENT RECEIVED",1323193445,0,f7491be50bf2fb572b2753b28b155d7be4baa86608b59d110c06dae0bc266640,43578042908
20180621,"PAYMENT RECEIVED",1263999578,0,b73d00762ab1fe671354f98442d790f0890642d5c9b961957978b2be8254728f,42254849463
20180620,"PAYMENT RECEIVED",1272799254,0,280124f4a897b407df471691128ed68c9b04b0d55ce884370f16b25ce9f66b2a,40990849885
20180620,"PAYMENT RECEIVED",1267299604,0,6c2d9597e2a6c50e4eeeca69f9d1ba54fcacf9300ca38f5e310dc47da7b5f530,39718050631
20180620,"PAYMENT RECEIVED",1273461705,0,06c15e2126d04e27e88e71a1b4a6a41ed7e1d35304657c95710b8b889b4d9d51,38450751027
20180620,"PAYMENT RECEIVED",1301103983,0,069ee251846d5dba2834cf06c66baa34f5b5673b23a79b7f6a04bfed70a94c7a,37177289322
20180620,"PAYMENT RECEIVED",1259234629,0,5732f625c2a8ad42bf0239664dd5e250a3471e83227010c841c24854d10e254b,35876185339
20180620,"PAYMENT RECEIVED",1290304774,0,5408f18d5ceecc578bd79e86aaafc1fb24854170b8681a2d1a083458cc0bbac6,34616950710
20180620,"PAYMENT RECEIVED",1299267581,0,a9fad1eb19c329c85722bdb8a8a9e37ab1eb720d2a148f082dbe268ea06f5868,33326645936
20180620,"PAYMENT RECEIVED",1273437653,0,7571a5d78a72de5b6c403fbdb550d0a5ba2355819476c9c0c468a72b85728632,32027378355
20180620,"PAYMENT RECEIVED",1371823889,0,68475da5e79660f9f7b60b86333d88abda8da35df826ffe3e9a1c295a15339a1,30753940702
20180620,"PAYMENT RECEIVED",1330043591,0,28e4d904345de08712ad318606e5db98bfe1c329e9e9a48db35796d0353bca7a,29382116813
20180620,"PAYMENT RECEIVED",1409685610,0,0e832da04b5969ca7bb6d0abb7b43b848f724f68afea938a37bc6eb109607b2c,28052073222
20180620,"PAYMENT RECEIVED",1361637609,0,af23a61ca163cf8be118c6c387e253a5f1e1482bbc09b76166cf077f627e9c08,26642387612
20180620,"PAYMENT RECEIVED",1357340000,0,26d03b930ca72250ebfb7f5f5e6494e2d9f4eaf264567f79d69fea00902c128b,25280750003
20180620,"PAYMENT RECEIVED",1416090906,0,5b2ed3016fc3774e6bbd7603f1a231c87af71267f8d918928c6e99cbadda2f3c,23923410003
20180620,"PAYMENT RECEIVED",1368772719,0,0433dea3fece804de52fc8faa9d47a7439188dc3d26f34795b676b72617607a8,22507319097
20180620,"PAYMENT RECEIVED",1391951613,0,bcba540855b08b9fabff7f916e1b5dd8a683ffe9a42d37705fb9009fdaa720a6,21138546378
20180620,"PAYMENT RECEIVED",1374210711,0,612f5bf1402cf35cb6140fed2c6782719401b2335ca982ef480b7107c4a54b1f,19746594765
20180620,"PAYMENT SENT",0,-45855173370,fc066ea9008414aeff9f4b1490286d02aa24e1aea60b9a2ecdb617ba3740ccc4,18372384054
20180620,"PAYMENT RECEIVED",1389230657,0,3bb61255996bef8b93345dd8de33a5be639cb30e03c4ec102c56879d861c08b0,64227557424
20180620,"PAYMENT RECEIVED",1387786929,0,204589c91753a21c9e98858b37fd11578c9e83359e99a80e08286b31c9af2c9f,62838326767
20180620,"PAYMENT RECEIVED",1384528063,0,3f18ec0a30985a93b61f0a18d953e772abd15af22e4875d4926d7ff55d4a7f34,61450539838
20180620,"PAYMENT RECEIVED",1486948038,0,a561fbfefb58879090ead9f987d04e2af15dee236e4c0d3319d3daa7adb84a4e,60066011775
20180620,"PAYMENT RECEIVED",1492199304,0,402a77c5d66e15d69cb451ae8fe9ecf84f421973423a30fb7de33bb763868e7e,58579063737
20180620,"PAYMENT RECEIVED",1481922797,0,bc265b3714b8fb0759f0e6bcb77482fa367a43afefed4ac2918a7d791fcc5cc1,57086864433
20180620,"PAYMENT RECEIVED",1415987044,0,6905cd8726d353643db62618ca0c4dc53539dbd3f7f5f638a327c6b9a56a60f8,55604941636
20180620,"PAYMENT RECEIVED",1369183521,0,b0c91326b391de65ef5e6d63c1650b5defed649737d35d3a0f1b176f64541637,54188954592
20180620,"PAYMENT RECEIVED",1468351309,0,aab9dbe681576835d5d89f5355c11ea3c359ef2cad9f5879c6db99c95f59fe74,52819771071
20180620,"PAYMENT RECEIVED",1361112648,0,7e3580c0dbb6c0fc957d705eae65b758e5157930374ebc0ec921808943c28aaf,51351419762
20180619,"PAYMENT RECEIVED",1503752771,0,085a669e0facb49afa58863df689c88559609ab8fda8ba62104593f47473aa76,49990307114
20180619,"PAYMENT RECEIVED",1345823470,0,b5d11dfb2c01b4933969cdd067c25e117402e4c3c108dc37ad90bec5aad76732,48486554343
20180619,"PAYMENT RECEIVED",1285557503,0,4e62441c928aeb9e139db1234499221df6855493bd4de7e2538b69a607e84770,47140730873
20180619,"PAYMENT RECEIVED",1376671462,0,d4596d06aa1df99c68860e898ee7382d4894d5d709d22776184a74f2ca0ab763,45855173370
20180619,"PAYMENT RECEIVED",1324583984,0,63172c8641dd114f08848d40f3fcd7fa7fb2bc606ba3067fec05d75d7a1b50ed,44478501908
20180619,"PAYMENT RECEIVED",1357544988,0,86f2ca8504e30af01bc9bfb0b4c181e2ae7549bdb14471a24f5e505e602b28be,43153917924
20180619,"PAYMENT RECEIVED",1265043676,0,fbffebc22f97af02a91e83c40d5caf906e8e0e56171ea267a77b417c0c3e9a42,41796372936
20180619,"PAYMENT RECEIVED",1284490841,0,186341029de615d932d781eb764acfa8af63c00658094e28367f42117b3519cf,40531329260
20180619,"PAYMENT RECEIVED",1334200522,0,be1ffc4005119f008fca55aa9d34f98dc96e46acc2e4ec8fefb076a82299d79a,39246838419
20180619,"PAYMENT RECEIVED",1414716593,0,cb54e8c815c990ab656299e101a44ab40fe81af27ba442df547185706a9715f9,37912637897
20180619,"PAYMENT RECEIVED",1256563455,0,5c65f04d48bb6b46903842af838bab9cba6fb37beb62036f3bc050e43d9e828e,36497921304
20180619,"PAYMENT RECEIVED",1255146557,0,9a43d9de00f872ad37bad2d8883a1f77159c677b4770f2695e3fcc7220addd46,35241357849
20180619,"PAYMENT RECEIVED",1251826786,0,f3f18301d902f3093e2f8007b0fcf8aac66639a0b7d4968eaa79e348bd7223a4,33986211292
20180619,"PAYMENT RECEIVED",1262250843,0,da3fa0cc45d2216e9a90841330cb6f5ca97ac7255de07e9003ed488220140cbb,32734384506
20180619,"PAYMENT RECEIVED",1256670568,0,0f2d2c37835672c1d04df66a2108a41b3e3d2e0ca07d13d24b3df177488ce4de,31472133663
20180619,"PAYMENT RECEIVED",1257019149,0,f8bc3547337e64982e9c134ef1499868f931c47153c4cd44845ffdcd7146f3a9,30215463095
20180619,"PAYMENT RECEIVED",1255428578,0,a95e809ca10ac13b707bbdda34c5def5f44be88a9f4a0d7791c47fd7faafce66,28958443946
20180619,"PAYMENT RECEIVED",1250682158,0,5ee66f23627330bdaec5f1ecd4d95c18fb80668622bd3afad2d5506eef527ad7,27703015368
20180619,"PAYMENT RECEIVED",1263209844,0,37163faa52f9e5b056db820df8892a32d7cb0092e78244a6469a5957cad808c2,26452333210
20180619,"PAYMENT RECEIVED",1270571730,0,02c1eb845e417c5e14458536653cd7bedd04be9de58a64206c135493c5f2dcda,25189123366
20180619,"PAYMENT RECEIVED",1270844740,0,2582cb2ccd7f239bce2805ca7764da9cfeca325956847ddd60a5d5ddb1465301,23918551636
20180619,"PAYMENT RECEIVED",1256863207,0,cbd9fd205345ee829092e930ec18117ac972fc235cc9b0f1b6890cab4a974a6c,22647706896
20180619,"PAYMENT RECEIVED",1251353625,0,3b2610a5343c299c65fda093a48e7c7bfd13cbbba2c62e13a1607befff58a04e,21390843689
20180619,"PAYMENT RECEIVED",1258180076,0,04596623ed1a0316f16e3d707855e50cb0da6a66939e98c95400c35ebe2a9541,20139490064
20180618,"PAYMENT RECEIVED",1257092116,0,897f22f5dc13e0f401ff63263a1aab53df0b24784b6c18c3c8388b3f94e6bf7a,18881309988
20180618,"PAYMENT RECEIVED",1265501320,0,00944653f932f25a261c00822c667e365c43d37ca41e60f0d9bc031e1bc67d75,17624217872
20180618,"PAYMENT RECEIVED",1260166878,0,0594c82cfeca896c5b8df93c990f9c45949911a706bf0ea3c05d7b132c4a8f0d,16358716552
20180618,"PAYMENT RECEIVED",1257312249,0,733c8ee66462f195af0b3b359da450e8df5d4cc681c980f5b77bba27aeac6cfd,15098549674
20180618,"PAYMENT RECEIVED",1260422661,0,c125114a94d69bc696c0f151658c26b95c56b406a8e5bfe0c0f69832b11ef12c,13841237425
20180618,"PAYMENT RECEIVED",1262119236,0,63764d8a9ac0c05ac45bc4f231f27cc849e1d266d7a14685f545dc8f0adfb339,12580814764
20180618,"PAYMENT RECEIVED",1253623471,0,6dd6df6ba8a937667979c01a48ee3483b1fc55b722dd2a274135d53508eb094c,11318695528
20180618,"PAYMENT RECEIVED",1277050561,0,20af7143b0552edb4a2428ce7eb7e0a4d79f56f63dd4909848d25bb6409aaf0c,10065072057
20180618,"PAYMENT RECEIVED",1251653212,0,b432c8331697b4788d154afbc4746bd020c5f17891b9d1fa00de61336b54f757,8788021496
20180618,"PAYMENT SENT",0,-18847340563,29fba157c7772ee9fc6da1a6bf358e8b6d5b9ea4bd28d6d5599b3eb37da769dc,54277329667
20180618,"PAYMENT SENT",0,-18853204293,9072a1857f85868fcf107169bc3b1f81d3466141d01264e929602b601a8d15e2,35424125374
20180618,"PAYMENT SENT",0,-27887757090,a77767fbf005288b7619ce8ab709f0fd964496a7b26a8a9b444a38d8e23c00a7,7536368284
20180618,"PAYMENT RECEIVED",1256578151,0,9d206496325ff26c3c015a0d9cdfe9dd9362bac5ad0e3d38b457940b74d26efc,73124670230
20180618,"PAYMENT RECEIVED",1251548020,0,2cf2d82a1949f9dded6a25e72b90667b0cab7462b7d5b3b885dfb32c1bd45c24,71868092079
20180618,"PAYMENT RECEIVED",1253129539,0,0623d227eee4925d304098275dc8954438887f6e5f4e9d15654d3036bb2d793f,70616544059
20180618,"PAYMENT RECEIVED",1272606780,0,10e50def8da9fbf737ea2274ca78bfd0b15ac0fe45312ba12954b005f627bd4a,69363414520
20180618,"PAYMENT RECEIVED",1252223266,0,10c4edc6f0ba8f797179f217b2a7a976cc51be3b02cb88f83063c110dd99c03e,68090807740
20180617,"PAYMENT RECEIVED",1250282528,0,9823667a4f21ad55c7f8eef2759c7b9b434884655935857b8cf5f0873b8e846d,66838584474
20180617,"PAYMENT RECEIVED",1259014559,0,6fa505aef6024cb37831dd6af03956492a7d49db24c26adf30d54a5f3b557f75,65588301946
20180617,"PAYMENT RECEIVED",1250865523,0,2739eb80425fef0c0cc31206af8667985dde3cbd2459a829a7fc16c2470e0ac8,64329287387
20180617,"PAYMENT RECEIVED",1275665321,0,b47f53f04790cd3322af6b5781c07e2b38295b01eab3dbd70debbcc8e8cc7648,63078421864
20180617,"PAYMENT RECEIVED",1264669860,0,abbf3f6bc67583bfe6468651d148e4ecb3606ea1b89a2c4cdf6c83fa006cd3ba,61802756543
20180617,"PAYMENT RECEIVED",1254585658,0,01f3ae01f7f4616b77a98a4cbd6573ef85069d1dc0fd09a7ccc8279d4c46b34b,60538086683
20180617,"PAYMENT RECEIVED",1267260421,0,9c0adcd139b49e7e516ebb75f49e958d84e2c017d279e2fe3767b90d47ad99a6,59283501025
20180617,"PAYMENT RECEIVED",1284659841,0,6f9c674adf8c29001c8f5f696cc23586aec9243ce9f848759f370b5b8aba2ca2,58016240604
20180617,"PAYMENT RECEIVED",1250385467,0,d433e5a2f1d367495c82a2c562db60f228c1120a2756d24f081b4c7c3fa339dd,56731580763
20180617,"PAYMENT RECEIVED",1292755955,0,e3f8ce1f11e29720b9878d896899e07a0405dc0654eb139a839d25d0aa297351,55481195296
20180617,"PAYMENT RECEIVED",1253169390,0,a667b0e8a437a36edd59854601bdaa5ab2929b31ff80ff79682421a2cc039bd6,54188439341
20180617,"PAYMENT RECEIVED",1276329253,0,ca2356f6a9d43ccccb015ddca34e7c6071c5f0891b9f238511c19ea3dd6d25fc,52935269951
20180617,"PAYMENT RECEIVED",1255660756,0,1f48d4c805cecc3741e5f49d0439f144a26da51245c0db22d1e4cdb9e8386a97,51658940698
20180617,"PAYMENT RECEIVED",1258242109,0,044d2d64b8a1218c8735155d1c7c95d7bc61c9878373356268595dfdfd94e000,50403279942
20180617,"PAYMENT RECEIVED",1258140502,0,0fca97af3f8a4449ee17f2fa9fd0a3f9017e1b31db63f8399bc260bcde67fcd9,49145037833
20180617,"PAYMENT RECEIVED",1253538711,0,a310c188da741d4aaaf138c0974947fb8c1a35bff545aad70c0d837e2c7b375c,47886897331
20180617,"PAYMENT RECEIVED",1266391843,0,ba9d9efae764ef59b8e76440659a036db69783ef45f1288f5aee79d3afc3461b,46633358620
20180617,"PAYMENT RECEIVED",1253953177,0,b5622dd22624a4eda26181d7c52659bf96494ba5dfc2050145f007e130d47dff,45366966777
20180617,"PAYMENT RECEIVED",1250474540,0,8dd68141ec626733ef1ca150851aa64f53639d5d24ab45077c0a727872750ef3,44113013600
20180617,"PAYMENT RECEIVED",1253039062,0,49aafe9ca5ebd6cbb5ab13a9be7d49c8e2c784b1c35c3c5a29c3cc4a0053084f,42862539060
20180617,"PAYMENT RECEIVED",1263865220,0,23dab3974da8d53cbffd6666555e4c84875549c3474af0b0cada8830738569c6,41609499998
20180616,"PAYMENT RECEIVED",1277007148,0,f6ed861fc31763336dfe45399a073e27dc0329fd69591a2857203ad13b8b394d,40345634778
20180616,"PAYMENT RECEIVED",1259433292,0,7eb020d547eaa25df0430f54d27e0192cc897989a1c26d409dd1be926a04be0a,39068627630
20180616,"PAYMENT RECEIVED",1250000000,0,98ac258e89f9383076aa63f5274d1b7532211372396325f4b9186bf67e56da49,37809194338
20180616,"PAYMENT RECEIVED",1254366925,0,11de9a5e799e7ccb5cede7927f01cfd2f5d76fcc78940732635ff2cbd32afde6,36559194338
20180616,"PAYMENT RECEIVED",1268230141,0,8ad8957cc52c1b680d36b5a1ddd03b606f3389e8644c0be11e7394273a1ed39d,35304827413
20180616,"PAYMENT RECEIVED",1261022591,0,5ff92b69366b0723317c899ad123b1f8c19da6316992b0172d379c8209f53efd,34036597272
20180616,"PAYMENT RECEIVED",1274883125,0,876c94cdf5c90715caa81b1ebea602398fef3f1b25fc7bb285eaa17766043689,32775574681
20180616,"PAYMENT RECEIVED",1301589195,0,df965c05b59079265f8683df5d2bc4ec3f41bd2e3fba4dde306b0b56f13819c1,31500691556
20180616,"PAYMENT RECEIVED",1258686835,0,3b0e4d98efcf73ca1256d2e8ae7e236292ab600014370588ab5a1a6d482be2c6,30199102361
20180616,"PAYMENT RECEIVED",1252661282,0,079956a0e089118c1f12b45a362c1e9104d1509a042eb00fd02049156b63481d,28940415526
20180616,"PAYMENT RECEIVED",1251589784,0,7ddeb8317de295e89317b4d208895f708804697dcb6d6d16891bcd993f0ed622,27687754244
20180616,"PAYMENT RECEIVED",1256225226,0,5639469c292a3e3c127b2be0c08a4904a5109dff2eaeed9e18e439c5a32cf629,26436164460
20180616,"PAYMENT RECEIVED",1258645701,0,0f5fb586a4b2e90cb22c53dad81530ae5a447528187f85dc4ef61098a1db8cee,25179939234
20180616,"PAYMENT RECEIVED",1251620829,0,1122a8c1cb3d523674dd6e3be0edbcf054250c509899bbf2ba750bd17bd86c9a,23921293533
20180616,"PAYMENT SENT",0,-8820478070,d0adaabcadd1f25d3016f7ffe874fc4d62439c1091911ba566a0344ae4874a94,59627303732
20180616,"PAYMENT SENT",0,-36957631028,1153896523432fd1de4b37f555a5876da1cbaafe5e13a45510650687ac27af5c,22669672704
20180616,"PAYMENT RECEIVED",1256992206,0,d19630e991e3341c648c2b375ad369fc726a8e4671c5ef65cfd0e99b9103da91,68447781802
20180616,"PAYMENT RECEIVED",1255147209,0,c319e0fc8b2bab5a24a7c0ffb627232e4fccbde701e82b939e65d46c6329da63,67190789596
20180616,"PAYMENT RECEIVED",1258878872,0,1b8c4aa7c765ae0da0facc4f66f3dc9e8bbcb1841eebecb1c649d8ecb07e7284,65935642387
20180616,"PAYMENT RECEIVED",1275025763,0,0c32cb5fcfe0e1ba6910947315625e64643d1acb45c3c760a5ad45637c34afe5,64676763515
20180616,"PAYMENT RECEIVED",1250552673,0,b37bd8f7eb173f1e651713df81f4b15ca053a4a87ab737e6af67c701ec37003f,63401737752
20180616,"PAYMENT RECEIVED",1250665974,0,e9ce79fb70e5001d9fc096e5bb1534c99b0c956950aa5e1c66cbf9011580ae3a,62151185079
20180616,"PAYMENT RECEIVED",1264058098,0,f5b394b4037561915825fef6a02996546ee476e8c13a5d63d9ac32592da7cfe2,60900519105
20180616,"PAYMENT RECEIVED",1256850808,0,f784cc91866107d5c4a0f65704ec475c72b441d605ce04121ae25e5347a2ba79,59636461007
20180615,"PAYMENT RECEIVED",1265501559,0,3798b682bede32be50302475c6ee453aaa84cf210d0bf74633783bfa04a1f377,58379610199
20180615,"PAYMENT RECEIVED",1257275732,0,fe2b0850c23b300005c0b61b0da545ec9f0e167bc195ae0073bcafc5f205d7e8,57114108640
20180615,"PAYMENT RECEIVED",1260054330,0,36d16c4bf6e582c06c815af70a4b75a54c336cd70396f0b22811cc78b8c8ef4d,55856832908
20180615,"PAYMENT RECEIVED",1275058967,0,ec9e740b79ca0290e0c9f43a7476d8852814025d1cd1750e9599915c913d6e15,54596778578
20180615,"PAYMENT RECEIVED",1258977917,0,b73949d659296c1780b876e7f8924d791add1716b0d32de93158b80beffc30ee,53321719611
20180615,"PAYMENT RECEIVED",1265206173,0,cad8f667de2964e96d712fb616e87b156d917e27e846808cbbffced03ead68e7,52062741694
20180615,"PAYMENT RECEIVED",1264931844,0,073e6a4729088a4de7fe4ec7aab7eff192aa6547cf29b4a5b1dd45f86134695c,50797535521
20180615,"PAYMENT RECEIVED",1251305854,0,3e89a2a6d8b972dcf0ae0e669a2fdb7e3fa9bcbfd5585f9b23e3ba5153ee932d,49532603677
20180615,"PAYMENT RECEIVED",1250755614,0,0bcc25c526d0c3b79182a324f8f0d6317835f961684414ad3418756413aefdf3,48281297823
20180615,"PAYMENT RECEIVED",1252433111,0,7bc9e357064ff036d50f3fe800d20548d4b529fef186231663c0c87eedb4fa55,47030542209
20180615,"PAYMENT RECEIVED",1294821732,0,e4fb99fe9710b72f9cb8fa1a55e6e984303e6f309595d5d54232867b84f26e47,45778109098
20180615,"PAYMENT RECEIVED",1282440647,0,3d74f818ae1f4546d20b522887cbbc81ae92b646b8dca07ab082296bb9f36996,44483287366
20180615,"PAYMENT RECEIVED",1262774396,0,d06fb9cfc6dc29f65f76f97964f1f5517253d851ca1b6eed279465c87318b559,43200846719
20180615,"PAYMENT RECEIVED",1274298152,0,fb1927180696d44d13ba69ea171409fc5dc2477d69d47e7f0c3da2b052bb38b7,41938072323
20180615,"PAYMENT RECEIVED",1256044739,0,476ce69fe39d729bf21692bfeccd89401bddff23bd91f3527230846f8dc10533,40663774171
20180615,"PAYMENT RECEIVED",1271051926,0,7581ecb7309022c2e180cbb67b265189b00a907262289c711d973611e624ce7d,39407729432
20180615,"PAYMENT RECEIVED",1252637424,0,3691b3bca640285f168dd0cea3fffe24fdc841302eeab79d2e608844d64b3efa,38136677506
20180615,"PAYMENT RECEIVED",1283953776,0,fb18c994a90c2583ec12b747faf44a615949df4efc056240098638cef2d4991c,36884040082
20180615,"PAYMENT RECEIVED",1254446859,0,2445a641342262cba5950f0c62b6ab359f6e50b8a354df43b5438435c547b7a6,35600086306
20180614,"PAYMENT RECEIVED",1259266519,0,2332be32223bc67a6648633a7d2cff1ac7e157e4a6e0812330b8396efba808ad,34345639447
20180614,"PAYMENT RECEIVED",1259950794,0,a8f237793aab783191a71495eb1cf1c42c373f7c6e5501091496953da66b8e80,33086372928
20180614,"PAYMENT RECEIVED",1253388628,0,d2f7e828e38c07623bebf13e067da5a242fb6548b8ea80833a81f1d2713a6bc0,31826422134
20180614,"PAYMENT RECEIVED",1256379945,0,5a65c118a9bea461ebe765eced62017f152c9b7c68373dbcc1485d66cd6cbe5d,30573033506
20180614,"PAYMENT RECEIVED",1285790618,0,f1e05016c8ff8e361146a2b861c97a46f5646e5dd32f7745fb705a67b31497d4,29316653561
20180614,"PAYMENT RECEIVED",1272287470,0,ab989fab019aa6035d4c1aa5e4995b4ab53e60061d5e1bef2577c0eb7cc06a86,28030862943
20180614,"PAYMENT RECEIVED",1277964703,0,ef006e3b194869b2d0e397f3cf9d91eb1da4fce6d67edc981e504dc5a9850584,26758575473
20180614,"PAYMENT RECEIVED",1262302567,0,c029b25ed1ffa1e875e81662f32a05c84a9f43eefaf97e9280e779ef33140477,25480610770
20180614,"PAYMENT RECEIVED",1257627519,0,19efbd8a9178f00695a362dadcb5506e766abbf9f80e9cc07ffc6ed382cc0903,24218308203
20180614,"PAYMENT RECEIVED",1253507942,0,afd6a20fed9fc11595b626a2bf8a3cc044ce0b01ed4c0bf816b262aef390fe2a,22960680684
20180614,"PAYMENT RECEIVED",1291274646,0,d582147960c1f45d7062192e2482a1528d49f62347e17ff188c766b522196530,21707172742
20180614,"PAYMENT RECEIVED",1253920379,0,4494eab4559805c9b10eab8d54290a3e31e640d9b953b9ef38ab34ac95217050,20415898096
20180613,"PAYMENT SENT",0,-5041410108,b512332e925486a565e1fdb1ed95b087fa6d7f02a527c6d9372f2db7fcbb930d,24195501359
20180613,"PAYMENT SENT",0,-5033523642,16665c8a25f8ddcaf17855f09de6392fcbadd91bb9b83dcdfceee8c98ca65751,19161977717
20180613,"PAYMENT RECEIVED",1252804369,0,689c5d55a456954b08c9644118439a1c00dd7f44752a6b1dc3235644c3cdf293,29236911467
20180613,"PAYMENT RECEIVED",1298348649,0,76b04c3f6432e99ef30406e095e1af70b23ca0582cda6bd6bea9531aa9bfb57d,27984107098
20180613,"PAYMENT SENT",0,-3780967915,8fd63558ed937a257575da9d714223a14bb50d41233f2d887aea5723d2122903,49447178837
20180613,"PAYMENT SENT",0,-3797865464,17a6091019d84a6dfb4495af1d95a481b1c125c59ad5c76ae8467c70a9af3e1d,45649313373
20180613,"PAYMENT SENT",0,-5031464114,ce0c2a78b6bd9e120f580b150333191e45ffd148f7803e862c389bfc85d6071f,40617849259
20180613,"PAYMENT SENT",0,-5040821935,bba7ea5e651e9b17d3aa796ca4adcd6601b341f83019936bb19986a6b063307f,35577027324
20180613,"PAYMENT SENT",0,-5025447018,3e0b7cd378a5d5d5ee4e7d7f18cb4941cd68f68bb63776a2475447741027c88c,30551580306
20180613,"PAYMENT SENT",0,-3865821857,669fb0a58418cec2cdba2f37b13889b385644fdee7cefc952ab581040e5380f1,26685758449
20180613,"PAYMENT RECEIVED",1281075107,0,c6bdc34a2fb2a38b76e7d1afd6bd0bf5a62cadaec35ca45ae273c61c93f48952,53228146752
20180613,"PAYMENT RECEIVED",1316806058,0,6d0c9e057526a1f23a5169286694d460b05d8b1fc743f022f61ec65c3357085a,51947071645
20180613,"PAYMENT RECEIVED",1323142680,0,1e4f59999a0820028e50c2cb0ab2ad09867fb50f4ef281c42795ec234244e932,50630265587
20180613,"PAYMENT RECEIVED",1355823157,0,baea14fb8f16a7c3eefb4e918f15cadbf8c4920eb7a9446c04e87897a0beb783,49307122907
20180613,"PAYMENT RECEIVED",1266470795,0,718966989e829c53402596fb6d3710c56e3eef9288382941d9e4c552dfde89f7,47951299750
20180613,"PAYMENT RECEIVED",1286952942,0,9ea127106b7343cb710f0166330b8efbf99ee4d6dadbb9f2b2918dbf49558c32,46684828955
20180613,"PAYMENT RECEIVED",1260423632,0,708bc1443e309b4fd8810b911b94e83210eaec51fcbccb30f9f0d649ce379430,45397876013
20180613,"PAYMENT RECEIVED",1256796669,0,f12865fffac530c0df9eebfebacbce5756c6f42eb7e2827b4ae53fcc6d382752,44137452381
20180613,"PAYMENT RECEIVED",1253848763,0,aeb7685a727b0d3cc9e4e931eb3e12e0a72e0671f24a6ed27c2ae612306733ef,42880655712
20180613,"PAYMENT RECEIVED",1256763244,0,9d2990b45cffd84b52fb09959dd975a19c57293471961926a3c6c62e1da54137,41626806949
20180613,"PAYMENT RECEIVED",1250821704,0,0fac7fa97b1f0befb8ce03dc6814b57ac04cff43e0511dedd584cc80b494dfdf,40370043705
20180613,"PAYMENT RECEIVED",1250907388,0,c26cf55607e3aa158316ecfa57e4cca2c6126510a664a33231f995a3c99cc836,39119222001
20180613,"PAYMENT RECEIVED",1250992560,0,1e8077b8cfe203ba4305c7fb14c5a9073329410236af7e75fe5d30e717786206,37868314613
20180613,"PAYMENT RECEIVED",1252860966,0,ec36426dc55663c3391243c17519f54276cb84b481b03576f3e006fb1c3eaed6,36617322053
20180613,"PAYMENT RECEIVED",1266417440,0,4c97f4284d0314f1d391a53e988c70b9998e0f7858d41869ffe54b186bec3ea1,35364461087
20180613,"PAYMENT RECEIVED",1261861533,0,0096e912fa59ab45f281e52c4be51a7d9fed801d84de4ac9ec190c9abd662476,34098043647
20180612,"PAYMENT RECEIVED",1256398170,0,d7202af327207f422a91a83b417771ea96946eb6aa5f3c99f56028bc3cfbb0f2,32836182114
20180612,"PAYMENT RECEIVED",1261753112,0,0ffb1450e15feca32fe6f68a26530da311fa18e023c06bce64bb470a407e32fb,31579783944
20180612,"PAYMENT RECEIVED",1268465233,0,0525d2a616d8d5183b68425135a23cf0402557e4b68ac8eb5d9952f4954b257a,30318030832
20180612,"PAYMENT RECEIVED",1259812173,0,beffa67fb86582dafc51fe347282ab02539912aa3fec52ed857ee38a1ce7be82,29049565599
20180612,"PAYMENT RECEIVED",1279419891,0,48f612cec718b06df731012d86a7be52a8b29bb0dd56b6e6a3ebf4a4c1e3d40d,27789753426
20180612,"PAYMENT RECEIVED",1252797363,0,282bf6f0af2ef545baa9ff9020a9c04bf310842e59c87e63bfeadae0094248b1,26510333535
20180612,"PAYMENT RECEIVED",1266315217,0,9e25631cfe03d5ef37866549435a9a3215d72c4b3b6d34421649c5589713a7d0,25257536172
20180612,"PAYMENT RECEIVED",1263085014,0,1b14d909eea62c371cba70fee9a38b48e1a98f349ece72705379403085164639,23991220955
20180612,"PAYMENT RECEIVED",1264280095,0,e7850bcf323a2e3e740952413c93da9f435f5487cc7e79a6d18362b2a5527594,22728135941
20180612,"PAYMENT RECEIVED",1304883574,0,5feb118f85b8684b26a70f972350e8f90f6fcf0da7707984ba32d392cade2c08,21463855846
20180612,"PAYMENT RECEIVED",1260947830,0,58bcc342d45ac9cb53655e2aca325dd5068a5fe15eb9981edba5baa4fc66c626,20158972272
20180612,"PAYMENT RECEIVED",1256603945,0,96426411b2bddbc0ebcca6a39c11dd9e755b4d6fd2b825776a571b8f18079f33,18898024442
20180612,"PAYMENT RECEIVED",1262936072,0,6fe3a8ed0506c02c342a4671e5e9ac02923d2e1498b65497f5d3b2ef40017b0b,17641420497
20180612,"PAYMENT RECEIVED",1265900923,0,0098b855d8d2e65258e4388d935c0ce7b5d1de3f00dbdce1270d1303a4710e33,16378484425
20180612,"PAYMENT RECEIVED",1251206601,0,f50d34939af32b87c3a85a01b83567b47627896480dd1bf0dfedd81fd15a9735,15112583502
20180612,"PAYMENT RECEIVED",1260227243,0,5ca3980cef0f540326b039317b17e065c824c742ea52c3d27ffab67db7547d39,13861376901
20180612,"PAYMENT RECEIVED",1250986682,0,2cc3ed47160cb6d801ff00abed26da1678bbdb82cac816c3d7a047154cf61448,123429748798
20180612,"PAYMENT SENT",0,-46587338957,3bb1b1f65d08e81549a11ff1f361e26074db3bcb94e4b01f083b9ea6544ce77b,76842409841
20180612,"PAYMENT SENT",0,-64241260183,b1c4e7e66fbcba7e1541b45df0c31e2241b51f1ca9d1878785b528f6b27ae445,12601149658
20180611,"PAYMENT RECEIVED",1251626887,0,7b42415707f5cdd3d09c7d20cf690131b8f0072ebac702e8c1ae062ed3c2822c,122178762116
20180611,"PAYMENT RECEIVED",1265597418,0,f327de860b8f2b44099f8c80ce7aaa6ffc8f1865d7a4b31ce876ccb9266ca1eb,120927135229
20180611,"PAYMENT RECEIVED",1255692155,0,40a45fb014d37551133c9438da51ba53623dcb479003f02696fdf28a9af1ee17,119661537811
20180611,"PAYMENT RECEIVED",1255361747,0,f9f1298c6a316c9600f4f368538ce2bbadf749d4356fea8c84a9e83ebbf5bb67,118405845656
20180611,"PAYMENT RECEIVED",1281518392,0,8cff2098f5dec71caf4ce3941385133e87990cfc30e93364db01c8eed94a091c,117150483909
20180611,"PAYMENT RECEIVED",1264283642,0,78d8b4fa6462f2cbe666f59c64a211f100e439b95a47d71564c80d68a2abceac,115868965517
20180611,"PAYMENT RECEIVED",1261614402,0,a4484faf5031a5a2bacae008dc17ca0399dc0b07474ff8e258198321a66d4252,114604681875
20180611,"PAYMENT RECEIVED",1263203712,0,13d2c9537541331583a1c8273df087aa128e8488656abfe1d5e79d01fccf8aaf,113343067473
20180611,"PAYMENT RECEIVED",1251264621,0,1006e993165fd5d6f7a002421b0f0b178f4750c80315b07ba1366b0ce3610734,112079863761
20180611,"PAYMENT RECEIVED",1259819559,0,2a7728ab4c6908ecb9c63d77e5db76000ae49c96ace975c0f7758e55c839bc30,110828599140
20180611,"PAYMENT RECEIVED",1250460567,0,9f70018611a23bf54a97b6a360a83f501fd442d2b163ed28cfb7b798a7f991d0,109568779581
20180610,"PAYMENT RECEIVED",1269264069,0,2242d4f8fe272ea15789464d9d62e0166280bc4d42682eeb4748af4c48423929,108318319014
20180610,"PAYMENT RECEIVED",1251436725,0,7bd32a9dec82c440117799a19e75ce671b54c2bdeab233df462171f36bba2434,107049054945
20180610,"PAYMENT RECEIVED",1268868160,0,77adc273b5689f042aca217539aabe3b9173522783553a06a67737657f2e8c8c,105797618220
20180610,"PAYMENT RECEIVED",1267042171,0,b318cfe4ead823f59b452c1fa1d0b21c4dc23bc8b77ad6c29ae6c618d5d30e91,104528750060
20180610,"PAYMENT RECEIVED",1252604668,0,68b2336fded9cff6946a99a0d9306b9cbde0e0e445833968016c35e010d0a5d1,103261707889
20180610,"PAYMENT RECEIVED",1254362885,0,ee833c8fcaeb0cb36ce909cc9506d3154f0e69ff67993e740c7763e892a09dd5,102009103221
20180610,"PAYMENT RECEIVED",1250239798,0,b29953ff4584d39705473c18acf946469dd2749fa1fcea0d8b20ee4015b58a25,100754740336
20180610,"PAYMENT RECEIVED",1252362341,0,ed76bfab445c43757af6b0eaeee47d3b769386d0efe6150fd63bda39214cf6fe,99504500538
20180610,"PAYMENT RECEIVED",1250926139,0,e1a3d6b086a878d6adbda961c9d546026ec8b2fa5e63ff60613ab74ae81277b3,98252138197
20180610,"PAYMENT RECEIVED",1250394223,0,7abc1053e850da25e82686e840c5ca5e52e6300746a878aa17143d463849f9a5,97001212058
20180610,"PAYMENT RECEIVED",1269494679,0,077b1f71785ced416e9ebeb47990ad25d1dfb7dfc52132a63810ea67dca32c12,95750817835
20180610,"PAYMENT RECEIVED",1253875049,0,7ac94e372747f1ae2f6453c1ec24ee33700215078c96453570c77864955e7784,94481323156
20180610,"PAYMENT RECEIVED",1256942298,0,1c815380d14440b6bcbbe86e63cb4733ba510a9770c5bfda2f3bcceac3f21aa5,93227448107
20180610,"PAYMENT RECEIVED",1270451285,0,a00428df5d95c2045d29bf4456ced6c45d9656be9a6fbbea65273852f0c6319b,91970505809
20180610,"PAYMENT RECEIVED",1277252953,0,ee6361c506a53e0cfc9ed5d9bad8c9dad120566d2675779e23d176353d0c4cfa,90700054524
20180609,"PAYMENT RECEIVED",1251078660,0,5c6e239b48bc9b3a9f8f4024daed628020f1fbe2ccf0185d5b04faa4a2dc171f,89422801571
20180609,"PAYMENT RECEIVED",1258071561,0,2ddd8526a754d345da8822300f81f0ad597fd76a3c4c8c3f4188b98e06ea2cc9,88171722911
20180609,"PAYMENT RECEIVED",1253419931,0,053dd4a0d9ac027586909c4debf684bcc060aa044d5f87d6a437c1dd58c2cf7c,86913651350
20180609,"PAYMENT RECEIVED",1277409862,0,752847010fbd019fff212b22893c439168d6c3b60953e81e5b2ae88a737465bc,85660231419
20180609,"PAYMENT RECEIVED",1256013948,0,a51c38a680443ce9b335db732b3981525b38cc53a0d1f4d59a56bf15866738db,84382821557
20180609,"PAYMENT RECEIVED",1254197532,0,0242ef01edf3874804fa745ff91ae45a7d3c38636a185633f711f869e947c3e8,83126807609
20180609,"PAYMENT RECEIVED",1267154199,0,4bd6d36f75dacfa8df8d034d30a7ebe59b57b6e4e7ae9f5787cd994df1797fda,81872610077
20180609,"PAYMENT RECEIVED",1250279868,0,4e18baec88f3673de31a9130f4428e1bbf6051e1b5a1fe456631083d022bc368,80605455878
20180609,"PAYMENT RECEIVED",1255878836,0,f3e363ee9a496bd795960aa1319d993475f6b39ad716cdfedebb5b272353b343,79355176010
20180609,"PAYMENT RECEIVED",1267500051,0,66199dd812d79afaa0b6af57e0724ee4a71bd62c8de1563cd6b830a8a67ef69e,78099297174
20180609,"PAYMENT RECEIVED",1252475733,0,e9725b41835804b507cc643f0dbb8125a6211e6f5f6d080c782f595a273ad9d1,76831797123
20180609,"PAYMENT RECEIVED",1260880800,0,7ad0ef4d64331a655d593b5518066bdfdb70211dc0398e23e6fa12f07417d66d,75579321390
20180609,"PAYMENT RECEIVED",1255840415,0,b7e110979fe07be350e914d75138e033bd1ed461cfe035d6b9c82f82d77f044f,74318440590
20180609,"PAYMENT RECEIVED",1257025340,0,cfcebd6e36b6fa08f0928ba0b8d208b53dd2e2c569f86bbe1c8a2016735f9533,73062600175
20180609,"PAYMENT RECEIVED",1255456939,0,d64abe953742febca46a27a2f01010f89668937818ecc9c4cdc44a0f76863a2a,71805574835
20180609,"PAYMENT RECEIVED",1260759719,0,0fe3f2762ad4556aaa137ac3c72373807426e11cf6a2b6872bd8dc64091fdc8d,70550117896
20180609,"PAYMENT RECEIVED",1254496086,0,ae6cce87fd663b575ac3be20f334ab864991f8806154fa49079e301bd3c80427,69289358177
20180609,"PAYMENT RECEIVED",1280282784,0,9dfe1f283e52e9e4d332447afb86b0e678b339e09b4fef1d3bce412a7ea358f9,68034862091
20180609,"PAYMENT RECEIVED",1254895558,0,c6bd214c19ec7b214d5d0b8361c6bffa5b443afe9492fee8ed8e010d34ed7c6f,66754579307
20180609,"PAYMENT RECEIVED",1253052649,0,50d54a19677e1bfaaee71410cf4f16f17b62f3781c9fc80034c4bf587ddbc1fc,65499683749
20180608,"PAYMENT RECEIVED",1257557589,0,d712ac07d6f393ddeeb11fd8a82df7f3d0ea9dc0c4a7b42bbc1d4348c7d203c6,64246631100
20180608,"PAYMENT RECEIVED",1258896751,0,0360aaf4d21d8bfda11fd0ea9f8a4875b7fc4476d03df0cd63ab98d789984658,62989073511
20180608,"PAYMENT RECEIVED",1257704046,0,168ad5facf957001a9544a9203302322ccf176db3dd72a7ddd554163f2b2313d,61730176760
20180608,"PAYMENT RECEIVED",1270075093,0,c4f850268ab22fbc710a15256cb8c651f3460b0f636972a81a60684fbbdaed07,60472472714
20180608,"PAYMENT RECEIVED",1265934981,0,d2d789563a20ce6a9409eb4567531e5035305af487a567adb61372d5d52f9534,59202397621
20180608,"PAYMENT RECEIVED",1278921109,0,425ac0c3dfc0617041f736f59635b6841ea69f7dba1f53d272ddf38ff96276e3,57936462640
20180608,"PAYMENT RECEIVED",1269429990,0,39d6d3125f4eababffbf4dc4c4441de08890773b2ca61b5df239d0c6b6e42aaf,56657541531
20180608,"PAYMENT RECEIVED",1274856323,0,f3c13d6e528ed7d02aa8e4c40cd45868d5dbf7abfdaf59fa328d912fb56f0f22,55388111541
20180608,"PAYMENT RECEIVED",1300534757,0,04840e2978d8eac51e11e36f682d56cf1147ed041b6a353d5f336b54518bf1e4,54113255218
20180608,"PAYMENT RECEIVED",1252212396,0,930c18a121e2ca74c40afd493afd13b84de14b0880408060fd157a7d0d1550c8,52812720461
20180608,"PAYMENT RECEIVED",1253409357,0,9ff23662fe14c8de7b9220311cb3de9573ffb925e7990da46cbb79fbecb6f48d,51560508065
20180608,"PAYMENT RECEIVED",1250000000,0,5fd08e593b1f13823f87f0e756ea628ee2d512c78bd81202126f4ee66236a0f1,50307098708
20180608,"PAYMENT RECEIVED",1289372088,0,29e6869d577a8bb9a7f0c6aea1605449ff2666e7c970f006a55d2a4da2fdf529,49057098708
20180608,"PAYMENT RECEIVED",1251879646,0,8e8364d4dc626feeb35a06b738c22572db9d5692ed907a2c2682ddfbcdbc8477,47767726620
20180608,"PAYMENT RECEIVED",1256242802,0,15f985c79f6ba44a8b046d7b8bfe5dcdeb31424053b12e37bcf9663d297ba5d5,46515846974
20180608,"PAYMENT RECEIVED",1263904280,0,311121bc562b04bfe04ba1cdc38191fbb8d0ee40968708dfe5e8c60aba88ce11,45259604172
20180608,"PAYMENT RECEIVED",1254571277,0,4f74ad5d295e91c3d013ecc153996089d6b8287239c27edc474e5fed6c89053d,43995699892
20180608,"PAYMENT RECEIVED",1253637513,0,cc3d8e69ba8627ff194ae0a31932f75827c6d2e31b1af2dc03bcc803880a4c22,42741128615
20180608,"PAYMENT RECEIVED",1253961525,0,a467ada8536a2d50cd6b60d6a967feb7d94656823f2c095aa05a7a244ce748c7,41487491102
20180608,"PAYMENT RECEIVED",1256540899,0,c6cef754cc9ce1b5368ec19f070f52dfc521580e8fdf1ca98e774383ac148d19,40233529577
20180608,"PAYMENT SENT",0,-99639835716,f5b5e5c1d3ae2e37d7752f8342167ff5c28589295df1583df01d1ab40322e7e9,38976988678
20180608,"PAYMENT RECEIVED",1264513108,0,fc7854dc4627ee1c27828557a6adb4956b13b7c14e2a32edd920acfbaafff615,138616824394
20180607,"PAYMENT RECEIVED",1257493695,0,57629af07f7403076bca1b99aebab52f486fcf9d60a04866b81508279765b8d3,137352311286
20180607,"PAYMENT RECEIVED",1256725283,0,031ca74195008911ba5e237b78cb6310fcb181bd33d0299e88b2fc1318d953f8,136094817591
20180607,"PAYMENT RECEIVED",1256942550,0,686fb6a93227eb85213dd326a2f6f03914d53b46b8cea2d32b16c03a37bb9949,134838092308
20180607,"PAYMENT RECEIVED",1251045778,0,a3d9aebb9453de8f4ac1644cb444b369d1ac6459a546c539b866fedbf6effd00,133581149758
20180607,"PAYMENT RECEIVED",1273031889,0,8f04a26b785dc5cb76e76d06c856ebb486c9c70e853fbdf82a29efcd39d1a019,132330103980
20180607,"PAYMENT RECEIVED",1259022004,0,99391d25b00664482c2ae3c68bb402d2cf9fb890e08e36e5888500952d0094ad,131057072091
20180607,"PAYMENT RECEIVED",1257087576,0,a69a967a882c26970bccf9f6674745d8d7cbabb4be342e402a94554275fbc710,129798050087
20180607,"PAYMENT RECEIVED",1254018789,0,488b45b5926eb9cfa599719147cac058e6ee58ced20e0a516001db22dd810496,128540962511
20180607,"PAYMENT RECEIVED",1264093833,0,dd67fba85659a7dcdb586f732b762a79691771b8f2f06b03613077b5de8d5ff9,127286943722
20180607,"PAYMENT RECEIVED",1273161600,0,0ba6ee0d7798d271307b6d2074189ab791832c1348fcf9d9c05670b1f16ce796,126022849889
20180607,"PAYMENT RECEIVED",1251230156,0,9d3f24b00a5b6aa87624ccb3e1852edd72f898ae84e4dc7463f6279d0f9879dd,124749688289
20180607,"PAYMENT RECEIVED",1252787877,0,79c4753e5f9ee41610df71e86c0f5947ae3234b80563799a4a85fbc73916ea85,123498458133
20180607,"PAYMENT RECEIVED",1259047312,0,a2c8f57443a7dde738761528207cd5f52d04d146a5fd29dff61db055b416b8b0,122245670256
20180607,"PAYMENT RECEIVED",1253846987,0,e81b46fbeed9107f9d7e93ee4c21a5bd779bf8c8b1231f56397539dee8c2c5f4,120986622944
20180607,"PAYMENT RECEIVED",1266535425,0,b29a690a9e7544fd8b1de69cb879e55b895dc943d80cb84aeb484e624800f995,119732775957
20180607,"PAYMENT RECEIVED",1251604771,0,cbcad905b25f7bbd5dcae726c8c6a7a26f6789829b6a73d850181f62625352dd,118466240532
20180607,"PAYMENT RECEIVED",1264065978,0,b2f4777a6178fdcb4deff569900ae666e473c520399403e17bfe4213e4788b75,117214635761
20180607,"PAYMENT RECEIVED",1253442603,0,c4f0612e12b4bfc0a287c385d01473d410139054c35699bbff870f810f317364,115950569783
20180607,"PAYMENT RECEIVED",1265476999,0,4dd77152117e95100d0d7e24f5e42f4aad22f5d1abba66a53d6a850e3adbc262,114697127180
20180607,"PAYMENT RECEIVED",1256117825,0,aa58c1f3e9596e55df3ca6a9cb1811232046f8a155edd5519de004bd826b5fa7,113431650181
20180607,"PAYMENT RECEIVED",1253744970,0,802ddb39eb2d668083f6eb41b28c9e3b7dc1f1e26ed5417e1f661f70f7fe0a18,112175532356
20180606,"PAYMENT RECEIVED",1253050779,0,18864ea569c0326738f8bea45f3b1f2806b02d7cc6ce21b8b6b9202773aeea82,110921787386
20180606,"PAYMENT RECEIVED",1252931760,0,7f67210148f395eff58d4bac7bb507315233b7a415785371ae82b44c9168a265,109668736607
20180606,"PAYMENT RECEIVED",1260720090,0,9876907f5e18961816dbad4831a94075450051a51d2e41c36db13e19e3deb0f8,108415804847
20180606,"PAYMENT RECEIVED",1270973208,0,c9a0c92ef3e75e7b3b52c2a4ab52d74a3101d8aab7e725af27040dff3bb6ad7b,107155084757
20180606,"PAYMENT RECEIVED",1258636114,0,e7d9ef9f93a0f672f6f1cf430e7c02ab545d3b2e5c89427655ebd7dc09d63157,105884111549
20180606,"PAYMENT RECEIVED",1263886165,0,f6670134bc4f1fdac4776f8fa16ebca6d39296e49de0da02c4b866ccead0f2a9,104625475435
20180606,"PAYMENT RECEIVED",1274192426,0,2ba6fb8712c8fa96fc397ec52e9ca82812ebc5ab2a5cb3e712129e9ad4aa72af,103361589270
20180606,"PAYMENT RECEIVED",1255393622,0,35052588218088701f5755a00f4cd0a45d1959a3b0dc4882e8576d7ce2ac4a5e,102087396844
20180606,"PAYMENT RECEIVED",1261411487,0,9cda3645aa0bf0a2037ae620c498b731581ddcdb382ecc6ef49ed3928b4bdd36,100832003222
20180606,"PAYMENT RECEIVED",1254506410,0,60035750176e99a094e5e367ee2051081d144899010064123484135efbda5dc3,99570591735
20180606,"PAYMENT RECEIVED",1251562865,0,8a12ec5002d8324cd39107fafd2fe6d8bf6bc60b05956d5bb69e0f2a759b07b1,98316085325
20180606,"PAYMENT RECEIVED",1258821306,0,861dde82392b54ebdcc7ffdf6dd0cde641993ac2260e172e493140424d7a0af1,97064522460
20180606,"PAYMENT RECEIVED",1257454366,0,c2ab65f95dba502c76f1b3e663530ae826d8ed26807c4c341a40e7a7d1d6669d,95805701154
20180606,"PAYMENT RECEIVED",1258467815,0,602ce15bc932c7fe0ab7f1c9312f0521b2af3f3c64a3c6a13e54941846b4bc01,94548246788
20180606,"PAYMENT RECEIVED",1254661574,0,d63d3f4bf4c5ff63b0c1cbf146080fb10de686050581996e5a383436a8eb53f0,93289778973
20180606,"PAYMENT RECEIVED",1283502803,0,09ea4a4e37e1daa27ee7dfa2b7d92f753f6fe70cb41325cf7cae98a658583781,92035117399
20180606,"PAYMENT RECEIVED",1252620105,0,d884a27c211d9dcad289476c50b103e03824138911b53e47094f4987344ee037,90751614596
20180606,"PAYMENT RECEIVED",1253844145,0,695752670e5d687f408fee2837cde7a59fddd4f0293c797759e1f1276f441431,89498994491
20180606,"PAYMENT RECEIVED",1257205490,0,38935a407881a9ec15bcd74fa3c9f4c3275490e4e7fec0c2d247248e4d5342d3,88245150346
20180606,"PAYMENT RECEIVED",1268305587,0,d36e87c598accbe8b2033074c42750e0c7852ed1f2a08d4ee3e79a961be51b3e,86987944856
20180606,"PAYMENT RECEIVED",1253307691,0,3ce014202e364d018c2c1cea152dfb2574af3df5e2c2561962430b4058d7705b,85719639269
20180606,"PAYMENT RECEIVED",1263185306,0,de4a25649dbe159f1d4f80dadd02d0714a371cebcaa39079ee15aa828b3ef00e,84466331578
20180606,"PAYMENT RECEIVED",1251334364,0,0cef48a07d1dd1b77ec5180b7def72b75235d7e3f531af6fe19a5dbda887f540,83203146272
20180606,"PAYMENT RECEIVED",1251913144,0,9ab3e853c67a98d7af8601bfe0e709bd8b01fc5d0f2e7b5669dc0942c5fc32c5,81951811908
20180605,"PAYMENT RECEIVED",1252262726,0,53f69242fe2b7dafeefa4372d33390fba89d138f642c6e8ee87a6732e3220719,80699898764
20180605,"PAYMENT RECEIVED",1255825451,0,7d0b4de4166b1a3d75049c5c218b47d16fa3e3430e51ba4c3f5e3a3c60b6d26f,79447636038
20180605,"PAYMENT RECEIVED",1274288803,0,3afcdd490b4b87af73173f0fceba87d587080e2900df331bf63851c18c93ff96,78191810587
20180605,"PAYMENT RECEIVED",1266722379,0,dcdb610bf4acc6494c867ed86a749d147245115038c87e67e22dac63000807f5,76917521784
20180605,"PAYMENT RECEIVED",1274742229,0,f106a8c5d20cdb0dc6cd63dfc8eb1ba8cbd4036347afd9dad42c4331a08ec5b5,75650799405
20180605,"PAYMENT RECEIVED",1282720408,0,36e64f7f88fb8cd78fd719f77445c62c344c1c503ca077180759f6cd2bd7de94,74376057176
20180605,"PAYMENT RECEIVED",1256755425,0,5b6e41b97213087eb374f1cd5c550bd391a19cb6b1b0e0e1bcbcc6fc7402f3ac,73093336768
20180605,"PAYMENT RECEIVED",1256273543,0,c61011b4360c51f9dc6dc147d75f7ec6c2c236103821688ec668b762b574f3c0,71836581343
20180605,"PAYMENT RECEIVED",1296013503,0,a2e7471f5f582586f21ce45757cdebfe130ba45811ec86d4efa4ccb0ee2cb603,70580307800
20180605,"PAYMENT RECEIVED",1260164798,0,6df54504c9f6b6a4c611baf025596c906c5402140b24dea8481ca863852c7c8b,69284294297
20180605,"PAYMENT RECEIVED",1252529707,0,b85cafa23d5353cc35d20f232ff183a678aa1561d1c992b2d9c8dda4a3dda876,68024129499
20180605,"PAYMENT RECEIVED",1311664866,0,2063d0eb732728757d634741104c65fac446fa863473e824da9a871827e5cb85,66771599792
20180605,"PAYMENT RECEIVED",1263326595,0,47eb971a0beb326bb4af2d679650caf8fec614145b89960daea6796c20e45cd4,65459934926
20180605,"PAYMENT RECEIVED",1250890174,0,f7b059e2599615d0ce750f72c1f16dd66afe8e56d7cb17092f2be3656220862c,64196608331
20180605,"PAYMENT RECEIVED",1265717394,0,18ece0ff6a1502047d23964d11c0d96224d57972296bbb28cf35c56b1439ac53,62945718157
20180605,"PAYMENT RECEIVED",1250620112,0,57839d5ee1a1ee09578e340d02771a16ffad2d3fe87254e100c6f7556b7f5bb9,61680000763
20180605,"PAYMENT RECEIVED",1255231851,0,95555f84953716f9da69a193eb6cdad0db91b0dfa475cdee3f43afa64d6ef9df,60429380651
20180605,"PAYMENT SENT",0,-98464981332,87cab709bf20cb070c0881d1ff48cb205c39bdb92184304c2f672876bec968e3,59174148800
20180605,"PAYMENT RECEIVED",1263590869,0,f0d99ea463d457cf3f0895346f1c61af4867d17eb0d52f97d36be6c229991ab9,157639130132
20180605,"PAYMENT RECEIVED",1257806488,0,7f4b9310f76070f4761f8cff5adad2fc8eec5a6dc06199ee1bb4c7cd69ed54a8,156375539263
20180605,"PAYMENT RECEIVED",1262121103,0,8bd2154bc64250e8e614979c6914b6e55a2db52d786792901c8e85160329405b,155117732775
20180605,"PAYMENT RECEIVED",1251548840,0,25b0255f537f227f9e4cd7aa3ee5d9bd3c5bfe4a78230f44a7b81d90ddb77c35,153855611672
20180605,"PAYMENT RECEIVED",1258888277,0,e143360b9f6123910ab5e38f1e5b0a3042410bcc4d4e702849f4a5eae9dbb0f3,152604062832
20180605,"PAYMENT RECEIVED",1269585876,0,8cbcb0f8b8c03551f26fca7bedff685f7383b29053934c7ce421e0270c60cebf,151345174555
20180605,"PAYMENT RECEIVED",1250541385,0,2185d3e49fd88902ec0e6db642394057e4e0af34a2f9a32872296b58012b48fb,150075588679
20180605,"PAYMENT RECEIVED",1267026177,0,511cdb155a878d52171e86fc0f4784337e5511b20c5dae153f362eec02cd865b,148825047294
20180605,"PAYMENT RECEIVED",1252361834,0,af06c39bb8cdf461271ddbc2014e651336bb2b1948e9134d02ffb4607b00daa3,147558021117
20180604,"PAYMENT RECEIVED",1264337922,0,8f90df69440a979559f74ac81721490b29ff35fbc397841cf55409d18e5cdf83,146305659283
20180604,"PAYMENT RECEIVED",1256638584,0,c88b4a69c80caf1751d86c5c2090d27dc691b2cdd78ea71b8a8e779c196c14e1,145041321361
20180604,"PAYMENT RECEIVED",1253351659,0,df21548cc05032e58633838706e6abc41808e281825db932e5feca4c71028fde,143784682777
20180604,"PAYMENT RECEIVED",1262125659,0,232a62a51b2b052e23f4f1ce9a5e4329748b62c453eb50ea425bdb2e7624ab52,142531331118
20180604,"PAYMENT RECEIVED",1253890774,0,699435468f7556371078ab5d7e653d96c30aff98915c74bf0da9a0ec81fda481,141269205459
20180604,"PAYMENT RECEIVED",1292452913,0,a7e769119184fae400e5489b6999bb2f0e99dd8aeb808a63c9ec42aa9dd91782,140015314685
20180604,"PAYMENT RECEIVED",1256960547,0,27f5ae40f913e23aba72f06543a54697f638978a3896049f6582dc97dade866a,138722861772
20180604,"PAYMENT RECEIVED",1257845977,0,19f9175bc38238535e4c570d0df1e3945da7432bdef8ebfc3b607fe3f0ba8093,137465901225
20180604,"PAYMENT RECEIVED",1272353657,0,7a03f37051866c451e9f83c83a8b9aee673b4d4e363559ec72a6ced526912c72,136208055248
20180604,"PAYMENT RECEIVED",1266483922,0,f23e3ed55e901a951622fd895265c2f21e70fc08cbf80af4583b95f38e6cac0f,134935701591
20180604,"PAYMENT RECEIVED",1262016255,0,0c0e3bee8ba90121375288cf4a6d9fa992d5c3f22cabf7d1b9c3637fcd985298,133669217669
20180604,"PAYMENT RECEIVED",1268085995,0,6a48173f8c05d90e59cc856ed4b04e529dd09d7f23b75a50f341007eba35b008,132407201414
20180604,"PAYMENT RECEIVED",1258152462,0,34907f5df20f0fdc46fefc3de92344ad3758b345e53a72eda496ab84db632064,131139115419
20180604,"PAYMENT RECEIVED",1260376192,0,4dd7e0818419320a0b74b5241ce1908f2f6c17d970faca2aa95204513fa504db,129880962957
20180604,"PAYMENT RECEIVED",1256028989,0,18a9c148e03329780763d8966cf0437fa8f11ca0d56fe2bd67ef499bc12fbab3,128620586765
20180604,"PAYMENT RECEIVED",1261486332,0,cbdc27525d8360f928896b465fa35986ea9ffb2b090b9fd1463f05c01d01545f,127364557776
20180604,"PAYMENT RECEIVED",1268061020,0,c85134ef2f5e8b79365706f1b25e932da85599abd0b9787eacc91cb08ae33c61,126103071444
20180604,"PAYMENT RECEIVED",1252323356,0,1345f11e4cee212c0b2437f16d63eed4ba2ef3093d1d1402de4e9a310212794a,124835010424
20180604,"PAYMENT RECEIVED",1252013632,0,0e3d36bd042b09a403e7b9a11e7f6a630b331bb3c501ca44d244892d9eafae42,123582687068
20180604,"PAYMENT RECEIVED",1256550596,0,1ee5309bc8cbef522ba15e52e4a694732283b1baa7965f6871daa95bd201d678,122330673436
20180604,"PAYMENT RECEIVED",1252477653,0,99a54b92da8803d2dfab372156d399e5439ad9172b90056fc77aa2ee86257022,121074122840
20180604,"PAYMENT RECEIVED",1266824194,0,879ce4a54e43542273096ae58de2ab84b073ebb8337fd2abe5d2bf5f1941e86b,119821645187
20180604,"PAYMENT RECEIVED",1255685460,0,033dfc0801b6e45c15c39fa02893353cc1976397842ff9f61af3dd0f586c824d,118554820993
20180604,"PAYMENT RECEIVED",1279718561,0,8b3eb92401b34e3f1d74a69da500e63a7dfa1675a2e338d5d203702e69ec83ef,117299135533
20180604,"PAYMENT RECEIVED",1256096310,0,97f49604937294864a952f32c7eae271889ebb15b738512b6b53d76f0a9b8ac7,116019416972
20180604,"PAYMENT RECEIVED",1251495880,0,600f1e5ba02af50a89934e478cbe77ffc7ede7a46f2979f837e7dd642b0808d4,114763320662
20180604,"PAYMENT RECEIVED",1268815619,0,88f0000c929f2c2fec617989e5870afa1a3ef5f1acd3a6c111404476868eb885,113511824782
20180604,"PAYMENT RECEIVED",1256785428,0,524f5fdbe890998bdf53c707dc5e6a66f04d878b2236fc20df907736c9a3d489,112243009163
20180603,"PAYMENT RECEIVED",1263397071,0,8c1d8aef1bf1dcbfb27ab4af0a598b7d601291eaaba3d2d44294b00e225ee78c,110986223735
20180603,"PAYMENT RECEIVED",1254743819,0,a9fd33768c51dce4760a577066cdde3ae0ce1a70baf9186a0607e7e90c0d7d41,109722826664
20180603,"PAYMENT RECEIVED",1269087966,0,2751bb63f1b6eb1799956a54bc7efca4290d6a8a315129bd4af5e110689582b9,108468082845
20180603,"PAYMENT RECEIVED",1272408174,0,fccde8689151bfd1851928916d33f944df036538422af52b54e73a9556a4e1ba,107198994879
20180603,"PAYMENT RECEIVED",1272365053,0,ac9a369250ba6ddbe4e3620f9f8d72d2eccb6f6b3c5650c1cbe821c4fd885d65,105926586705
20180603,"PAYMENT RECEIVED",1276449118,0,e625ab58b49162868ad3bcccae73ad18ef35f4abacafff067980dce6a8b83a99,104654221652
20180603,"PAYMENT RECEIVED",1254176800,0,cec2b4bbb7517929d6da307efef1e4ef94ca1744cbf9fc924d458d78d1aebe8a,103377772534
20180603,"PAYMENT RECEIVED",1253236636,0,4a87e537a866cbdd4ae62e0c675db1282e7cced2ef4a4d01415ca48f5b1d866a,102123595734
20180603,"PAYMENT RECEIVED",1254573872,0,0f408e8bbac893f32d36de3949470476ca55b952ad0dd8703aa75b7b022f2eac,100870359098
20180603,"PAYMENT RECEIVED",1253945114,0,2c6bd74fa679438249c0b0f5b818c484d986fc7ab8188717ee1d18d0b47fb816,99615785226
20180603,"PAYMENT RECEIVED",1255192914,0,5bd7242fa91c15ed57b67cc9317ff393a1220535e6ff327b5c8e51701d5485f6,98361840112
20180603,"PAYMENT RECEIVED",1258693996,0,31ee420ac335578189aca2b33cd1fa8002321393531e98296820033e18cd836f,97106647198
20180603,"PAYMENT RECEIVED",1254154939,0,56636ff2146ab6aa660efe0f9fa9bc0b6923f670c56165aabe8bca7435ef18b1,95847953202
20180603,"PAYMENT RECEIVED",1254270213,0,98db69e4597b975938958550d02e72a264d7ed6bf8eef5eab93bbe2ff5ba129e,94593798263
20180603,"PAYMENT RECEIVED",1274966155,0,1849f582f83177f500bc67e1277a09dffbaa7d27d82a96b7ad8c2f936944adc2,93339528050
20180603,"PAYMENT RECEIVED",1255651804,0,d582b1a05543c8a1db0fb6aaf070ef8e9ff5be30fa9c4efef1d53f6770dbb646,92064561895
20180603,"PAYMENT RECEIVED",1251983730,0,272d2db4ca2a549394348a664a7e80a098ca1f60a9d1e5f4756e01b4527184da,90808910091
20180603,"PAYMENT RECEIVED",1259629846,0,a5be678450e36cf1cf5bbb7af8a3c71611101b67f4bacdf5ec4a6154aff3c545,89556926361
20180603,"PAYMENT RECEIVED",1255286674,0,b4f22842c9426d28f49a605add698303681064dbaf08ed19635389dee4ec77be,88297296515
20180603,"PAYMENT RECEIVED",1251716566,0,08c56c19aa06ba7881ba6f72b43806b15fead20121a3510a0ca8c3d8bf61f75d,87042009841
20180602,"PAYMENT RECEIVED",1259700533,0,38daaaa84b61626246e42d397a7d016478f78f9da182c6e320d2c01a5d39b794,85790293275
20180602,"PAYMENT RECEIVED",1278582811,0,46964e870f457681d1e40d129fc1390ffe9eacb2e71e29991d2fc663eac6c8f2,84530592742
20180602,"PAYMENT RECEIVED",1250111340,0,08e73becd2352341bd52a549c6afe88f61e53c39dc3e13a2e9230825cd1bb1fc,83252009931
20180602,"PAYMENT RECEIVED",1253772856,0,cbee04b3b13f91eee6c80e938d433ab85755e5141b8eee87cd614e53bcee2a06,82001898591
20180602,"PAYMENT RECEIVED",1271179725,0,ffc7ba44fb338282d6ce2de36e79b19bad54821625b7e05fbc9cb584ae3001b6,80748125735
20180602,"PAYMENT RECEIVED",1263453174,0,1b24fedf071c6c839439e81d9f00e4761ce4fd94d1c0392d19de171434139706,79476946010
20180602,"PAYMENT RECEIVED",1265832914,0,d161b549e0b19a5c83c4981a741041526df1faf88f59774ca0a151c23252bfee,78213492836
20180602,"PAYMENT RECEIVED",1250626840,0,0f9925473e244ed2278cb49490ae2bbd9e86febf3dd0c8d7f9ae8534c298b4bf,76947659922
20180602,"PAYMENT RECEIVED",1261211450,0,6565483aed7b0c746d4151f18156843dda123f88432e9c758fc65b80809f33cf,75697033082
20180602,"PAYMENT RECEIVED",1250371722,0,5e9e4fa7447f07a3d2ef884b07e168d69efb260f6cb6ad28f13983239ecc7fb2,74435821632
20180602,"PAYMENT RECEIVED",1273989347,0,286de4ae80297147ec49c830ba8cb0d4fc9b954d25ee2e3ad1daa1d506943c57,73185449910
20180602,"PAYMENT RECEIVED",1268620681,0,6cebb20a8371fa70372cc93c4e9700dd260087c94a01fc2376dfb894771adff5,71911460563
20180602,"PAYMENT RECEIVED",1250302864,0,7f647209c0cad95004a89983f3650f48e40c16e48b97fabb78a015cd3a067069,70642839882
20180602,"PAYMENT RECEIVED",1252222204,0,0096daac49a10ccf04dc215f6a6ddcbc0168cbc6a4b7a74bd67cdf5bb2af1899,69392537018
20180602,"PAYMENT RECEIVED",1262776243,0,868a7b5617e3a8569ac65b8344954df92857718ee7249669e70f2d66a37d4f29,68140314814
20180602,"PAYMENT RECEIVED",1259483879,0,c34cc48f13af2bb2af21b02810c6601a3c5bd0562b223f0962f612dc07527030,66877538571
20180602,"PAYMENT RECEIVED",1253453475,0,c260b39a6d1e5c2275b744064c95cc4a88c3ef7088850300cca5b48203878665,65618054692
20180602,"PAYMENT RECEIVED",1250000000,0,a2b91df1b58d40a9038ab53e5fb7073e9ee0583b79cbfdfe27379fa5868980dd,64364601217
20180602,"PAYMENT RECEIVED",1258344855,0,f69920d88f596ac4681a07c11f27a3d2801cbe8f3bae74deac0ca90c9828729f,63114601217
20180602,"PAYMENT RECEIVED",1260698213,0,d30e4058126e00b871c4d2b54bd80dcd57a448fdcfaa5b6116c72771deac9b1f,61856256362
20180602,"PAYMENT RECEIVED",1253526908,0,ddeeebbfb31799a9805d4a86d00a75c8cfa285bf6a5213ebb0d82a495b827b37,60595558149
20180602,"PAYMENT RECEIVED",1250526867,0,920b7d95852e10bde32c6162080ae1ad410cb8972ed7893a64d5ae5d6469005f,59342031241
20180602,"PAYMENT RECEIVED",1264043120,0,76dc606d958ab9fc60e6287b86f0e20fbf0458050f60b7ae7ae2c43f37d9d2c2,58091504374
20180602,"PAYMENT RECEIVED",1256441718,0,5a018625b6de9a43f87da5e6314f155dc51f770e681c3f1e2829f42705631888,56827461254
20180602,"PAYMENT RECEIVED",1253109262,0,008e2d0727cf98a60d6d4808daf80532b2b0e6e03dc9fa443d64c75ecc5c1921,55571019536
20180602,"PAYMENT RECEIVED",1255358797,0,e15d0fb7a0d34587cd2e9b8cc5faacd798a4ac8ff42d88f840f13f624755a2c5,54317910274
20180602,"PAYMENT RECEIVED",1261651743,0,3b743042a514d226b4420a7b534de7f52d3cd44064ff0845fdd8ed3b812d8611,53062551477
20180602,"PAYMENT RECEIVED",1255029822,0,c6ca528bee53b585b0293277742f3eb1302d8a855da62526c23614495b92252a,51800899734
20180601,"PAYMENT RECEIVED",1254846649,0,15466fc636f956ba2344228a0aa1c2b13162d925a7e856319eab7bb99e7fc317,50545869912
20180601,"PAYMENT RECEIVED",1251750785,0,d3f35268fd89c3a5433d84e544334efdf2e56684bd841b90e908b37637e8fe15,49291023263
20180601,"PAYMENT RECEIVED",1250411053,0,e3f0688e8687fd96c38a05985f35fe4dc93f37c27605f1ef5808c3211390bde2,48039272478
20180601,"PAYMENT RECEIVED",1265225504,0,d31bde9c071bd8fc0f3671f8445e4cd17b8dfb4c647cf592a52d881e0e73e650,46788861425
20180601,"PAYMENT RECEIVED",1260404596,0,88030bcab1bebd4620fa510ab300b5f4fa12c40d09b7f30dc83c846500dcaae7,45523635921
20180601,"PAYMENT RECEIVED",1274068207,0,0504231d4d6cc91dda3b65f4e4891d3e0baf0ed5c8812e1e05a53a01e75d4505,44263231325
20180601,"PAYMENT RECEIVED",1261413876,0,50526b041712d56bd6b08ab3351bfcbc56a053020a512f6515a4409c39182941,42989163118
20180601,"PAYMENT RECEIVED",1261565745,0,9718620cd5dcce5151cdaf64e468803318b951236e0fe9f781d087160925982f,41727749242
20180601,"PAYMENT RECEIVED",1255702400,0,4ad9b4cb7f2bd35d6c94fdc31e8dc892a21107e2e0959dec2ad2eac7edb41077,40466183497
20180601,"PAYMENT RECEIVED",1296286232,0,dc01f8d35d12f18e61310d72071b7a6490e887236ff6c128940a4ceb0550e690,39210481097
20180601,"PAYMENT RECEIVED",1261277985,0,35f9b778f25d6493ab59c603dfc0205241c38b2b0db5bcba50f2995709dfbc45,37914194865
20180601,"PAYMENT RECEIVED",1289615100,0,6521af39f0345776b035fa4933431a4fe99ec8d4b478e8c64262e78bb1e792cc,36652916880
20180601,"PAYMENT RECEIVED",1277212044,0,8fceac05bf129e0a797d5820923808f77a7d596dabae2545b32f2b1980323c53,35363301780
20180601,"PAYMENT RECEIVED",1253262328,0,76f01ff875db391fe7b154a704ca58cbb1ff1a89f9be747e552313bffc48d0ff,34086089736
20180601,"PAYMENT SENT",0,-96534479206,a7ac2a5c4c5ae436b04549ee186faa89dd1cdd9306c7686f4fc28884b13e2174,32832827408
20180601,"PAYMENT SENT",0,-50268018796,2c6423908e5667e422e910031e90dba91cc50e45469ecd98d02c15934b964f3f,129367306614
20180601,"PAYMENT RECEIVED",1264991626,0,8b9bbbd67d4c2ecf8bc38ba277b93b720f2b12f477b53fb01ae5a8cc2a1b6ff6,179635325410
20180601,"PAYMENT RECEIVED",1307825924,0,2f28e441b4b6fcc81c4fad5c4b4c950679c3c188267686bfa5c6cc53d3345c56,178370333784
20180601,"PAYMENT RECEIVED",1251413846,0,75c50943389e7b2376491149e602b5d6cd6476fbeedcdd3d6721f6eb03510a40,177062507860
20180601,"PAYMENT RECEIVED",1259101147,0,8909cf016bbcde841fc0dafcf75e5bb7107546caa3f4bc22920fae0b4d055640,175811094014
20180601,"PAYMENT RECEIVED",1252685992,0,842dc75510ddd615dcb83c4517db947879ea2a5055d42f22e69d47c322b011b1,174551992867
20180601,"PAYMENT RECEIVED",1265953130,0,23b994469191d0762d6e72ca066047484ebb5e06ddb1b86bc9dadd0fef9d38d9,173299306875
20180601,"PAYMENT RECEIVED",1261290011,0,094e25a96b630db86da9e49d59eb55b1f2e21b292b3a46462eb8e376cebe8489,172033353745
20180601,"PAYMENT RECEIVED",1256438716,0,2beeb3f87c51c0e20fb5d36383e1b22c6d2c8eb214f98e7a7e6521f2df0f5740,170772063734
20180601,"PAYMENT RECEIVED",1250741469,0,0eb83be01b10a7e474592a03739e02802f6e86f9478c6dc9debf18e70dad82ca,169515625018
20180531,"PAYMENT RECEIVED",1251752715,0,f98aea2761eef15e5a94a895da0d947dba13edeea5f9b070e7f6b7b3ac42497c,168264883549
20180531,"PAYMENT RECEIVED",1264238600,0,f04172e799aa38a565fc6abd154eaf8a00c8fbddd7602fda35742bf7837bec82,167013130834
20180531,"PAYMENT RECEIVED",1258305888,0,6d4d8a57a75afe966a08c42dc959e9293934711b1299d5b6ccf0bfe23230bacd,165748892234
20180531,"PAYMENT RECEIVED",1256679023,0,a6346a4d73410ccbe9acb91cc3d60daa1e2593f44b9c05f7095a6528000a7448,164490586346
20180531,"PAYMENT RECEIVED",1270984168,0,df6f533d354ae109ded5e37f1aac71f2e6b9b6b5ae9195d3fc0486b005c65eed,163233907323
20180531,"PAYMENT RECEIVED",1302575317,0,29a210f449bc648bf1e85bc82af8c518edf16afdec8b9eb48c72161b78f7c651,161962923155
20180531,"PAYMENT RECEIVED",1259741279,0,b9328ee2aa5a471d20b8c7d501c856f319f4f13c11ac2f339bfb9ec81569eb5a,160660347838
20180531,"PAYMENT RECEIVED",1292112117,0,4cda8187eacd8515be0f2f965fbded3181a50b3e3366f6f0f7959a8d1858dd61,159400606559
20180531,"PAYMENT RECEIVED",1264460129,0,2edeec582982631801f7245f20b94a54d286c50a9782ad3ca73f19a648d6e7f1,158108494442
20180531,"PAYMENT RECEIVED",1255934199,0,39d49a17784805920ae749059ba8e4bf5ed741e4fa7b4a78246e25363fc898f0,156844034313
20180531,"PAYMENT RECEIVED",1252441815,0,008a5281b281a6b71d08ab342f55a79c8cef977626c7d9ca4f5e4c003915008b,155588100114
20180531,"PAYMENT RECEIVED",1263873851,0,63ae9d54cf1168b313c20564942485ae1a8ad8b6995bb666d587a7930856dd8e,154335658299
20180531,"PAYMENT RECEIVED",1250000000,0,d3a5eb43fd1c505a88296afc9a315204b0f55d1b3d6b5d55f5354b0192a115b2,153071784448
20180531,"PAYMENT RECEIVED",1250505945,0,1d95f30d8be60323df30b06b47b584e38750847ed85ebecb1c14d87289482e44,151821784448
20180531,"PAYMENT RECEIVED",1287412771,0,d6c03d830f31a9b77dab89543a5dcc7fe6b32380c31666ee46f17b96c7519314,150571278503
20180531,"PAYMENT RECEIVED",1261139324,0,26e4f4d197471e131557f6d69521f12cea5c918088eb8380fe51961cc0b39d6e,149283865732
20180531,"PAYMENT RECEIVED",1263214232,0,eed1174c7d65171dcfcbbf41b84aba76b6adc616527e273004adf3f870aaa4f3,148022726408
20180531,"PAYMENT RECEIVED",1274343799,0,829ce9d0f8a75bd49a8649a6193fafaafc4a0178d5befbc6f075c5080c17fcb4,146759512176
20180531,"PAYMENT RECEIVED",1279814698,0,f7f497b4e9bb9f6eafae300a16c7daf9283558ca8d57f8649c04fc346e7f6665,145485168377
20180531,"PAYMENT RECEIVED",1272935767,0,793d0cb9e25595dc6a017df2a59080c034ee14420bcf3eda454a24dc29510a0a,144205353679
20180531,"PAYMENT RECEIVED",1261365981,0,3c28634038214ca050edea3d73c67138c86c61fa95a1dfbf55f4035a323de2ec,142932417912
20180531,"PAYMENT RECEIVED",1251026612,0,7368f4af1d6b74ca3c2b5387c8f378c4a7d630ad06d3c1ce6f5f949b473d9298,141671051931
20180530,"PAYMENT RECEIVED",1250584894,0,6b749a46ff974043eaf8079ffd36b5abf82f6aef28f16dfb38123ab0f1a8740a,140420025319
20180530,"PAYMENT RECEIVED",1258882739,0,c5c2ff98a1865c0829f18879aa89bf40904f6ec576e7c12d51241286f2af4172,139169440425
20180530,"PAYMENT RECEIVED",1264546581,0,0074d1de719875674fc714e2bd076b23a912963f7f229790885a7558551bd1a9,137910557686
20180530,"PAYMENT RECEIVED",1252533014,0,64f1272f53f3d6c2c619f605ef9929452f1e7b5f3afe89ecf6fb301226e029be,136646011105
20180530,"PAYMENT RECEIVED",1264809827,0,30b6b465e7ecf6788b09ea5e606db515d1fe94ced73ce522554c9a9a8726cdd8,135393478091
20180530,"PAYMENT RECEIVED",1251532072,0,5c8056250d9d561aa75a06cbd0eec53fd996ba5f2f712f9907771b9bb00f861d,134128668264
20180530,"PAYMENT RECEIVED",1258563086,0,29d754d9c82abef33fe59d425878cf05c371c3086619e673c3bd2c0dd129932d,132877136192
20180530,"PAYMENT RECEIVED",4626,0,6a4a30cfe28c998d15523226a0106d39f736e93279e927da9b8bd676e18bafbc,131618573106
20180530,"PAYMENT RECEIVED",1263175340,0,bc27ec9d1ce2b43ed6f79d647ced0d0270696f1e78e61d462852a0c486fb75a7,131618568480
20180530,"PAYMENT RECEIVED",1257571683,0,e4d94932b1583d333370f2435b44e0da13bfff21abdb9b3225cfe8e5a89dee73,130355393140
20180530,"PAYMENT RECEIVED",1263508740,0,6377d4e0822e676c4775bf50a16cacd55229d618f90a2758775af9ab6d592ba3,129097821457
20180530,"PAYMENT RECEIVED",1268838093,0,7099777d2cb97cc1f8048071476b035e5e2b32482ef18d23497ba9189d903beb,127834312717
20180530,"PAYMENT RECEIVED",1258400145,0,ae0d043907f6f4388aafe835e7b01d6034d01f14e6d3bb8c94adf15787f69c46,126565474624
20180530,"PAYMENT RECEIVED",1258190189,0,0bcf7a005388a0726892d07db3397bbcb54b74137a9b625b0936529a076948e7,125307074479
20180530,"PAYMENT RECEIVED",1285872817,0,2704769a7b60d8a2d8a13ef6aa3f05dde396f0fa82a020c0ac3c1c0757d9ec66,124048884290
20180530,"PAYMENT RECEIVED",1310083456,0,c24c89c5c6c9c68584c8a0e102f366cb68e84b9a533ebd18123ec7c371b50a57,122763011473
20180530,"PAYMENT RECEIVED",1251572433,0,5e9332c579c55fb610f37edfb54c27295728303ebf08a4350caa9e356e54cbd1,121452928017
20180530,"PAYMENT RECEIVED",1275759729,0,0c4fdd08cf824fd4d3eb6784eab2b2fc197d26a9c9e681f101c78e303ef1d707,120201355584
20180530,"PAYMENT RECEIVED",1259701421,0,920e6b5eb9e0d1ee7fecacec75846a35cf48693b82ff2a3fefa306f782f3f700,118925595855
20180530,"PAYMENT RECEIVED",1266701803,0,44ef8fd16dc255db900956413721a6d1d537636ef5a59be31c43d9abfa65c2c0,117665894434
20180530,"PAYMENT RECEIVED",1256054426,0,45e3206e84431e5cbdcc5fc256f516107f26fab7cd1915ea63e357dde5a1cd79,116399192631
20180530,"PAYMENT RECEIVED",1280163853,0,cd7b9c933dafc0a1f59a751ae8429542af1a924e0d5d4acc8db184c4d37e578e,115143138205
20180530,"PAYMENT RECEIVED",1263989528,0,77b901d7f4f861e85f19a0219e2eef3f574b3a958b7fc0ad734d9355f4a1a907,113862974352
20180530,"PAYMENT RECEIVED",1251975267,0,2f73fcfba73af3382eb5ea0861abaa0c2ccd780ecc13332dd2535c93752b9280,112598984824
20180530,"PAYMENT RECEIVED",1266227816,0,6330d91ed45fac2a95c74942e85f8721b6cc8a0ac6fcf82cef272b4960581a7e,111347009557
20180530,"PAYMENT RECEIVED",1278163300,0,4a5580fba4488c5b65caa8317042aad57f60b124385d711238afe52838461263,110080781741
20180530,"PAYMENT RECEIVED",1262309965,0,44db8293d457d6318a0b2f761b2b7b57c5a6a0dff9a7c26f1c5f3ed97f9b2efd,108802618441
20180530,"PAYMENT RECEIVED",1252092311,0,9b707c97dec10f2477de2f0c7678f8c6bd9dd7df31c06567527a08a82f708f69,107540308476
20180530,"PAYMENT RECEIVED",1265489614,0,6d470f6f20c0140d11cbc05b2daede29c39a148c32412a0b519f845e9f40c6f0,106288216165
20180530,"PAYMENT RECEIVED",1253617515,0,1e76bc819928b868543c9308ea8081464ab820f70ad93ebc620a0d14545e4f64,105022726551
20180530,"PAYMENT RECEIVED",1266782261,0,72d5005cee0c0a7aa94abad3152807e355de6690485f691ec40ac19b1ed13cfd,103769109036
20180530,"PAYMENT RECEIVED",1250756067,0,ce40b37c152a6f99d30fe833cc7ada7eaef885d0013231ca2237f8cfacceddc5,102502326775
20180530,"PAYMENT RECEIVED",1251233359,0,d11a0cc26d6152f64e67944f239b544059857952eb3a83bac264c197d2cfedbc,101251570708
20180530,"PAYMENT RECEIVED",1257949854,0,97d1176d19e1328f54c3da0793072b05f8c80fba9f39ec230370a0ddb166ba4d,100000337349
20180530,"PAYMENT RECEIVED",1263954981,0,b711ed8cf10598d52c86b2cf4ddc576484c0240086d9435dfe2d71d0847101cf,98742387495
20180529,"PAYMENT RECEIVED",1269258664,0,67b37504dc3fd0bb885ae69cebf8418ebd1aff0606a3640ef5b1a4b910455468,97478432514
20180529,"PAYMENT RECEIVED",1253279129,0,d5288d5a34700bfb572073ca166e48ca04eced5d98c20ab48710b6c8bca34aa7,96209173850
20180529,"PAYMENT RECEIVED",1286317841,0,7db502341d7e989c2784c1eff0548e3e0ebd65e91c52531e6b090250a996901f,94955894721
20180529,"PAYMENT RECEIVED",1275792290,0,ad985d58a9bf6272fa4f821eb962a0ac8613bd3085dde2fd1eeab2b68179ee01,93669576880
20180529,"PAYMENT RECEIVED",1261661320,0,c76ca7d238054218878e8f82b0a017dfde4d46ddc81d500a73bcc46cef8c555a,92393784590
20180529,"PAYMENT RECEIVED",1259064993,0,e84224c4764ecfef7fd4fba05ab0dc861edeb605b2e218321ead97403ffff52e,91132123270
20180529,"PAYMENT RECEIVED",1273373078,0,cd258ff4f344e8ebdccbdf03f9b31313b7e6f46abc2e98cafe0d75057f48d940,89873058277
20180529,"PAYMENT RECEIVED",1285927714,0,b0896ab9832a6d69fa51547da96130ab22f9fb02f16c7b2b102faca3cd99ae18,88599685199
20180529,"PAYMENT RECEIVED",1272096325,0,5a1b6ae5012b4fa12d04a1f73a27e057adf592fa9aef8d048da0d0f95dcc6b93,87313757485
20180529,"PAYMENT RECEIVED",1279815376,0,9a6fc01cf8a36735b242655b9ed8dd88bb01f572b976564ef88e4c22785ebef3,86041661160
20180529,"PAYMENT RECEIVED",1268155456,0,c0f50fe15db7133b111172eb9d359933ccc3002d18159c77ce8b41513e217378,84761845784
20180529,"PAYMENT RECEIVED",1289855688,0,c3fe86605fd70ecc2b113fc9a40b63d00a2b675af709979e87b545ddf6471232,83493690328
20180529,"PAYMENT RECEIVED",1313444209,0,d48f60b4f21db7de742810837c7986e3a84e0e92d39676a1081b150a0593ccbb,82203834640
20180529,"PAYMENT RECEIVED",1272776692,0,d4b1411da80829babde33bdfffed68d638578133b0a661f955fca07a23024295,80890390431
20180529,"PAYMENT RECEIVED",1293087445,0,41901c07393c6e5afd81a4780dec2f985e0eab46827055b8e5722427c3fb297e,79617613739
20180529,"PAYMENT RECEIVED",1286592213,0,bdb2edc1c438ea008800e549298b0ab5ad1be419d6e0f599dc74f821500d7e1d,78324526294
20180529,"PAYMENT RECEIVED",1317472489,0,de4f421360c93cf96291201cd631fa0015c83e4f8215d76b73eced7d53102435,77037934081
20180529,"PAYMENT RECEIVED",1264917394,0,b91882fe80ed4255b6872d6018901e24d0feabb78408847e472992c030e9cd23,75720461592
20180529,"PAYMENT RECEIVED",1252613336,0,aedb9583c2ec56c6dd6b9b766569c6e844426f34718f44d45aaf34e3c5046ec9,74455544198
20180529,"PAYMENT RECEIVED",1250699355,0,62f5818773435504e3cea130b84b254b9addad7c1658668eb0d65dd9b82dcfdb,73202930862
20180529,"PAYMENT RECEIVED",1252590274,0,7e179f1f4a8023d32e54b2bdf4bc7c089bfa708f6d5befb89ea82779838e38d4,71952231507
20180529,"PAYMENT RECEIVED",1266673058,0,8c37cc6860c09ab528f795fc661d9dc68ac1cf742ec9873cc3870c9e061d3fde,70699641233
20180529,"PAYMENT RECEIVED",1253526369,0,e605919bc52cf8b48a47e9f5f031f01cdd21be5164d4aa17518a2389f11cac7d,69432968175
20180529,"PAYMENT RECEIVED",1277553169,0,f785b0d7af9d625088731ea79a4d6022d61db990baf39dab1e288a2ac9a54c64,68179441806
20180529,"PAYMENT RECEIVED",1257682616,0,dbcdcabcf5b3d786e5ad19632a04be0866443e062f34c5a4b8c3c78676ff349c,66901888637
20180529,"PAYMENT RECEIVED",1300870578,0,ca958ae6ed0a805035757f76723e41fd81d3f50e4f9e2621d6a406adbe8527fd,65644206021
20180529,"PAYMENT RECEIVED",1255612624,0,5672dccc92f371455d4cca3c328f010989a39c185a59ca468905a5b70adf47a1,64343335443
20180529,"PAYMENT RECEIVED",1251703015,0,3c8c88ba5e15101d01849f84946fee6e613424b06b7225ee7e33152f1290d08b,63087722819
20180529,"PAYMENT RECEIVED",1270781328,0,3a692009fddb258aaec4a489fad06533b33fd4e0f5c88d54fd9fea71c2836246,61836019804
20180529,"PAYMENT RECEIVED",1286848908,0,92b8c13b1bdc0ae2fa154f28abed2d5c53fe12dfa88687dac82387e266695307,60565238476
20180529,"PAYMENT RECEIVED",1256609657,0,37b3208353ffc41e5bef7e3230dbac88104ee2ef0db6641e74ed359369a1fdd1,59278389568
20180528,"PAYMENT RECEIVED",1261459605,0,be6c79189ad7449886d9a158cc47f0a3069fb95900ac385625426a94e0ee3292,58021779911
20180528,"PAYMENT RECEIVED",1261102491,0,c75eb8a72508361cc7c006071aad5131a4926a6a7afab7608e9572b7fcf6a40e,56760320306
20180528,"PAYMENT RECEIVED",1250414651,0,8a11edf38f1284102f3696dd75a3be51da8e8f55f651f27428eaa3a7d6429f15,55499217815
20180528,"PAYMENT RECEIVED",1354462920,0,454acf3250720220f95a28791a483b04c9166ac06cce64974435a3b81bed3601,54248803164
20180528,"PAYMENT RECEIVED",1273326758,0,3fb975bdf5465332ae882dce96da6b64727fda9143fc8117b682fa5fc16b347b,52894340244
20180528,"PAYMENT RECEIVED",1284167753,0,b919a05f48ecc6e3179ced4ee8bbaeb47df4f01a4ec02790722b2aa54991ff3a,51621013486
20180528,"PAYMENT RECEIVED",1268901316,0,37a8b2f36adc039b76f0fb19902b77513f2f925cb4a39b597e3f9912bae5fe70,50336845733
20180528,"PAYMENT RECEIVED",1260472513,0,656360fc48d181272ff3ca3368072861da89dfc510e6f85c713c430415869224,49067944417
20180528,"PAYMENT RECEIVED",1278722597,0,bae7058b64fdd8fde55717d61e5ce99f962143adba8d8b96e7796d9a59c1ab0e,47807471904
20180528,"PAYMENT RECEIVED",1269542485,0,5269a18e34382b296ae0fe76960f1e3960b11861db7109e6e8a5ea1432413895,46528749307
20180528,"PAYMENT RECEIVED",1261356089,0,70465d116b611a9c63acf4ef4c38a631271abad50ea1e509165abc437cba8d3f,45259206822
20180528,"PAYMENT SENT",0,-100285462386,34450c593f8d6ae7ea0b3f3c04579aec97e92261e1bb54e66b3d0cc4c56dee08,43997850733
20180528,"PAYMENT RECEIVED",1250440346,0,c0fa247773dd96212d9e0fad69c9587c4890c59e012c974e0af983679e1ce801,144283313119
20180528,"PAYMENT RECEIVED",1252407272,0,2e7cec9d03e691e1df63d88096d531d4154a5b9072d4285bbb99d129ca698564,143032872773
20180528,"PAYMENT RECEIVED",1252790082,0,5ea0f0b960479267e10b802ee37c154e81f8a2c6fde442290ace1b5c6a0dbd43,141780465501
20180528,"PAYMENT RECEIVED",1255979259,0,8427bb5205b8f6fa912a053b3de3ab6875a0eb805c0ed90e25983afaf4b79a04,140527675419
20180528,"PAYMENT RECEIVED",1250000000,0,1d5e1833f5a93799ff7e59bed7245d0633197891d1d518d9a98331e276363721,139271696160
20180528,"PAYMENT RECEIVED",1250794386,0,dc610a8304817a16b22f0845850ab67c7e532af98e5c3c5b5b14cf5558428df8,138021696160
20180528,"PAYMENT RECEIVED",1263053810,0,684634cded7b35a19e46c7565e41a26eecaa1d3c1fc792cb24067c5aa04b707e,136770901774
20180527,"PAYMENT RECEIVED",1264428507,0,2d02629fd7323c6b8f99c19abc29803c5238fdb3f0d25fbd44198d005591ac5e,135507847964
20180527,"PAYMENT RECEIVED",1251402618,0,3b7dc2bbb36df80b322c84836d8b199478f369f153be02f70b19adffd89d3eeb,134243419457
20180527,"PAYMENT RECEIVED",1260471309,0,d772efd4ba708d34abe2a61acb0057f290ef8cb4b9fe79ea4e84b33697a953b2,132992016839
20180527,"PAYMENT RECEIVED",1250972919,0,5028dddf7e9378489ae015bcdd83dacb8ddebf6fc66ff49fefaf4ee52358a21d,131731545530
20180527,"PAYMENT RECEIVED",1264073146,0,30516e5c9f4b2888dcc26d2b7bfefd5e8ff3abdcae053fd82fd98fc92324b4e6,130480572611
20180527,"PAYMENT RECEIVED",1251293080,0,81ad3ae9fc706baeadf4c771a361f124f55d3b2be366eccec599cad7493e2781,129216499465
20180527,"PAYMENT RECEIVED",1255959907,0,98687c1035a576f5dacc9f236de69329cff1b904d7f5e04e35b324b0e5a82ca5,127965206385
20180527,"PAYMENT RECEIVED",1267333315,0,8974253814dc06dc8e4e628d896c00a41c913d90d5e46bf4d5ef2daf9ef4c401,126709246478
20180527,"PAYMENT RECEIVED",1260288426,0,105b229ea564132096478b0cdf0b254c7f273d706d47e667267997596ee0f95f,125441913163
20180527,"PAYMENT RECEIVED",1256401917,0,cb875759941eb95f2f83c3e5399315d4bc1f735132d46c6d3993570b7621c6b9,124181624737
20180527,"PAYMENT RECEIVED",1250351233,0,6c0f69c995f29b757d2ab758bf4fa373fe3f3d0593bffce6143621bdaada0cf7,122925222820
20180527,"PAYMENT RECEIVED",1257031203,0,996a52d4a700fdb26bf0b2b2515b4d1b76c141b9b7fe44f503c81f49ee6c94b0,121674871587
20180527,"PAYMENT RECEIVED",1252950489,0,952c766ff1af632989c1ec15f16f5870a31ff04e5c503d5281866206b6cafb70,120417840384
20180527,"PAYMENT RECEIVED",1257399724,0,56d4347f858314dabf05685286d3ccc167aadd5595cc751aae14f73ddfdf6267,119164889895
20180527,"PAYMENT RECEIVED",1260398124,0,b3e20f89d401394f0b2eaf3c5c771362418fc4cd7a63c21b165b2af185207bfb,117907490171
20180527,"PAYMENT RECEIVED",1258767391,0,d21391dd8622d78fb9ff30a8846633fae73f081129f69ad024e39b0a3db966bf,116647092047
20180527,"PAYMENT RECEIVED",1329268614,0,471dfa4bb926722a1ecdc7a81ab38aea0ffb9d3660cf84b611cb40001f017898,115388324656
20180527,"PAYMENT RECEIVED",1256205218,0,a9329f82419f94e995943404f59726981edc57415ac9b36783bd9279000e42c7,114059056042
20180527,"PAYMENT RECEIVED",1267793497,0,073b34fce420db4cdb9c6f4122b58652913d61c66bb327afcb2492cdfbea542a,112802850824
20180527,"PAYMENT RECEIVED",1256700032,0,b43989a512cecd4edd51b53c1a9e7dfaa39fadcf2f09d28c82a3516f4f471b24,111535057327
20180527,"PAYMENT RECEIVED",1254067565,0,6f5a6fd8096df81134cdea1690826dc0c6aea0a899ae58180a8bd6a4162c305d,110278357295
20180527,"PAYMENT RECEIVED",1253417048,0,5823459f237e97cf3a0fe7c2c6a8d1623f9496a9b26a6ce5296b7c80b8a0b520,109024289730
20180527,"PAYMENT RECEIVED",1250604473,0,fdbca1c5d4afcaddba7ab84ff2444f452cd9e0629e96576ac99745a233b851de,107770872682
20180527,"PAYMENT RECEIVED",1273160054,0,0f7f58b43ac37294f47cb466a8723645935c47205858c0ae4eada840da285b14,106520268209
20180527,"PAYMENT RECEIVED",1258419765,0,65acdd1e063a4b3d57a7d35d32b63301f4c2f4a87d6578be7c644cbf0fa5bfba,105247108155
20180527,"PAYMENT RECEIVED",1255973317,0,476fada7c724cf925774fdf6983f01a53c2108f950f070854e1a6ef7c845338c,103988688390
20180527,"PAYMENT RECEIVED",1269595508,0,d7a1e7e0fb29cb4f1f285beb138dd34dd56ccde6c9dc018e146f57ef227a663a,102732715073
20180527,"PAYMENT RECEIVED",1250759479,0,29b80434d243b027d97c1cc7bf6bf3be3b6b9b4d99357afded5e02f5353c8c88,101463119565
20180527,"PAYMENT RECEIVED",1257112114,0,77d8e98ad80675f9fa63b2499dc69c863654f2f476e4b3c6148cba2f2f116eb0,100212360086
20180526,"PAYMENT RECEIVED",1266953090,0,0d6cb6a904c3db764b156b1eadf0a7a262e270a6fc805a661c4cb8e46218ea4e,98955247972
20180526,"PAYMENT RECEIVED",1250960718,0,dfbfebc9f43c365f8602593897ecfa4ff0aa2b028b14b1a11f19f7a6d0e9f04d,97688294882
20180526,"PAYMENT RECEIVED",1253268702,0,7579ed6f06d10e8e87cdbb44b494d39de25f6a9f4ff7e47408948e22cda2b18a,96437334164
20180526,"PAYMENT RECEIVED",1253580781,0,ea4016dbc6437f1c78844f1542c5f6386414e0930d8d82e72a04f97ed8a56886,95184065462
20180526,"PAYMENT RECEIVED",1269593458,0,d86143930740753e513b49357a2c78714341987b95384654b813a6a7e58e09b3,93930484681
20180526,"PAYMENT RECEIVED",1250204831,0,c7059b07c09b79a1c73cbe5934ce810bf839f52d249c39208ef2628b0522d38c,92660891223
20180526,"PAYMENT RECEIVED",1284782316,0,00665b7861ea21dd27754bcbce1f98a8bc62e5c8552b967e034265077ac32f72,91410686392
20180526,"PAYMENT RECEIVED",1251949356,0,6ab4b1247e5a9a11d5b16b56dcad7cbabb752a9679350c4bb87582903d7aa8f3,90125904076
20180526,"PAYMENT RECEIVED",1270101432,0,a58af0776a2eebbdc395805fd13013b9e2a2b714b757a376d7df9b0003b6d653,88873954720
20180526,"PAYMENT RECEIVED",1259235486,0,4296dcd4556e0741889e2c8cf271614253a5e06630fa17b47128575cd64ea5e4,87603853288
20180526,"PAYMENT RECEIVED",1251433906,0,c0ad11f1a2c0aadf8971ebdbbb572352086441dd7e9f52a52437491026dd0e04,86344617802
20180526,"PAYMENT RECEIVED",1317929845,0,e3393ef2112c446bf4aea57c110fd610c48fc9887f4e6d4701ed10cc4048243a,85093183896
20180526,"PAYMENT RECEIVED",1262634618,0,dd1b43afe20c7b7583928a9a658ffeae8151e02dc48876296d0fbedc3fc3ab0b,83775254051
20180526,"PAYMENT RECEIVED",1268073563,0,3077f07a0946518e17e457f586b14c13825a74bd209c84cdef599bda03f31864,82512619433
20180526,"PAYMENT RECEIVED",1325920026,0,22afdff11ae2daf32320ba13b126cadd5391b9df74bd62d539148c3d955563ec,81244545870
20180526,"PAYMENT RECEIVED",1253460120,0,89de9343603988ad26d8238199c000b005d3da79acc9bcabb68a07c285fd2f9b,79918625844
20180526,"PAYMENT RECEIVED",1253463992,0,1ac8f8bdbd6bc9f00fa41ab6716265319b0d56d300b923718bdc6a1ca567d173,78665165724
20180526,"PAYMENT RECEIVED",1270794118,0,51352561a668189288932dc86205968f60696c67ecd9ee6c6e456fa9f9b4309f,77411701732
20180526,"PAYMENT RECEIVED",1252603233,0,69005c8f6f9c24eacc0609ca90a460e776d499d58ec225266fe9ed407f698ab5,76140907614
20180525,"PAYMENT RECEIVED",1259677443,0,05c28ff57b76075999be427d73694e1a161d2d80ec717b47e3fb2f0af9cbc446,74888304381
20180525,"PAYMENT RECEIVED",1251934163,0,b862bc38ece8660c85a1c6b759ae8fc81b276157848bd5c1de592ed2baf75845,73628626938
20180525,"PAYMENT RECEIVED",1254675694,0,e2f532789b6ef62e05fd3c627a624bcce0287564091095f60c9c95f72890151e,72376692775
20180525,"PAYMENT RECEIVED",1284722124,0,d7317381ec0ae6dd4affddfbe496924aa15050c37cb6dc9eb7520b7a65d13863,71122017081
20180525,"PAYMENT RECEIVED",1251221000,0,07092858ea30100ef0bba160ee41fddf8f1d0ffe28b82789d6cf4d40b86b152a,69837294957
20180525,"PAYMENT RECEIVED",1251485471,0,5d26f8004ca0c5671aa14890b0b25a02b9f96cf43c1c4427ed35d60704bbceef,68586073957
20180525,"PAYMENT RECEIVED",1263747136,0,376e190bdf345970ef0c0f72f04d39dd8266e754563a4a5a3c48445f589c6b4c,67334588486
20180525,"PAYMENT RECEIVED",1292759006,0,f11548e19271bba7595c80a842a7c4e73e5fced2d2f77011e0f72cceeaab8d85,66070841350
20180525,"PAYMENT RECEIVED",1270772922,0,c04c4bf76436775cf0b012f490fdf571d724e44aadd0466da4386f3475d8108f,64778082344
20180525,"PAYMENT SENT",0,-98754423309,97b20e48273b158df3534d1f68f7a43ad058fcee9a78a72aaf2936168712f08e,63507309422
20180525,"PAYMENT RECEIVED",1255067793,0,3ef48aaa690be8be4a0f3505e62c1fc21cbab3e9b052658c4e0db17021666982,162261732731
20180525,"PAYMENT RECEIVED",1260637068,0,4ac4b1c52599029437c4df14b49d779ea37e192755872d12468d5aa426f8e819,161006664938
20180525,"PAYMENT RECEIVED",1315838348,0,d1567955718db1c8601bf51feb4aefa57f3969f474e5bb17c5090c27e7f827a8,159746027870
20180525,"PAYMENT RECEIVED",1293860753,0,2fac7bdc5e448b3b6c1939ea754ea5763acb70a626b50ae25b8891defed82525,158430189522
20180525,"PAYMENT RECEIVED",1290424125,0,707bb1265c08cbc6c9a8c33f952b374dc719b921c9f2d343ba061b34e821a094,157136328769
20180525,"PAYMENT RECEIVED",1345085730,0,a184ebb5170d9d523246442329db605180e8fd5b21d39c036e5f756bd5d3c659,155845904644
20180525,"PAYMENT RECEIVED",1276992204,0,c97c5814cc593720b13309abdf6f7da22191b441aa44b89f1f0494e3c243d291,154500818914
20180525,"PAYMENT RECEIVED",1272205517,0,05d25f671ad3b5a557e0ceae7cf72fd9f09db673dd250ad21ce44dac8baaff99,153223826710
20180525,"PAYMENT RECEIVED",1252421999,0,96c6c0728c9c288c162bf5544125c4c2c2a3e1a6526c3ca0d020f406e5c735b3,151951621193
20180525,"PAYMENT RECEIVED",1254452975,0,6fe652ea357b193752ed85bf26dc2faa8a396b1799779aec92f179721f51d2eb,150699199194
20180525,"PAYMENT RECEIVED",1270284666,0,899b25a8a63f7fbf28efd82f1c168c86d0365b809db6d9148bce0e479a21ba56,149444746219
20180525,"PAYMENT RECEIVED",1263220134,0,ed078b176b57a120c165d75429327a1daecf357810c48bc58e97be5e952d6d39,148174461553
20180525,"PAYMENT RECEIVED",1251318703,0,d20bb0ccc77caabf11420a20c23c1e91f24e7dca9d3627ff4d1e133180e5803d,146911241419
20180525,"PAYMENT RECEIVED",1270761689,0,4c93310593fdb76c932bf970e6bcee6f5aaa5d4a0c7024a689d268c94e718a88,145659922716
20180525,"PAYMENT RECEIVED",1250673146,0,ba3801be26aecd9485554994076d3cca864aef1b8141d656329b29b7451e4488,144389161027
20180525,"PAYMENT RECEIVED",1250164411,0,b609c65fd7a2e6c8b0c9e847f5f1fc084696abe3b0b7407ed6729b75e508faf9,143138487881
20180525,"PAYMENT RECEIVED",1261843043,0,3abe71d067fa6cf5f3a860785408a9480f3a0dc80550292366882e2fa6690140,141888323470
20180524,"PAYMENT RECEIVED",1271006686,0,b378b8fdecdd4a51dcb5b758587fd40005c8ec1d72b1d9d8eda9e4b61513e354,140626480427
20180524,"PAYMENT RECEIVED",1276657633,0,295f9d90611ca5f4a09fdc6462afd94dbe95d13658af8f0b175b1ec4f0763df6,139355473741
20180524,"PAYMENT RECEIVED",1268627824,0,08989f923d02ae15e6e6a959766dfafa06da575948186b1192b698888692ca6a,138078816108
20180524,"PAYMENT RECEIVED",1269847681,0,11f62773364626b963ca580139436de8df5e95d2904914d2eeb37ae4fa3e5740,136810188284
20180524,"PAYMENT RECEIVED",1278655962,0,2d22d470c62c167d3361c61e2b6e1e57081c949ff50a067a7034f893e158a24f,135540340603
20180524,"PAYMENT RECEIVED",1260801751,0,e0faeaf80808f63db154e9189c2d1eaf883e52174a0f1156725dbf9ecd807aa1,134261684641
20180524,"PAYMENT RECEIVED",1278481516,0,da51fa1572e161324a078c894fb7e97736a5f1c9de7c45af8b74c59029566c7c,133000882890
20180524,"PAYMENT RECEIVED",1263900569,0,607b6fac40f3a94518613a85fcfb2f3b091d967ba80d73055325e57da01f437f,131722401374
20180524,"PAYMENT RECEIVED",1316826140,0,5cef8bb0c5e24bea0c5f4abf8d4a0ea854aca4f54bcbbc43582c32bf8fc9209a,130458500805
20180524,"PAYMENT RECEIVED",1259140365,0,028d71241e247d0b57dcd6089c910e70a4129b052af898e7390de44bc3376e2d,129141674665
20180524,"PAYMENT RECEIVED",1259316982,0,7f0348fb036d1d9bfdd77860dc77db54b3dca7b8f5d85f26dfd2392ab80de56e,127882534300
20180524,"PAYMENT RECEIVED",1256679005,0,825ef72535a3abd180c3fa30747a5cd4a189e9a4a8317401e8cb4b8e87f19faa,126623217318
20180524,"PAYMENT RECEIVED",1268374376,0,8b4bc48508de3c232b66e3dd86cbbc5e1bc28441562156e5f2dd7d698a466310,125366538313
20180524,"PAYMENT RECEIVED",1285986146,0,67d73c031d3822fbbf0a9ccb61b544eb584fa42c50116b1f9b05183779942406,124098163937
20180524,"PAYMENT RECEIVED",1256405885,0,3c1427db063406474e171aff2f556709a6067e1fab040ec5c9cbeef34b79eed9,122812177791
20180524,"PAYMENT RECEIVED",1291112523,0,8210a3a54ba096df601bc4c3a7ab8364a1524f13672cc31c811d1fe620cd2ce8,121555771906
20180524,"PAYMENT RECEIVED",1251978257,0,167e591b2e01596fe36baaa87e47d00bc47eec38614ce7def9d532999f9bd1ce,120264659383
20180524,"PAYMENT RECEIVED",1260660563,0,924e1a9ae11f0049bc997dd90222d96932b0c2e4293ff5f328caf98353b0964e,119012681126
20180524,"PAYMENT RECEIVED",1258708435,0,3285b724c60ed5dc044ba363ef3f8db3363da6d1a6c42254e4fb144c5831bf25,117752020563
20180524,"PAYMENT RECEIVED",1262357640,0,bf14f7eae87485f942962a16d8304b0adc1c1120095f6cd5c69db31ce4766a75,116493312128
20180523,"PAYMENT RECEIVED",1251321540,0,863e56ec6cd402f02ef4de7df2e20c1be5141461c1b1a9431745faa9d140e406,115230954488
20180523,"PAYMENT RECEIVED",1250351834,0,63fa15c3aee1fc628acd3fb0b9c7a48ffcb7d8b8b12d9b70dd2869cd5ac7ec96,113979632948
20180523,"PAYMENT RECEIVED",1258571915,0,827d6a26bc3f5391d83ab53b025a9319301e923d1a94f970629a6d5f4485dc11,112729281114
20180523,"PAYMENT RECEIVED",1265925249,0,28980363ab02a07a14970e5474bde153fa832623fdfd6174ed338a1964a1c7ba,111470709199
20180523,"PAYMENT RECEIVED",1257363585,0,4a47fd37e872fc012054ccb2d54e5f9b6829e5f80177939f1bca831a908ec7be,110204783950
20180523,"PAYMENT RECEIVED",1264520777,0,e3438cfc29b66c5c80854c00a269975c5b25bfb574bc5a8d0625d1c1003dfdc7,108947420365
20180523,"PAYMENT RECEIVED",1266564239,0,346201fa52bf47dbe4684d57c0e0876c8e36d53456ca6b29db13d2334afa1a1c,107682899588
20180523,"PAYMENT RECEIVED",1259758777,0,cacd3e9a71dd1ab70cd606603752e9546f77910a204509241c9e98f89e423495,106416335349
20180523,"PAYMENT RECEIVED",1250701437,0,9d2fe17067c42d8a3c2d9120ce64f50b5cbba4028910a4710554dd0cd077e95d,105156576572
20180523,"PAYMENT RECEIVED",1266874587,0,6e26c9725833c278835346f34e0bd319f39bf3d36cdd7ea2686ae500148f2e73,103905875135
20180523,"PAYMENT RECEIVED",1268262440,0,7349c8ffed75a0656f58c4f59e0e4f6ad1862e0307647a746c63ec1719a4eb76,102639000548
20180523,"PAYMENT RECEIVED",1259044572,0,49558b98c221f7cf9f5d29b6eed177ea67e1cc959f687859fb824efe6345dc6e,101370738108
20180523,"PAYMENT RECEIVED",1250550504,0,cb55aef2e3292b818059a3a1b02e981afc4675662c4fa591caf21318523f0c6d,100111693536
20180523,"PAYMENT RECEIVED",1250454836,0,e00e898b0649f0fac56fe6abb89c0503da56d09ef136b94e55ba32f6237814b1,98861143032
20180523,"PAYMENT RECEIVED",1281998917,0,42b9cdacbd334c5e267e796e0176288eb37c4fba1893c53488f73e0fbce9b970,97610688196
20180523,"PAYMENT RECEIVED",1259283935,0,8b9870af7dc4423ba2d59a4642b175cf6c450e0c13c6126c561edfda1d95c912,96328689279
20180523,"PAYMENT RECEIVED",1282330928,0,02d526377fb3fe206fc74c72d8b662cd2f81ae2026d79ab04dfcb82fa8ca9ec7,95069405344
20180523,"PAYMENT RECEIVED",1291035385,0,974b057789c878e322827ba7a84f1ff104b2c089ba9839b48420b62c141f45d8,93787074416
20180523,"PAYMENT RECEIVED",1264198384,0,1fb959b660f1e79433c6240fd52b0889065839801008715fa356a6037773b34e,92496039031
20180523,"PAYMENT RECEIVED",1274587348,0,810b24171b77b6d3130faf8ae2c9f88831657fc48b465fbd8f3eb584a52dd392,91231840647
20180523,"PAYMENT RECEIVED",1274771862,0,0bcf5dfce363d1cbea8e961100fe233b8a68ed91cbb9cb30f90137466f27b1b8,89957253299
20180523,"PAYMENT RECEIVED",1251802548,0,c464b3f9422b935eba6b650e3bacbc268316a3d5697b7d2d3238671228e588b5,88682481437
20180523,"PAYMENT RECEIVED",1251294066,0,babec2c90ccc89424248b637734940010b582dbe6cf38a8952d38e08a7cdcf02,87430678889
20180523,"PAYMENT RECEIVED",1252091423,0,ac6f9ba5c1cfb68fba9985a2c0010eafacb0c7e1d2045a270742e22563d31908,86179384823
20180523,"PAYMENT RECEIVED",1250329420,0,51607e47f4bde1d2bf5d19b34ea6d9d7cfd91dde925a3bc0c5202d9131ba59c9,84927293400
20180523,"PAYMENT RECEIVED",1271290270,0,5ea4de79ec5ba38d650cd5c746e95e657b42490cb51b958398592ce78b72acb8,83676963980
20180523,"PAYMENT RECEIVED",1286201152,0,824611833ca69c90c97bfb9064379f95295c097f7c07697680cf0391876801c2,82405673710
20180523,"PAYMENT RECEIVED",1250147123,0,aa69477762afbac6519c03940f54e266439671b507205f2bc2d04c349ba4e8c7,81119472558
20180523,"PAYMENT RECEIVED",1253434147,0,0443cd82b702141a53b486075fa2830f67096b6078770e9c86b24f6dff953f7f,79869325435
20180523,"PAYMENT RECEIVED",1259929662,0,7e3d0bc6d4819ca2d328abfd73af2c920fb79d661db69d9a48a6029cc42d732e,78615891288
20180523,"PAYMENT RECEIVED",1255577603,0,8ffc33ba083d027f37b6f502ba3c15df4f4d5f0541684dcc141ae51298bf5b0b,77355961626
20180523,"PAYMENT RECEIVED",1258996744,0,b9ffcba405be2b6188347659271d0702d725a02358931eda5db9b6e69b98e425,76100384023
20180523,"PAYMENT RECEIVED",1256413916,0,9e46d0587238e5dd53742789b557ba8dd41ebaa5c9acabc74baaf7424dde7669,74841387279
20180523,"PAYMENT RECEIVED",1253564225,0,2248141b3d971c8bdb8230b874e88bbf3650446233526fc86bb6d99f1e9a7cf2,73584973363
20180523,"PAYMENT RECEIVED",1275246637,0,04e167ac01f67fbc280bad7a0a05d4ebfb9abc190e9b99f7913818c176bb9e71,72331409138
20180523,"PAYMENT RECEIVED",1265712147,0,269df45697c3ca65774b01d843dfbc812bdf364fb1918249cc906ba8ae04e3da,71056162501
20180523,"PAYMENT RECEIVED",1264672269,0,3187211d3e7ca3a9d2f71111710a01e4e4359572f8b36ed439ac04cd4c857c7d,69790450354
20180522,"PAYMENT RECEIVED",1259702115,0,1ede6c7d3d38db104dcbb173200ed7b8fb0428feff951d7b04e046f1108b5177,68525778085
20180522,"PAYMENT RECEIVED",1259540611,0,c05357011bf18c190be1faef8bd786e7e80808930aed5a7ddb9e16c1897fe82b,67266075970
20180522,"PAYMENT RECEIVED",1290748033,0,eb470c914733c5ab081aa7d7032f8649c5f0167426da667c6fe7a1054602c17a,66006535359
20180522,"PAYMENT RECEIVED",1275105428,0,1c7a8d27a1cc726614eba3d957869be0128cf4de91f4ca1a658bb0e67c813569,64715787326
20180522,"PAYMENT RECEIVED",1274441120,0,c580f36d9bc39e1d401bcd98559b4ef93eccaa55f84ab3f43dde47f5d9706ea7,63440681898
20180522,"PAYMENT RECEIVED",1280439769,0,7f6e7516dcbaf19a2edc7a4c6ff9167d0d5b7f084fc3f90e13bca5537420407d,62166240778
20180522,"PAYMENT RECEIVED",1272314446,0,d341199f3d22891ac43d4dd75132bc93ff179bbc4cf11e6cfd2e54429ae05afa,60885801009
20180522,"PAYMENT RECEIVED",1271237815,0,3751879571aa6019cfa709a6dc6cc50fae89f20a520fb11d5e1718c1d4dd3616,59613486563
20180522,"PAYMENT RECEIVED",1283078622,0,e3a0faf139e9627005eddb59808ccef16f4cd736bcc76b3020c10fa150bf4c29,58342248748
20180522,"PAYMENT RECEIVED",1305413871,0,8547d63c13b0bb907e6217e7f5b00f93ff42f37292310874b7366ff1869d826d,57059170126
20180522,"PAYMENT RECEIVED",1250000000,0,66d4d799bf206effdacc3a09c1b7b489b09a6c2b782a715dd7166d2b07d11179,55753756255
20180522,"PAYMENT RECEIVED",1252644659,0,3f528aec3bae0e9d4d1a37fb96ff0754a42c75c41e5c3b8ed3cd2becd13c409f,54503756255
20180522,"PAYMENT RECEIVED",1289096308,0,167bbe23cc8070a93ddcd858a890f1b6c56735937b41f1bd033a82f35f366d52,53251111596
20180522,"PAYMENT RECEIVED",1261470990,0,f82ab39970e30baaad864c8373ec08093ea55e274836c3d6abd332593007838b,51962015288
20180522,"PAYMENT RECEIVED",1253537801,0,f501e60edc17f08447c7e079f9dd0356e984f91261320610556b55fee7b6e21e,50700544298
20180522,"PAYMENT RECEIVED",1251110091,0,1a209192bb9c9fa4eb8c43d008bd12bbb9b3177771dfc3d938a120e879754312,49447006497
20180522,"PAYMENT RECEIVED",1269221763,0,675194c9ee9f2dda6aff206eaddb9579aba801c7b7140eebf4e38bc6bacf9a8c,48195896406
20180522,"PAYMENT RECEIVED",1260073308,0,29d068e99d325e9de1ac3bc26374b4dbc962a0bc3b0009c2789ded13aa337099,46926674643
20180522,"PAYMENT RECEIVED",1264952068,0,42f6e73cc750750e532bdd05d8a2a02327d3763e6135a966e2745663a5365040,45666601335
20180522,"PAYMENT RECEIVED",1259166002,0,fc1d01d474aa686b49f61d53e95d70ff254a12529630a37f2add0a6f1fdfa2a5,44401649267
20180522,"PAYMENT RECEIVED",1250067938,0,a1c458d328d00bfe4f0463acdd73aca8d6daf308719bb7691e11b87f20616dfc,43142483265
20180522,"PAYMENT SENT",0,-49365689441,2d685b6d4481a7f2c7492eb595e533d0422b7389f513f62352de60f2a641423d,41892415327
20180522,"PAYMENT RECEIVED",1253269623,0,5b4f78ca83cb50537cb5c50edb0864062e831fb72c267b542378c0e8e085f424,91258104768
20180522,"PAYMENT RECEIVED",1254953481,0,4dede199866f92357b943d7f7cfd1e98a0f58ba0235582b5dcf3c263326bfb1f,90004835145
20180522,"PAYMENT RECEIVED",1278929004,0,c8bd0430c46b465a40ef8fcd7d89dc9291422628fa75f624b9c6ffb84a632a01,88749881664
20180522,"PAYMENT RECEIVED",1261651325,0,7a1e45ca72bb44509ada6d565002d068e9169b953a6fdf5dcef00c75719dc065,87470952660
20180521,"PAYMENT RECEIVED",1262432157,0,d4f6c7955e2eee60675f3d790581864ccad32f086c4c1274d47edeb71a8f1b3a,86209301335
20180521,"PAYMENT RECEIVED",1251031163,0,0022cac834df531a87785251b970b64ab57deda5c4a01cbd8d959a3f31957bac,84946869178
20180521,"PAYMENT RECEIVED",1256859163,0,8098096d8ccb544e3ce01a4166b50cef6cd5c693638541f0a5a77816fe345fa7,83695838015
20180521,"PAYMENT RECEIVED",1279434697,0,5b0ddfc498cd2b65f77424d7ed8a5bacde2a97f98c6384b7ea77f97cac7f7755,82438978852
20180521,"PAYMENT RECEIVED",1254451866,0,9791fed2850038706582f39af42da4c94e489b3c8709e8f85381bf1142bdb4db,81159544155
20180521,"PAYMENT RECEIVED",1269437408,0,4fd1d5470efd5413b4a802283cbb863cf853b35e9942a1153ee52ba0b0770c7a,79905092289
20180521,"PAYMENT RECEIVED",1252487294,0,47c77c179c49b9bc1328222fcf980e9db9eb261d26365bfd67047d665885b4ad,78635654881
20180521,"PAYMENT RECEIVED",1252856800,0,cac36943e46ad38d272d76894e97f92238487b17cbbb64c2c1b69bdaa9632051,77383167587
20180521,"PAYMENT RECEIVED",1300073285,0,9d5baa92c414d7721bc1b1e250d5686f62491a1b6f083e8c6a95d1b12d171bcf,76130310787
20180521,"PAYMENT RECEIVED",1277583108,0,97e210f95d8988a0726a9ebc69947bd9ae2e73e27af7570c91fee37d8df3a729,74830237502
20180521,"PAYMENT RECEIVED",1298491271,0,4bfe032a1381c807210b300c5feec918ef1157733ae0e16f40273385b7c9cc2b,73552654394
20180521,"PAYMENT RECEIVED",1274897497,0,f688f5106ac11923434368c43a112b6307cfbcbeef196b652dc069fb9e68cb16,72254163123
20180521,"PAYMENT RECEIVED",1267779345,0,40c3585095a99480d57ed115c3d274e51ab9744b76092d366ba3674e00479d6a,70979265626
20180521,"PAYMENT RECEIVED",1276740540,0,6cfb43be58afcf4ab8657b8ab11063ba08d3d1d2b94f5fb7d2660106166f0554,69711486281
20180521,"PAYMENT RECEIVED",1254710201,0,c4aa39ee6865f082940fdf085cea5ea36b9326c792b247dfd9ab07bcde2377db,68434745741
20180521,"PAYMENT RECEIVED",1307640263,0,d58c0753b7fbe84eb54a64fd85ae75ee96775c937cbc8b297b0bcc705b23a6b9,67180035540
20180521,"PAYMENT RECEIVED",1277888437,0,919308214019ece2f52fc26eeabe411d8839cad7c955eda78543804449637c07,65872395277
20180521,"PAYMENT RECEIVED",1262571310,0,49611dd679ef338c8f811fe966e2c0d2f4ce1f86d1873ee1cab665597e14ffb0,64594506840
20180520,"PAYMENT RECEIVED",1253281084,0,0b9491a259edcdf03b3eced3b71c08b6329c271c5ce8bd11ba6c294ad2ab02fc,63331935530
20180520,"PAYMENT RECEIVED",1250452979,0,f4d32c62c2e5f6d85f4112c853d5be8d757a1592fbb3d7021988d2520068c7df,62078654446
20180520,"PAYMENT RECEIVED",1271757756,0,885bfbf9f1971ecffeac3aa35b30041bd9a985cbcf6d86a45fc1a5a33cc24eed,60828201467
20180520,"PAYMENT RECEIVED",1261121398,0,f78c3329b8262cea169cd5f3fa142ff5fa289ad632f60ac9ea10d9b339a033d3,59556443711
20180520,"PAYMENT RECEIVED",1254236296,0,652ae25660b22210a23258b7cb7aa9a8cecd9fdfc19bce493f29515d05266cc6,58295322313
20180520,"PAYMENT RECEIVED",1260526555,0,bd9ed028a72aab7ba8ea9a3622dc3ffefe758e66dcc919e4fec0a2976c54fb4c,57041086017
20180520,"PAYMENT RECEIVED",1253800002,0,1e33cd84a93c1b884ac4530f5214632b39010217f9f9447633446661663ac682,55780559462
20180520,"PAYMENT RECEIVED",1259600669,0,dd48e7e2767c7abd30def88177dea2c6d49f6b264866b2b0159c30de7d702eed,54526759460
20180520,"PAYMENT RECEIVED",1264087182,0,be169b47e18af3396e5b6f77dc17fcadf9c711f4ef39dd65a5f87e0e2ed593c9,53267158791
20180520,"PAYMENT RECEIVED",1278911497,0,f20ae3155845b63e1bee7f7aeaf034ce6e20e5fd3824d6d01ef43043d844026c,52003071609
20180520,"PAYMENT RECEIVED",1254160514,0,a500183ece788d8621a395fc716dbfe8ac70262966535a183badaf1063a5a7f5,50724160112
20180520,"PAYMENT RECEIVED",1259103839,0,ba53b788c5e888168584ea6b15edc989f2ded70d85650479707797f7e616eca0,49469999598
20180520,"PAYMENT RECEIVED",1278981988,0,71a2579ff7d297a5acc69122e35007a47599863ac9b6b0816f166e3177560094,48210895759
20180520,"PAYMENT RECEIVED",1264239452,0,d03cdb042efb7ac7bffbc31f04360c3f7f9f7b406a8c108928f6b5ea71fb23d6,46931913771
20180520,"PAYMENT RECEIVED",1283965504,0,ad2499386cf42a9f7f3704e87591af89f6fc05cf2798d8145acd106859511037,45667674319
20180520,"PAYMENT RECEIVED",1271635081,0,b62a14e65d8fccfa199b5df8e2316c730276ad7b19a0981870781050c4244c30,44383708815
20180520,"PAYMENT RECEIVED",1250765089,0,576f66bfc1847da023e4766b39e9983d79a69b5b2b4d412ed1444f6902bb275e,43112073734
20180520,"PAYMENT RECEIVED",1267440039,0,27d4c14a348d078816da4034e14741c0e51c20bf89114ef379bc6e347efd30f5,41861308645
20180520,"PAYMENT RECEIVED",1270426217,0,9e7b11a5595d99dcd9c656fb2901d040d519c64e2273f18a06ba53b7d6e43ab4,40593868606
20180520,"PAYMENT RECEIVED",1252123185,0,1c13995e78534c7a014a67856b39a369b22bd6c1abd6b80e9fe88764e89d8f97,39323442389
20180519,"PAYMENT RECEIVED",1264327848,0,099064191f2b3acad288028d52cb8b2e9a263c869aa54f5d82ba8b71e6116ed2,38071319204
20180519,"PAYMENT RECEIVED",1254104994,0,346f4f7aa9cd56c722de751187b474a3d5fb8bee67f6e657eb8fc484e8420028,36806991356
20180519,"PAYMENT RECEIVED",1287962944,0,db50819900ed8be5f141e669b74f3cf79be6ca9bd4b8dd7dd523be41e70bb419,35552886362
20180519,"PAYMENT RECEIVED",1257822843,0,f92c8137cc3256d4cb86ad797c6e10a3a7195362c217a6791d617cd32604fe3f,34264923418
20180519,"PAYMENT RECEIVED",1250687257,0,6eac110b5cc4691d955fbc8d5b8072b0a250b2469ec7d2f0a4be672896de94c2,33007100575
20180519,"PAYMENT RECEIVED",1272419719,0,3f6609241a92c0ab07d96ca9cc1090c519f5e109c748f3658e21f5e2c926e8d0,31756413318
20180519,"PAYMENT RECEIVED",1294248510,0,48e09df087f573caa5f59dd2f7da6b97d5d66fa1d4027e490dddf5e8b40762a0,30483993599
20180519,"PAYMENT RECEIVED",1258951077,0,269d8fad6261ae6f5edc8797ae064470821503fc8eee2c9d7f0a8da98f0d094d,29189745089
20180519,"PAYMENT RECEIVED",1315530003,0,af41848f39e6ad4bdfec8561ec44afd7bd7a0a7d603c3b476a3d41ca7f8dd6f2,27930794012
20180519,"PAYMENT RECEIVED",1250668937,0,d28bd5944a7c396d50ec3bc1fb45f6adb2c5b06eeb67ee964875277899c1675c,26615264009
20180519,"PAYMENT RECEIVED",1283574038,0,4b6c1906f0ddb7cfd4ce30125eadebe31157e39b8d886897f8dbead986e4d50d,25364595072
20180519,"PAYMENT RECEIVED",1256927648,0,8b2ce348fa44a65c9b47dbc2112f7800d17d399a22ceb70feb85ad5e8f79a556,24081021034
20180519,"PAYMENT SENT",0,-96980684931,74666745d924078f5246eee86b92f276cc476b1a94d409bbfb3a0ef3dc809e6c,22824093386
20180519,"PAYMENT RECEIVED",1273005662,0,0e637d11fc925eaebe2f5dc0a6aeda8a76e7b7b308046089e61c985ab6f361cf,119804778317
20180519,"PAYMENT RECEIVED",1286343701,0,f0b16c04ea9f7a55eaa4c32d83a107533075d88d849cea7d90260f18f537a97b,118531772655
20180519,"PAYMENT RECEIVED",1254109387,0,bcb5d142cf21017025ee1e4e4cd8e6ba69d4e488f6c491d836d0856560b88e5d,117245428954
20180519,"PAYMENT RECEIVED",1277300316,0,13647a8fe9fa5fc7e8d1d9b3980e897a90e1b5f46e9b4896c1de1dbc08ac8550,115991319567
20180519,"PAYMENT RECEIVED",1252786097,0,0f0a20ef027142c1e9a09b9e46bd2878ab5724ee175c0588a0006ee9d234bae2,114714019251
20180519,"PAYMENT RECEIVED",1262437807,0,281b47cce9170f0ce3203454cc231d875c382b76eab048edc7918ed33fbd5789,113461233154
20180519,"PAYMENT RECEIVED",1268791504,0,bbe63861307fe9015098ad419cab17bf10b6a3d983a4d55c529ea4eb5a2c0e4a,112198795347
20180519,"PAYMENT RECEIVED",1272323062,0,a17d5dfa12339cecc6c9a90efd50030663d2da48e121dd193ce78eb8344dc851,110930003843
20180519,"PAYMENT RECEIVED",1251609097,0,94b706f3303d3c34feec1c1966d228aea5b5d6408ccee7bc43959b62c2960394,109657680781
20180519,"PAYMENT RECEIVED",1294269279,0,c54fff42445f72630166e4fe943beace7afc71cb23d73e47ba2aac2f6c910f3f,108406071684
20180519,"PAYMENT RECEIVED",1251452323,0,046801352b5ef73c74215766f95a36b68e6e78533408b169ea1a94d101078754,107111802405
20180519,"PAYMENT RECEIVED",1260920360,0,74486262ece2b5f0fdb697a269c5f7c36d25460793c2c3a5c530c727945f88fc,105860350082
20180519,"PAYMENT RECEIVED",1253137186,0,5a3daf6bc23b5e3c778a5769120fd91cae1c2ac9554b3cb33d8e870f648b1fea,104599429722
20180519,"PAYMENT RECEIVED",1252326795,0,0493675d098afb187a6dcd9f42999a65465beb5022b1ac97fcec77079ce941ea,103346292536
20180519,"PAYMENT RECEIVED",1278423628,0,299a7e90d05727956ced109d0f87d901142ac851f89a9d7b0638705e5e6621ba,102093965741
20180519,"PAYMENT RECEIVED",1285022266,0,1172d00480bc7bd98bc91505808b9ca6b5b91c04ce5a1c1bde5745de133144c1,100815542113
20180519,"PAYMENT RECEIVED",1260620284,0,9e0a38d13012fbfdcc49731c22124a11b1bf857690088ef2c662d704c87009a0,99530519847
20180519,"PAYMENT RECEIVED",1289214632,0,3ba12cb648271aaf65ac4cbcff98086aef1d722bafde7fb9a8a141c114128449,98269899563
20180518,"PAYMENT RECEIVED",1260844036,0,09d3254f54134fb3b8e24014698e0bcaf544f7059806d311d559615d3c379f2a,96980684931
20180518,"PAYMENT RECEIVED",1309814816,0,bc58c7aab826b5c7b7568f8ba9e2c8265cd0a550bfb7babe8e60068fac75db0c,95719840895
20180518,"PAYMENT RECEIVED",1255721635,0,868cd14ac8d52a5b9b6e34bc60c88868046aca2b9ade571551fc885bb06b4d1b,94410026079
20180518,"PAYMENT RECEIVED",1251911132,0,89d55baf0cd9c9b46179cfec5a74c8045b0eb3f517497633c85dab739a1c466b,93154304444
20180518,"PAYMENT RECEIVED",1335160506,0,352d0afa630cb204f3c2636fda9aba7206311b67f07ba07b75bd04cded37eb39,91902393312
20180518,"PAYMENT RECEIVED",1250469651,0,59b5ef77fc7451b84ef10e9715f9fd16d6659ad8c283ccbc198f7c0ed29f4c9d,90567232806
20180518,"PAYMENT RECEIVED",1348991386,0,40231b0ca5a48ebd9c59e277cdcdfea2721598d716714268bf5dc5182dc11510,89316763155
20180518,"PAYMENT RECEIVED",1251509239,0,d3efd109029610fb22c0ba72bba27821e21681792246503ac4eba212e50b1de7,87967771769
20180518,"PAYMENT RECEIVED",1348696461,0,b9ac4e347d8e74099d0340494a2aae328bb2fff292c503b27d5640f0535968ee,86716262530
20180518,"PAYMENT RECEIVED",1360857210,0,faf0324064e34daa92b9c8b26224c7aaf75ae9ca115e640938ab4046e34d904a,85367566069
20180518,"PAYMENT RECEIVED",1362782178,0,43444ca6f32268906a5b40cf28c1307f9ab85783d6e6f2a3e4faaef25e6bc776,84006708859
20180517,"PAYMENT RECEIVED",1356508461,0,b771be198f0e6a9140e58042e3cce7ebcf8bfa4b96b38e0ead64fbe17b7b9f88,82643926681
20180517,"PAYMENT RECEIVED",1279273270,0,5dccfb0e0464f0c0a7878a69a656fd43ee97d19f7c7f05ec1a259cbb8a4da0c9,81287418220
20180517,"PAYMENT RECEIVED",1327411602,0,0deead69add651dc4a901ed976ba2a07dac96f310e1674daea18e35f1d02252e,80008144950
20180517,"PAYMENT RECEIVED",1285815451,0,43671a9ec4c707f8f184c9de8956470b3a1880d9dce65c65b224bdd714e9025a,78680733348
20180517,"PAYMENT RECEIVED",1298600166,0,42bc1f007569d3609b0ace67181b659d471965d0c2a0b4115a2ebd20382d826b,77394917897
20180517,"PAYMENT RECEIVED",1284523636,0,4465a71e50d5bf67db655a43f730008cfcae85daceb91f33cb329d245bfa1a1c,76096317731
20180517,"PAYMENT RECEIVED",1294114007,0,1272c5d8c1c82e27d23ddeb4ee34877fa267eb3f29d18497444650cabfed6d6e,74811794095
20180517,"PAYMENT RECEIVED",1330273304,0,e9d70491984959bc35338d5720f457376ca272a1203455879332ce4539d52b45,73517680088
20180517,"PAYMENT RECEIVED",1350637641,0,1d2193ea719543329f4f3cc72adc344dc462bb7e194510fe2787df5b043e10c8,72187406784
20180517,"PAYMENT RECEIVED",1356983876,0,de0575349685ab7e2754c77244e2b1122d01ce0d19659ca7a9e047ef3e8b1eda,70836769143
20180517,"PAYMENT RECEIVED",1383376189,0,889b075f7b9aefaddae736befe1d9988ccf12dadc4bfdc025c00c07630241507,69479785267
20180517,"PAYMENT RECEIVED",1276147515,0,3ceb34492499eb53ca01caf75222bb80665cef4d39e9623ef548587e006fad6e,68096409078
20180517,"PAYMENT RECEIVED",1257790430,0,23b3feba7543738b47421031a05587be1944e8667518169fafa567bb57f14417,66820261563
20180517,"PAYMENT RECEIVED",1257928765,0,9d0eeffce6aadc02dff0d8c4f9729568a4952fc57bf707d37ad64ec6f23a8c82,65562471133
20180517,"PAYMENT RECEIVED",1253227160,0,82bbc04904083e51efd9e5424b99a24331409b8d412792a1ea0bddee75455d9c,64304542368
20180517,"PAYMENT RECEIVED",1268182269,0,07900c30dee401f2e368cd869969e59a19a08f93f7f00cf6f68462c62f8bfe6e,63051315208
20180516,"PAYMENT RECEIVED",1252219530,0,9e4b06672b7f415cd1665187264543e00a25e19d5e379de4bb3cbb1268112504,61783132939
20180516,"PAYMENT RECEIVED",1264976316,0,44eda83d70ef1577f7156222084e7ca714544025e428a8653c50e8cc391669a8,60530913409
20180516,"PAYMENT RECEIVED",1255091671,0,144d6f5a5b8a6300f395ab90c484aacaa8aa1df5ac73870099f6694e17b53c37,59265937093
20180516,"PAYMENT RECEIVED",1267633114,0,6f87c2320bcff87ebaf52ab2b024b0930a1ca67b5e1bb83d1be093debb9593a6,58010845422
20180516,"PAYMENT RECEIVED",1266825183,0,5b059aa10b69c9937f93f5b02c3248c99c3dfa0cc25851d3df8733ec07ab2ba4,56743212308
20180516,"PAYMENT RECEIVED",1258582101,0,1c0e7b8263784a1baf0d55119c228ef849fe0799912299fc747fce7b45d55232,55476387125
20180516,"PAYMENT RECEIVED",1251453790,0,85990e6060b42c1465924877799e4a0154ae2d6d17f7d6ede35d5e60ed705805,54217805024
20180516,"PAYMENT RECEIVED",1294282614,0,dac6fb61641377f3274db98218ac4a5a2809bbc81e8fc828ca9d8ec6e52f02b7,52966351234
20180516,"PAYMENT RECEIVED",1261697931,0,e0f01a37c2babf6db52e2be6454b5ae14d1e2549df33ebd4f76ea0b3c636e8d5,51672068620
20180516,"PAYMENT RECEIVED",1259214505,0,304db49cc948b4636be4fc55749ec4a0fa401c11381cf4fbcc88754eeedb7854,50410370689
20180516,"PAYMENT RECEIVED",1284471023,0,ef1711b3b6c8c1ecb6893e052fc7c93efff7d9837ae6c22f609b144771a9e904,49151156184
20180516,"PAYMENT RECEIVED",1258906794,0,9a8284f9fc7b5070128f51cfb4f1b3a9a25a06246bdbcfeee69575f087bfc123,47866685161
20180516,"PAYMENT RECEIVED",1251880552,0,e6a13679d953c2250cfcf82a462d2d558a7ac837bd7e16a2afe1aef95c4f3c94,46607778367
20180516,"PAYMENT RECEIVED",1252604722,0,1b581bfc5cab190bb3d1cb2adf82d36a6a1bd8c99437377f759510479bbc9d28,45355897815
20180516,"PAYMENT RECEIVED",1253744251,0,db223762612c3910c3c7cab5209e74f5f811917167e16d77c48b35846ecc87bb,44103293093
20180516,"PAYMENT SENT",0,-86116418115,cea06764431970e2f2613ed22d06118346edf8dbd76e30de1e43d47869533bfb,42849548842
20180516,"PAYMENT RECEIVED",1269802069,0,4ff5ed873c7c92e89546d7e0ad13dd6cada9d7d7f3901800df1f921e3b0e26e2,128965966957
20180516,"PAYMENT RECEIVED",1250430285,0,d7b8dca99aac20c3e4129290e50fc9cc10a4654e31d776e5a2a024ad972343ae,127696164888
20180516,"PAYMENT RECEIVED",1251591151,0,5fc1f47781d5a158fed5340e3072831de86d57517dc50b992784492ed1950a07,126445734603
20180516,"PAYMENT RECEIVED",1250000000,0,01ebb3e72c54b8ae46aa4f026257cc1e050e2ff058fade8f030f7253b0b474b2,125194143452
20180516,"PAYMENT RECEIVED",1255508122,0,05024e57618c6411503ee4890b781eab85882395b44853e7e84fe0ed3e33b59d,123944143452
20180516,"PAYMENT RECEIVED",1250000000,0,aebc36b10b6293ea2b4174881155cb30d24436d21a1914bd0f69f7105d5abd1d,122688635330
20180516,"PAYMENT RECEIVED",1250000000,0,e25312882c38c31c40d3e1763889f9c0e5b6cc653bcad48b04d20ea1419027ff,121438635330
20180516,"PAYMENT RECEIVED",1278821004,0,f57c287c258a416804dec259b7af9affac096761a13f89bfd188bac1a63f93c6,120188635330
20180516,"PAYMENT RECEIVED",1251428418,0,e3ce5cfe1def36ff4b144cf4cf5f9b2bdfac6641c54b97eaebdf218f36f04e7c,118909814326
20180516,"PAYMENT RECEIVED",1280901993,0,cb45d2b3e8cf9411f39c628f0724a6b0bddaa05a223f09ab6e8a5c6097a705c0,117658385908
20180516,"PAYMENT RECEIVED",1272944172,0,da96f679f5deac9c5096ce29adcde2feb47b28c0907687ef553116bea422bb5e,116377483915
20180516,"PAYMENT RECEIVED",1251460583,0,de2ad62a47532f9571dcb1ac9e18bbc457012010861e53a49abe5e76fe660990,115104539743
20180516,"PAYMENT RECEIVED",1266988107,0,f6291b1d957877646531674aff41be4fec6b4c58c8cea09af38c5b82dc50640b,113853079160
20180516,"PAYMENT RECEIVED",1250981390,0,7ce308b93f7c9c28d21175ec6d589b8fd6078bac919b4e4b667397ef0abba427,112586091053
20180516,"PAYMENT RECEIVED",1250485478,0,03959eb2ea2eae08f27915419b02dc5db9f02244743d73ade01cc657a4808f3d,111335109663
20180516,"PAYMENT RECEIVED",1250000000,0,f98d446678397e4258c67c7a14b481fddf48e213bf46548acb11b2bf1746d000,110084624185
20180516,"PAYMENT RECEIVED",1250284978,0,d420bb405bb6608c811f26da0977cf7a5fa06556a54cbb92f386120ee7ab12ad,108834624185
20180516,"PAYMENT RECEIVED",1262318614,0,27c02b5ae040f092a613c12ccabd68efbfae6905f0823e1a4705abdf999507dd,107584339207
20180516,"PAYMENT RECEIVED",1278713393,0,58b23836d656a75a7169a33bf1ac8c0d2072e009c6245eecbd7384c6d58b7b7a,106322020593
20180516,"PAYMENT RECEIVED",1270175377,0,997317c2459c40e9161e66ae8848a6fa1ceb24eba14ad744c67b20da4dd8f7d8,105043307200
20180516,"PAYMENT RECEIVED",1307763657,0,7b27263d7dd27d3a35b915ace43d7b5c783d1a2a6aa0bae58867f6af50fe9753,103773131823
20180516,"PAYMENT RECEIVED",1251868359,0,55d6ef26beaad51428bf17e3719fe048ad2e278b65f13976fb1f7adf0d4f7f1e,102465368166
20180516,"PAYMENT RECEIVED",1251054764,0,ec4b7b3531d4ca61dddd44d6267933ecccc02647580428d998cc07e5707a99bf,101213499807
20180516,"PAYMENT RECEIVED",1259264977,0,c8b051899ebdc5cde0c8ffa1548b566de48a98dd736d55c6e73c8e4fc7d774c4,99962445043
20180516,"PAYMENT RECEIVED",1276752704,0,a9a34a5368fc080b406290cba0b4b100ecd69d8ccb3f70be340a4e1b19562861,98703180066
20180516,"PAYMENT RECEIVED",1265607874,0,d39b8465c17980d00e267c2a3efa626a1374af7cc50cc4ed4ceea6925cada469,97426427362
20180516,"PAYMENT RECEIVED",1268384325,0,3c4ef679a8d9e114d6ddaef51b94c7fc75b5c09d35201788f72cd20b93147c4d,96160819488
20180516,"PAYMENT RECEIVED",1255742299,0,fd81ea6a2c7530de7c6959c2f04ef7662bcf7a9988a6bb45d82c991606d25152,94892435163
20180516,"PAYMENT RECEIVED",1250681053,0,d21f7e4bdd3db9d3df56fad760cccdfd786c1771f633ccb2eafa5460feefc7bc,93636692864
20180515,"PAYMENT RECEIVED",1263929498,0,0e15c87c677fd4b6772e492f61d06f4c2c8acc2c00a75d365a7a60a692559949,92386011811
20180515,"PAYMENT RECEIVED",1256319667,0,765a838d5ee7e7d4849e29add53f6594cdd4a7e7d3baee05283e81465f383e13,91122082313
20180515,"PAYMENT RECEIVED",1295203856,0,58217ed13c42015d9a2cce6f99f3d625ca103e6f2ae628add0ae128c79820634,89865762646
20180515,"PAYMENT RECEIVED",1252337871,0,1a80e367c36283ad4f67014ed18f7520fafa98a9f05ccae893ed575ae5c5f94e,88570558790
20180515,"PAYMENT RECEIVED",1272899739,0,34df0ce76d08cabcd1f942a3dabe7b0f1bdd06d363ec5899efc9f0703c39b6b3,87318220919
20180515,"PAYMENT RECEIVED",1259450237,0,b2cf16161623e3c3b77849c755278be402379c3e83e8a3dfe378e92484e4b4ba,86045321180
20180515,"PAYMENT RECEIVED",1260283455,0,cfe6c1c63df06b4aaecd22eb6a63fd9f42069b11245fd3b31931577f3b19f17b,84785870943
20180515,"PAYMENT RECEIVED",1271919711,0,ac492db31b7ba04812c5dd141cbb6e227ea2d5cd5e3eb0581df62889c0a13fad,83525587488
20180515,"PAYMENT RECEIVED",1258742798,0,215c40a76c036d4de60e6385d4f1e99f98bd78a249f2b82cb2a5fc50a55bb56b,82253667777
20180515,"PAYMENT RECEIVED",1282553690,0,d91e377e0d4ad6feed13cdecb747ddce695038c37ef2264b761fa71558be6bed,80994924979
20180515,"PAYMENT RECEIVED",1255053436,0,94872c29b4f65fe8048ddb5848c59003f33e7d6c327b58d34a6998ffefb1ffea,79712371289
20180515,"PAYMENT RECEIVED",1251243545,0,5d46c858ad8eeddc12e2ae724ca2b9464236f387e55fa9e8af5aaffa3126fb18,78457317853
20180514,"PAYMENT RECEIVED",1263770508,0,e3aa29dae7b96eaa3df3c1333985aaf4a36d0c8b637d87bc8850df764d8c6484,77206074308
20180514,"PAYMENT RECEIVED",1297784402,0,adb0fcd9e289ba86a6e7fb489318dce7e0dfe707fdbc7dfa57a0f757532eca47,75942303800
20180514,"PAYMENT RECEIVED",1281059617,0,7bc75200b16a4592b10eca43aeff4217b4358838dca054cbd207b3dd855f9e96,74644519398
20180514,"PAYMENT RECEIVED",1293537294,0,5fbcc2b78231bac65e494682514c49538677dbf430a4d51122a1bff1b2c01218,73363459781
20180514,"PAYMENT RECEIVED",1292223194,0,e3fb6c8054c6f98ff3dfc6844d66367b6d5e6f2ceea1123a4514280ce433b148,72069922487
20180514,"PAYMENT RECEIVED",1262489185,0,48b5191711e8843bc9e5eab93b5befb5f9de741965c059c6c7c5b23b416bb0f3,70777699293
20180514,"PAYMENT RECEIVED",1262042848,0,39b13f169fb251746d96aca3a202f5e1ce9b4a736fdb16728308535d9d7edad0,69515210108
20180514,"PAYMENT RECEIVED",1264769458,0,5f3e9a9c93eeaf413f5224d3dd75412d90e07462cf6845575b8d56bc93c42853,68253167260
20180514,"PAYMENT SENT",0,-58412444912,a634b48466287aa42a5c38646a8bcccf8be0de4c7e0a847f6ef1ddf21c35c4f1,66988397802
20180514,"PAYMENT RECEIVED",1266539447,0,f19f415a9e25d6e2aeb9536796d920a4c057a89314d6f0d471048608be2e0264,125400842714
20180514,"PAYMENT RECEIVED",1260482216,0,b2a4b7f7463f59b8ce8ba3869db27b33ffc5a78b94dd58f230fa1c250487ee57,124134303267
20180514,"PAYMENT RECEIVED",1271478546,0,28216efb7fb55bc886b05c0cb6705bf48158fe34bda00db302c09363ccab95d3,122873821051
20180514,"PAYMENT RECEIVED",1270924619,0,703ea3345313ec54d29343311f4f5c150842efeb3a5662080b59f525028be70b,121602342505
20180514,"PAYMENT RECEIVED",1255818339,0,7169d1645c292d68faf62c2ed5532bb3e16336e40ba7c6c6390b5eb923e46720,120331417886
20180514,"PAYMENT RECEIVED",1287962391,0,28ba09275dd42d2eb72724b89abe584719823e88216be265f810dac1014946fe,119075599547
20180514,"PAYMENT RECEIVED",1263233711,0,f922b53829fc46cebf854e581fc47b3707f708a7a79df1884420afe3a8e19187,117787637156
20180514,"PAYMENT RECEIVED",1278707558,0,581f810e1db8f23aabb32e58092df5bb1b6b3404fefffb8e90264ebe0a869f4b,116524403445
20180513,"PAYMENT RECEIVED",1257593919,0,c8aea9b44b4f622e15a410d7c5b26263854e166f41a172da38c19dd667d9ef69,115245695887
20180513,"PAYMENT RECEIVED",1268551064,0,6a1f5e3247346331caab3cb31b743bf5af5c161787831de16e773c7c0a585e8b,113988101968
20180513,"PAYMENT RECEIVED",1282376106,0,fecd12a87ba6060e0516179c478104fc1c7ad62749a7d46a002e50a7eba753ae,112719550904
20180513,"PAYMENT RECEIVED",1270063203,0,9f391828e8b320f54d67ea5c5376b32445d3ab6a25dccf5b5e6eff25d63a9e38,111437174798
20180513,"PAYMENT RECEIVED",1262753563,0,e969c66df592aea0288d4110d286695a30bad0725712939fabc8881752a859a2,110167111595
20180513,"PAYMENT RECEIVED",1250218655,0,1030d0e0fa724425034a96b0ff7ca98544829dc7d43e0987681c91744c56e251,108904358032
20180513,"PAYMENT RECEIVED",1251397009,0,5252e4c764941230485db15b5fc5eeebfc6788012c85ab647bfe7f04ee42ab34,107654139377
20180513,"PAYMENT RECEIVED",1250268308,0,2e8c642fa875b9e420be16d239da737f3b507d80e63728596be7b55cfc53ceb3,106402742368
20180513,"PAYMENT RECEIVED",1305250472,0,18a615b880de842c74f9519ac5f25288d3d11d3fe0621eeb3a4739daa8ebc188,105152474060
20180513,"PAYMENT RECEIVED",1257308773,0,b9c0080284a6fbdc234bf7fac96f914f39996a0b93299a6c8e38dc84573238bd,103847223588
20180513,"PAYMENT RECEIVED",1257241485,0,d885b823a77e3062cc5a2bc3dd00e0e9d23cf9aed02fcba9cc834bbe9387538e,102589914815
20180513,"PAYMENT RECEIVED",1268140904,0,25ce8ee9c90f1a5e9f8674f80212f496369b6aa2c2155f39c2849f279e187d45,101332673330
20180513,"PAYMENT RECEIVED",1250338242,0,d1f0799d2c59af63f416c7962212048b1b81ad015e8c9bf10500de5f610f85c4,100064532426
20180513,"PAYMENT RECEIVED",1264124509,0,cbe37d6284289588b9351e934fd1194c7eff2cedaae29df9c01c7f26b8639ec0,98814194184
20180513,"PAYMENT RECEIVED",1256900010,0,aa38615bd9b96a2984664588ee197498fd7e01f2dcba523974abb982057b0b66,97550069675
20180513,"PAYMENT RECEIVED",1259749780,0,536fe8c20c10a09a22aed49b48f8d1c9e5ea08f28c26280c99fe746112757004,96293169665
20180513,"PAYMENT RECEIVED",1251925072,0,b50d7389dd91cb4d4f3147d0878ce27b39a0d496d309bc64597c6a6bcde94883,95033419885
20180513,"PAYMENT RECEIVED",1251532312,0,de59d4a30d777ea9408fe880e7a85ca1c7ab0db154f5da795da24f2004220569,93781494813
20180513,"PAYMENT RECEIVED",1256049016,0,3c817da13463b4face9337adaf740785abd3da2b4d5579aca42457ce763370f4,92529962501
20180513,"PAYMENT RECEIVED",1260907640,0,d0a8718e5d955186932134a7f699c2f86bf0d0a5b5f2e03f4bf84d5b5ca258d8,91273913485
20180513,"PAYMENT RECEIVED",1250173670,0,732bebc9c348b97031fc9a3387acf7cb064ce3531a74cffe90d8eb37a7b8e9b2,90013005845
20180513,"PAYMENT RECEIVED",1252264981,0,4293384dd70183855b74931fbdff7a906c7c1959d5c05c8ac11b88f3dd3b1f62,88762832175
20180513,"PAYMENT RECEIVED",1250888004,0,32caec45724cc8e1ddd5f1daf0263a7e0eb45a8ad136db0c435a39fe3f045c77,87510567194
20180513,"PAYMENT RECEIVED",1267526634,0,0b8430e48b8a07cb91c1f43b5d4bd865a49f0cd1a261f1937864d1283d531ac1,86259679190
20180512,"PAYMENT RECEIVED",1265840761,0,9f0117a884d20e20c4ac13ed86dd7108bbc911635522ba300d02dcc6b2ae6a7a,84992152556
20180512,"PAYMENT RECEIVED",1253796231,0,838ddaae207b028c2a5417c11e7f24df60ad171d197246e7766bad892fe0dd88,83726311795
20180512,"PAYMENT RECEIVED",1264463844,0,0da4f4f599099f7f5ae1dd4856a5173a35ee9b27590218904fa1fe82c5c063e4,82472515564
20180512,"PAYMENT RECEIVED",1257043794,0,81bb2501a3a31274fd02c76b1d27138eeaa527fde7f71b2a8b6611ed3ba82105,81208051720
20180512,"PAYMENT RECEIVED",1254012882,0,0b36a289978ee03c4a23d2ddd1cba976bc3d2cb4525f382e2b7f0bbbb532371f,79951007926
20180512,"PAYMENT RECEIVED",1253949804,0,3d688a3efec99a3a450468b8097afdd8bd494240bf9938c11bbe14d5dd0eb286,78696995044
20180512,"PAYMENT RECEIVED",1271707473,0,78b415dcdc209f416bc28d206a67fcbad1a28fec83dbb5ffd4115a504cd7d47c,77443045240
20180512,"PAYMENT RECEIVED",1250480547,0,373c84aab96a0610b7eee7d112f1347eb159f302d999a91299443a888479700d,76171337767
20180512,"PAYMENT RECEIVED",1260962379,0,d05dda7afd87856d419cad84c44d6703623ba12d1e9d51d92dc82dfe222a1ba2,74920857220
20180512,"PAYMENT RECEIVED",1257495775,0,46d6221e5dc89f2c448457e0d51e4e8ca5adab75c0386bee248a6c74394ccfc4,73659894841
20180512,"PAYMENT RECEIVED",1250561046,0,eb406472a3b2f359745ffbbdf844535d4c8ca15ac333bcb8be527852270cc25c,72402399066
20180512,"PAYMENT RECEIVED",1262158394,0,d7b55d7fdfbfd13882d176002b7dbfbb19a47e77df88fa11c2a5090a3005f678,71151838020
20180512,"PAYMENT RECEIVED",1257304706,0,4b249b54b8a7b8b3ac54c32a0e60e44318a24766ff73781c6e7597b45a043f43,69889679626
20180512,"PAYMENT RECEIVED",1253934863,0,e3e0d2afdae34b0d52d369163db6b74562a82ca02dbad7fada45421881a7eab8,68632374920
20180512,"PAYMENT RECEIVED",1309806399,0,8c32771ebedfe9ea421996db4c470c3c6979f8e4e5fcb57849384be120e3b625,67378440057
20180512,"PAYMENT RECEIVED",1290594199,0,340f43ee2c88d715a1c3cedfbbbaacf783a5180d87c0f89d1ae724d8d94662ca,66068633658
20180512,"PAYMENT RECEIVED",1262893304,0,4f1fa07a12e92092284fe7d50ba189b8bf5c403de6643d13286fcc91889ea86d,64778039459
20180512,"PAYMENT RECEIVED",1251870342,0,274ae68cb3c671b6562ab6ff0bb11531d338db6610e49a4a1bef2b97b10acd3f,63515146155
20180512,"PAYMENT RECEIVED",1258770120,0,01aeef615250ea2aa00fe779bf40c35d1b9a3405fe392324ada0e79f172370ec,62263275813
20180512,"PAYMENT RECEIVED",1303963290,0,b2ebd057699f309d6819a12b0dcb2b7a4856e498a4c44ca88c6b41169ab579cf,61004505693
20180512,"PAYMENT RECEIVED",1287019553,0,05735589ff28f5497fc45e00b48650257768382b91061766dff4ac075489a1e1,59700542403
20180512,"PAYMENT RECEIVED",1260839495,0,fdee22557f5fe1d8e3c7f40e7472dc566e05986b21c04eb9a53d4478c007d147,58413522850
20180512,"PAYMENT RECEIVED",1294279324,0,e8ef6e07d6c42be2fd34f0f5c6f320430c59575c306bbd90fa6ffbc5d4b101b8,57152683355
20180512,"PAYMENT RECEIVED",1268645081,0,e35671324ef20eedbce48d2ab68986013b999d18b371a773096a8d22d90b86d0,55858404031
20180511,"PAYMENT RECEIVED",1263978739,0,3646ef13d15701dcdefa8cc607a49da726b1316eae163a504da75872409c3af7,54589758950
20180511,"PAYMENT RECEIVED",1298358923,0,96464f9199f7f854554a617c33f4205296c63229be2fae1d7fe7b3bef431e56b,53325780211
20180511,"PAYMENT RECEIVED",1264082133,0,c69362932ad43eea5edb8706a97b2850ffea7a4499dc1600c1a8d0c0b0b93c47,52027421288
20180511,"PAYMENT RECEIVED",1293053872,0,5fcb5091b13d5a056774f58be0085be20ce54abb18fb93f0a81c3c3d2280d808,50763339155
20180511,"PAYMENT RECEIVED",1341160466,0,89f9eedb21852c50634d2576899524f1c17bc046b043ab3c78de23ea88ab9b6b,49470285283
20180511,"PAYMENT RECEIVED",1275817587,0,44d1ab80c01928812744e4d4aa71af77dad9d280861f8482f2ade54af67e89cb,48129124817
20180511,"PAYMENT RECEIVED",1256471345,0,ea54d01d10d322a02c92984a4e579d98a1bf40596eed4ad3f5e1e658a153a224,46853307230
20180511,"PAYMENT RECEIVED",1258977829,0,da1f241a16b2a62be2d50ff0a7f92bce4b4febedf658762a5cf9998eeead3571,45596835885
20180511,"PAYMENT RECEIVED",1273101182,0,032008bb059f6f77826085df56381364a01d512cc9d1335eb331248c6a1eacf6,44337858056
20180511,"PAYMENT RECEIVED",1288348649,0,4014b239f36ba6d5e72403491800449a5a68172a57fca6a9236c3b2a641da8b1,43064756874
20180511,"PAYMENT RECEIVED",1276196049,0,4ea573b3f227cebcfbf9aa00cc7a182c972c4ba405be49759d7b877dd361adbb,41776408225
20180511,"PAYMENT RECEIVED",1268968037,0,2f648b302b7cf4c87999d4ab389add275b3e6d12299761f1f32b3dc81e91b295,40500212176
20180511,"PAYMENT RECEIVED",1278512550,0,34c9e5be1b4e53d479e206af03f15d82b188c8fa5b5d49d29a8bf689e9d78a2c,39231244139
20180511,"PAYMENT SENT",0,-97752495381,49f09fcee361beb7718ccb16ebc8cad118034467c8c3e75530b9489691e185bf,37952731589
20180511,"PAYMENT RECEIVED",1291098512,0,c0a236de6090181710571e01dccec879f8b2b33edf83e7cc0bef94145e243f97,135705226970
20180510,"PAYMENT RECEIVED",1263734331,0,6484eddf51424a0e0b7d8eeb63b37f39e4ed0097e68dcd4fa0bb343e4f33ce5c,134414128458
20180510,"PAYMENT RECEIVED",1255571232,0,3d4d2318aae0be50f97791fa37b78410168650467fe9ec7c87662668f2f479b8,133150394127
20180510,"PAYMENT RECEIVED",1255665985,0,855a6fb911820400dd7f9e3871b2b0af9c8654d3022b08fd4305b208312d4037,131894822895
20180510,"PAYMENT RECEIVED",1276512057,0,9c4241a8ea0eb25bd45300beca6b859513611bee36666f4a32859acfc7aa6557,130639156910
20180510,"PAYMENT RECEIVED",1280516502,0,fd0fa3c80468e17d6974a87c339b61db0c7bbf46842ed7ed3673b520242ac837,129362644853
20180510,"PAYMENT RECEIVED",1266455784,0,ae5c1ba23c390951c05853e4bf852ab4ccae7945c6944a5d1a717a747921716c,128082128351
20180510,"PAYMENT RECEIVED",1316811270,0,1ba91f84bfc5d5d7179715f4244505e15fa8d4e4a5f1d89d7a05760aca560aa7,126815672567
20180510,"PAYMENT RECEIVED",1257963103,0,593258d22f243362eff0304d4fb2bd0f0cae00eab053f52338971dad00c76ad9,125498861297
20180510,"PAYMENT RECEIVED",1258464240,0,a84a101cc97862cf47485da0b00246afa54c224d995b0260880ac705d99d344e,124240898194
20180510,"PAYMENT RECEIVED",1272645263,0,ee9428e345769cb5c8476bfbb8576e493b6b45448c9246e7223981c2ba020107,122982433954
20180510,"PAYMENT RECEIVED",1252660260,0,0bae9e0736b99e7a49b36d61256f5b2745d3963618931b695809f8b64448beb2,121709788691
20180510,"PAYMENT RECEIVED",1256324691,0,9dd35b8bf0b446368c2392d1d16db28465a0244c146b65bd5cf66de0816fd098,120457128431
20180510,"PAYMENT RECEIVED",1262391190,0,93c6ade0cd7d87d7177bbedc23119bb31e7c703bb85a5cfb12c07890fda0ae2d,119200803740
20180510,"PAYMENT RECEIVED",1251980464,0,63d9f90b8f158da8fd74cce1f67b1d9545a5d7274b89f7761734651fdfa0c362,117938412550
20180510,"PAYMENT RECEIVED",1281427889,0,d60d13c114f7e8bcdc170477ef83017261cd917c621f9dc15bfdbfd959b1dc5b,116686432086
20180510,"PAYMENT RECEIVED",1258428220,0,49ea4bdc4cceac5291b68cc8bb66d87c574d79faab9205f8777e949aec22cda9,115405004197
20180510,"PAYMENT RECEIVED",1256991682,0,39bee2dcd7495f091b6a0ba0e3dffe830c2c7abb646343a242fd200071849878,114146575977
20180510,"PAYMENT RECEIVED",1252759122,0,74030faf4ca0ddcdc557d7bdf0dd6a1309313244c6637f6bb80f4b9f140e25a5,112889584295
20180510,"PAYMENT RECEIVED",1262036054,0,2629bed0307ed45a36a2faabeaedd9eb1c2c91674c243babf13145ff2652b6c8,111636825173
20180510,"PAYMENT RECEIVED",1250904715,0,5ed591e8aff63b4e3c47d155ebfe7b8e1b6c6ce4fd5739ddfacb69f2c6565d61,110374789119
20180510,"PAYMENT RECEIVED",1259464142,0,78b8f49407d09901d9c13914977cb9a9185afdc9725d782bf3f1910c6b969263,109123884404
20180510,"PAYMENT RECEIVED",1268396475,0,97733a54b6f0999cc0a3b83c39a9923a99c7d16ae944ed98e8c0f85b83384aca,107864420262
20180509,"PAYMENT RECEIVED",1250544443,0,3936d2565b4835140010443cd88ff288b7a773739f593585e940a052afb4982a,106596023787
20180509,"PAYMENT RECEIVED",1268088335,0,3b310055655e06f96a1ea0c11cd82e3d02fbab47731ae2665fd9fbea421d5765,105345479344
20180509,"PAYMENT RECEIVED",1251140850,0,477541ba54e8825f49270756eac182dd3e751b59604964181ccd2da7f57b955c,104077391009
20180509,"PAYMENT RECEIVED",1287269018,0,f0d56d112374b3aa51bee99b55630f264d7c5d168f28ebaed5f999e74a14b401,102826250159
20180509,"PAYMENT RECEIVED",1262356739,0,f2c6ff74340c274636e11ed89f3ef334053a44abf3f5ec8c4d0fb58a735380ba,101538981141
20180509,"PAYMENT RECEIVED",1283663524,0,2ab6cfe7c74f063f89df3991927eefec90d952561dc5f3613c559a6ece8d44b8,100276624402
20180509,"PAYMENT RECEIVED",1281565640,0,e84acf49ca13389951a812aa1dbc7db0eda8e9dc5a32e3e76a10031cd99d34e3,98992960878
20180509,"PAYMENT RECEIVED",1282202459,0,ecfd44840bc84ac121a92ffdcd813a1abc583d934de46853573676aa4ee063df,97711395238
20180509,"PAYMENT RECEIVED",1276591912,0,df4c8627e3f342827aa417a6eb4941725fd05d9d7a511a2f3dd001793f8e2164,96429192779
20180509,"PAYMENT RECEIVED",1254178735,0,ae955c5527bdd7382c0dd2826c4b44852a5140a85e8f698b825c80d253ea6f72,95152600867
20180509,"PAYMENT RECEIVED",1272714415,0,5ec1ae6dcf37bd47aed38c47a2f7d5c98d919213d39b58564933a141dd333d4f,93898422132
20180509,"PAYMENT RECEIVED",1260050200,0,b7b0f3190e3200516f9c7790fbe1639e98fc5c291d1481012222fb8796fb07b4,92625707717
20180509,"PAYMENT RECEIVED",1252864158,0,825f349c6d543e096307d61798b9a2c70c88b519fd77f19c9c1167726917aa19,91365657517
20180509,"PAYMENT RECEIVED",1282517651,0,aa8a54a26b02d6af1f3c4885bb47a2aca41ca6a8674e45044184a7bf2d35abcb,90112793359
20180509,"PAYMENT RECEIVED",1274100012,0,b7db6ebf31f63a10b8d48c0f25493ee78b28e6e544846766994f07f3da4ff1c7,88830275708
20180508,"PAYMENT RECEIVED",1264534384,0,d8494dbc4797b5e6969f2e6b39faea954c25e28be125a43884c11981f61144f3,87556175696
20180508,"PAYMENT RECEIVED",1251718836,0,00f77c6affc941093d15ab4d78930e655666f699eca4a88cd0ce7fd562fb4dbf,86291641312
20180508,"PAYMENT RECEIVED",1260151254,0,6c346ea8edab3bd81ebd0f61800da4abab98a2e891bdfeff4c93cff2c6007a72,85039922476
20180508,"PAYMENT RECEIVED",1271662462,0,1e2483c60858faa15e5a7c83ec9693ecb0c4267f24f288fa78ee66052cbfb617,83779771222
20180508,"PAYMENT RECEIVED",1267711242,0,ff203499c57105cdb847e51055baccf2cffcf69e6bd61acb887c8d71508d735d,82508108760
20180508,"PAYMENT RECEIVED",1298641716,0,65160aea8d94ff610066965adbc07fc43476d5483c6084779fd07af9fc8d4e9a,81240397518
20180508,"PAYMENT RECEIVED",1255735898,0,88954dbc4b64194a7d53450855d5790cd297d3bfbcaa130d0d3b5c8232378ae3,79941755802
20180508,"PAYMENT RECEIVED",1264280633,0,a2fd9418a18dfe245ead7029e68efef83334c5776e9ba8d792dc05b52146774c,78686019904
20180508,"PAYMENT RECEIVED",1281528380,0,e5e2010421a4a35b34b03bd3a2075df68fae6b64b0daee9e7f538a729c30608b,77421739271
20180508,"PAYMENT RECEIVED",1300868193,0,f867e9c1f9d4c5663e3eead39b29c6802a07e9f9efa2a8e0ee42e63c9b07b0fd,76140210891
20180508,"PAYMENT RECEIVED",1265233893,0,a1e5c2ae361e0f6911bb516f4882479af28a886f7ee42a911ed0ca8444c70ed5,74839342698
20180508,"PAYMENT RECEIVED",1253031021,0,da2a4858665a2d1b479fa5488d52b2a7073d68afd355bb59b38178f6e99b27fc,73574108805
20180508,"PAYMENT RECEIVED",1279116763,0,eb12e826f58cacc231b66e99f646569d1a57af8306087f6f036b8f64deeb52f3,72321077784
20180508,"PAYMENT RECEIVED",1269904725,0,7a58885f4f2bbb92a0aef40d731be1a426d50614a966314b9ec34037da4c57ab,71041961021
20180508,"PAYMENT RECEIVED",1276770469,0,2474a5fa861d95c16c3832efc82270298f4b72b050c31ba4d9f00eb559f24d82,69772056296
20180508,"PAYMENT RECEIVED",1260388654,0,86e3de611b0a45b8610f9d6ffb6a57ae537e0674a76ac415b75ad70cf23d01e8,68495285827
20180508,"PAYMENT RECEIVED",1284484569,0,25c43e1b626f7d7476c13ff93d2aa5fa23157ac04d0220b5b8aede003d288e46,67234897173
20180508,"PAYMENT RECEIVED",1280604017,0,3d292bbb57fcbec66eca89e98adc702d3278711c31bb62b3bbaa620add5d3cb7,65950412604
20180508,"PAYMENT RECEIVED",1278965483,0,884011ad0c25e45d7c86c255c84f6814a840e0c7f6545e05435e004f118c761b,64669808587
20180508,"PAYMENT RECEIVED",1275675105,0,4dcf8d2ba52f4a4a00e4750ff23f813272ce57fff85b76c3ebd4fae659a82567,63390843104
20180508,"PAYMENT RECEIVED",1273842759,0,d2d2e7612080e772ffa89a2c24347ce32dcae65b6f035857399bc5e93f84eff3,62115167999
20180508,"PAYMENT RECEIVED",1296675596,0,884c686d1aaadb0671dd7ab6f4100ca38d748c4b7966b85fbc5c1608b7379193,60841325240
20180508,"PAYMENT RECEIVED",1277480945,0,ad9029c83978cc8144b98a86032870049d1e9d09e2b3e915940313c99c781771,59544649644
20180507,"PAYMENT RECEIVED",1263039552,0,f69a03f4dd3702242c139a25f1fe3746bc6de0eb15edaccab973a644c7c005a6,58267168699
20180507,"PAYMENT RECEIVED",1282506823,0,a7ba7748b2717f84ffe6ec77f1f1c5ccdf3e51096a66598c9e81ce69612fe38f,57004129147
20180507,"PAYMENT RECEIVED",1296666265,0,0ca09cb308679ecc633887b55af2b7fdf7fe63e4d741945ab67c4c8efc5a39de,55721622324
20180507,"PAYMENT RECEIVED",1250780758,0,61c6ea1d3a3af0198c35f175c916bcfba3a82958491a8858af599797ecb2daa4,54424956059
20180507,"PAYMENT RECEIVED",1270185743,0,1c7c4e8eda09adebc4cb2d6c5823708929b04904cd53f3e84e293c655f9ed7df,53174175301
20180507,"PAYMENT RECEIVED",1267107997,0,7c20bc46fe8d592f3cdb5dbdf3d45ecde6d48b6c72b5c3738d2b151ffdb4081a,51903989558
20180507,"PAYMENT RECEIVED",1266511375,0,533420d681540f000d091ebb193f64e437b5e9ba05c3785433f7261b22118e42,50636881561
20180507,"PAYMENT RECEIVED",1275453106,0,24d719a671530c9cb3329051702e774dbbc87e5153481dd0a6ae38f00ad94041,49370370186
20180507,"PAYMENT RECEIVED",1271625643,0,a1114845dbf8e8048f15a03b87b098bcfb1050ea946f1c4989ccd5247411172e,48094917080
20180507,"PAYMENT RECEIVED",1318094564,0,523d6d3c07b54ad3664cf2d284cd3edbb030b286ac1ab2fba8fb9f9a1ec2df1c,46823291437
20180507,"PAYMENT RECEIVED",1353859184,0,0646eb3372d00dd3974514c5b6847c9e2bf35305a6d91b51fe86d5b05ddfef36,45505196873
20180507,"PAYMENT RECEIVED",1304032821,0,9cf6f1108534b8653d9f20478d5d78db758eb9cc1728355d6c3b4da5ae5854e6,44151337689
20180507,"PAYMENT SENT",0,-95684281701,db05653243c2640be68045498490165ac3b2a37c12b40b52104372857b4d1889,42847304868
20180507,"PAYMENT RECEIVED",1274450918,0,dc47f0a870fe7f20715fc8b18e9bf6c87d75988811402400577e58f75c70c581,138531586569
20180507,"PAYMENT RECEIVED",1255126799,0,accfa56a44a9974c14552339dac500958290aa587f56f3e30ed730fca19c9df1,137257135651
20180507,"PAYMENT RECEIVED",1289151045,0,26f92a19a252fe485b84506156adf143f81845eb670939b160bac835c794be0a,136002008852
20180507,"PAYMENT RECEIVED",1250000000,0,f3ec43e356fa35838712eaf0f6ac679022f7979c2b975b1cfc775cca934ab5a4,134712857807
20180507,"PAYMENT RECEIVED",1262541843,0,e655f705c3d4aa940d56931956caa24775d8b80ae28a3a8849ac081a050a7c10,133462857807
20180507,"PAYMENT RECEIVED",1250566174,0,34892e7e2b56273a0ab4cf56916cef97eda7792beac27b35d254ac57d2a61c3f,132200315964
20180507,"PAYMENT RECEIVED",1268879640,0,79d3b2a771a1d77a1c545c6fbc1a470047239285e62c013d5ee62a48821c1664,130949749790
20180507,"PAYMENT RECEIVED",1251519824,0,1a2e6cc51cc231346c24662c791619930c5fdef1df7c6852de17fec9a06388dc,129680870150
20180507,"PAYMENT RECEIVED",1269211948,0,9f1d5b470b442a4f1460084f3f66dc71d121994cda041adb8fe3b0cf7d2abbde,128429350326
20180507,"PAYMENT RECEIVED",1251059244,0,ef3e4778c316156d65ceebeac7dcf00d0dd15cf5d3f0f1c302f618ae0feb2ecc,127160138378
20180507,"PAYMENT RECEIVED",1255934165,0,5d70599a25ddd1192bcfc71566eb270dcc46e328814b5df1dbcf72deac3e124f,125909079134
20180507,"PAYMENT RECEIVED",1265487675,0,083fb6dfe53cd4395f65e067a8f7835a63338427ae1e626ccf81e0b07dfa1c6e,124653144969
20180507,"PAYMENT RECEIVED",1251739048,0,7a00728e627d4aafb7d73f0b72ca4c5289dd85c4dee125d7a82aaafac4fe9f68,123387657294
20180506,"PAYMENT RECEIVED",1250215601,0,b97121eb7dcd75cf136a2e2241a4d4567a188649228bb16779f53d452c30d99f,122135918246
20180506,"PAYMENT RECEIVED",1294419329,0,e3bd3a7ddfbb8be00f76de4fad58e2e8a1e1b675548ba8ed048aa11efbce9ac8,120885702645
20180506,"PAYMENT RECEIVED",1259690155,0,58138ef8e02e478cef57870f53e6811a2e2bdde633cfa2a6aafed98776723e69,119591283316
20180506,"PAYMENT RECEIVED",1289134508,0,80d6da113176d3ad1f685766d714a11c8ee9bb5838110fa96871e3b5cc06f6e3,118331593161
20180506,"PAYMENT RECEIVED",1263902574,0,59968700285fc680021489d78aba30953f6314f18a3fbca000e5252cbcf34c0a,117042458653
20180506,"PAYMENT RECEIVED",1272373950,0,d2aee4eb05b8d754d3cb188c80c7b1db1b4b437497258f2ed0364f296888ba58,115778556079
20180506,"PAYMENT RECEIVED",1261624588,0,d1527d9d7bf5793935f46e98b43b366ca37d2ccbc26e049ce99aec8eb4e28142,114506182129
20180506,"PAYMENT RECEIVED",1251721128,0,922de8cdc4b595af31e6fd4fd70f403a43c9ed66610dfc3e26e01555b46790ed,113244557541
20180506,"PAYMENT RECEIVED",1274326804,0,c2b7dc0c9b80d62595910907bb95ec326f242474f4db5a1867cbd4ff37f122f1,111992836413
20180506,"PAYMENT RECEIVED",1279575265,0,e6bf2d4bb060099cb77edc03d23c8a20554b3d936c389631742de2a3949a9a0a,110718509609
20180506,"PAYMENT RECEIVED",1263931489,0,a0a56fcacdcc592469c7f40454c9d0b993a3c456658968c6adddca7d939e91ed,109438934344
20180506,"PAYMENT RECEIVED",1303025856,0,64e1b45c2e97785f36db4e4ef747c96664734e84fcffe41b538da6cabf155090,108175002855
20180506,"PAYMENT RECEIVED",1266249760,0,037b94b1f26844032d5874ddd18e3b0eea1d753e916895e661607a06386169da,106871976999
20180506,"PAYMENT RECEIVED",1261257746,0,dbb9e120859b3e66caf0252e96159270a5ff7ce193f293be76e7f530ed39298b,105605727239
20180506,"PAYMENT RECEIVED",1253073628,0,e78d7d62a6542733cad017b6c1c42e45b1fffb4b4394a8ff66af5003cad4817f,104344469493
20180506,"PAYMENT RECEIVED",1254430565,0,ae80a2e1004f8eb71a1d1710fa2f08669d31cbb5de6b6d9ce96de3d409c0d57f,103091395865
20180506,"PAYMENT RECEIVED",1266341927,0,eff8bf7d81605a4806762983ae9578879d4c639b875f1d030d20a9816d1371e1,101836965300
20180506,"PAYMENT RECEIVED",1257785516,0,3245431a4a379cd7b9e82688113f21ebd1c03a2e3e72eca824ff3d829c556adb,100570623373
20180506,"PAYMENT RECEIVED",1254927906,0,56b81be582c30dff06f2ea80eed56b5e2a88f146332d15d5474307ccdb3d5d9b,99312837857
20180506,"PAYMENT RECEIVED",1250554455,0,1bf9b1f5c9f8176064cd369e482be84853987cd059e083d11abe5496b0dc3dd6,98057909951
20180506,"PAYMENT RECEIVED",1250000000,0,d05ea254d7d68b044973bc26b569d3a00be25f0a504dda50dd55fed628708e9f,96807355496
20180506,"PAYMENT RECEIVED",1251994776,0,d2a493ce275c07c2d993c025ebe8fdbedd0053f0485d92f56485bcc0b63496bf,95557355496
20180506,"PAYMENT RECEIVED",1256129396,0,e726c265dfb779fe36a6de6c8abd8400693e0ef92bc35d8489e59a4ee594ecd7,94305360720
20180506,"PAYMENT RECEIVED",1320536395,0,4a9a7f143aafa296a3af870f3e8fd5e7d99ae6ef1a7fa92fd7f9b90dc7fc77f9,93049231324
20180506,"PAYMENT RECEIVED",1301469236,0,77c00a94de763fe03270a9c3848d8f62f2a9209a61b65c2b93a4e020077a97b4,91728694929
20180506,"PAYMENT RECEIVED",1255447440,0,3a6c905555aaa6f23c9cbda5b38708c30c3af970e7f8e71c15b9b6a5af0c10f8,90427225693
20180506,"PAYMENT RECEIVED",1315053193,0,64d56b5f70fdc15e7c9f14662490eb8834c80bc70c4e701fd124efc736930238,89171778253
20180505,"PAYMENT RECEIVED",1306867772,0,9ed87af8e8601a9a9750ea796c277a01dec236e1d7e9af862e4c6881f77e5edb,87856725060
20180505,"PAYMENT RECEIVED",1266355020,0,ed5899a1b6ebcaf28c58a66d51b04caeac382e7af62d64a6620696f034a3b01a,86549857288
20180505,"PAYMENT RECEIVED",1284436752,0,9b6330eea5138118be7f87f3d5c533cefaf18d4fa768bc185a9747bbcf265d21,85283502268
20180505,"PAYMENT RECEIVED",1271976124,0,a300cf21d0e1518e5a0e87f065d8641130ac4f0737b48daa610e523724407256,83999065516
20180505,"PAYMENT RECEIVED",1253930756,0,634062428f0c6fbf1c506f56d1346aee0110a148e836b55d4d2220800f212bf9,82727089392
20180505,"PAYMENT RECEIVED",1261738379,0,866b24379e5ce65e8a4f9fc426f74d47db7c1e80ad90600459a5a868cb7d7d97,81473158636
20180505,"PAYMENT RECEIVED",1250000000,0,b80566454c591c4f80d5cfdea6daf3c26ebfa411c6ae03fbf46c32d801b9e9e1,80211420257
20180505,"PAYMENT RECEIVED",1279804477,0,ac011e8722751cdd482c147c1d956b82e4344600321043c2e2f90a98bf9f1d80,78961420257
20180505,"PAYMENT RECEIVED",1251267638,0,61a75defe9966a34bb4ced0b7b7616e3d314e115d182699b48079e6350b24a8a,77681615780
20180505,"PAYMENT RECEIVED",1251806564,0,c767be84701dad2839c79c233c8a55da33305a6227a08e1010af767fc7a28774,76430348142
20180505,"PAYMENT RECEIVED",1256768698,0,f12478599a8eb779c5395b1d2f2b58d74cf4f424ac29e4d9e52dc1dd1ff59e78,75178541578
20180505,"PAYMENT RECEIVED",1282074280,0,9633275a9c33118c63708c7de77a50e567d36f7d90f37ff7f336283d90f8ecfc,73921772880
20180505,"PAYMENT RECEIVED",1253927162,0,9a020b9e092c44b53c58ae7d17da0c4bf4d84dd9a587c7e3d21c81788f9af9a1,72639698600
20180505,"PAYMENT RECEIVED",1289885175,0,9b1fab59b11f0033e5e7e3f6524641dd2de459530e1665b0022b49198f1ef58a,71385771438
20180505,"PAYMENT RECEIVED",1272080288,0,e08f23fb51e0231e7f5c4a894e78e2348ce86163f9d08bca403e8c4c32eb1373,70095886263
20180505,"PAYMENT RECEIVED",1250690985,0,4e2a4ef8ffbeab2efc303aa00904b55347648bb91535d0869811d1b48c70c2ae,68823805975
20180505,"PAYMENT RECEIVED",1261013238,0,410b0b8200bbec187f2a69104a1fd9f978847ee88791f7ed09519e20324fae98,67573114990
20180505,"PAYMENT RECEIVED",1313584733,0,a0118ffced8ce67670c1ef002b4a4d88bf931691b6a13c92b7bf5a8f990d8ece,66312101752
20180505,"PAYMENT RECEIVED",1279627192,0,f05fcb0d511e2d8585c1636a9ac092626b33718475adec9c9decd2995021f8cb,64998517019
20180505,"PAYMENT RECEIVED",1250647099,0,2dcde44a3bd0040a7d6d1b7ece956e6f4bc5bc6e935e9d60f2c638fc030e080e,63718889827
20180505,"PAYMENT RECEIVED",1255706120,0,8bee31e853ffdb3f6d0cd5ef86f86fb5a42edcd99e7632b4412ce95d954b0f67,62468242728
20180505,"PAYMENT RECEIVED",1286990044,0,9a33f69fa8340dd41ea9613ee3a203d8e9ff129c16c6de1ea3ee28628fce4f07,61212536608
20180504,"PAYMENT RECEIVED",1255796414,0,7043ea3d1e418bb35738e2065c5ae1d56a60a76bacb9fec5b4f238577473f520,59925546564
20180504,"PAYMENT RECEIVED",1255663953,0,17546e9482b1b9c0a494a28fddb224b2b0552ae15b65e4e96291fa26f53a3bb7,58669750150
20180504,"PAYMENT RECEIVED",1255914883,0,c1daccdcedfd35c1376ef3207a664e84fba877acf9852d3369d8050751765898,57414086197
20180504,"PAYMENT RECEIVED",1250000000,0,1811b141e3c11a78b5f6992b68c9086befe98fe2bbec70b6bbf2b38c0248f6c6,56158171314
20180504,"PAYMENT RECEIVED",1290107255,0,17e28371bef47a31f0bfa51787299e5cabae74f55644574357f65b7267a0bbc8,54908171314
20180504,"PAYMENT RECEIVED",1267492515,0,b8aaad21b9fd79c11198d3046e352aba1a6728155047ce3b2db7f391ec9962f9,53618064059
20180504,"PAYMENT RECEIVED",1278332061,0,0650b73db16eab83fb1c3efa58aea9de99fb33ba213ab61d62e4a4ac2495b1ca,52350571544
20180504,"PAYMENT RECEIVED",1312575245,0,74f4460a404956f9cdb26b464ab4d5ced2f314876e004ad264fdb24333abbca4,51072239483
20180504,"PAYMENT RECEIVED",1277176837,0,21644b00cf4b34f5de88063b295f37f9aa00ac65d2974f343cf840089a637581,49759664238
20180504,"PAYMENT RECEIVED",1253185142,0,1f3cbda316534a85af0ebb654fd2bf8c8ab1f24c63020ed40c34b27c7d9fa316,48482487401
20180504,"PAYMENT RECEIVED",1263859993,0,ed35e41495586fa4cacd873007654fe46e0b2de006e781d2fbb9bd3413a9e935,47229302259
20180504,"PAYMENT RECEIVED",1318008806,0,22f028cfd0cbf31e75edf2c01563c247fc9d966f89ef4b674eba7783d1da8c3a,45965442266
20180504,"PAYMENT RECEIVED",1258334452,0,f8c451193610503d51b71160f736a99f042bd8f9c877ef57580075a5e9d75be6,44647433460
20180504,"PAYMENT RECEIVED",1290580246,0,2f1c4fe26fd5bd724ffae42fb22f9e145df77afbb562fb72d66cec254ace4df9,43389099008
20180504,"PAYMENT RECEIVED",1259211276,0,482a5f9fb4c880be0efdab59ba2bb202c36449a25c7223b38174664f2ae923a6,42098518762
20180504,"PAYMENT RECEIVED",1253025546,0,cb4d512ab2e1489fa1d390512d08e1374abaddd2b2dd3221fb413c520db1e48f,40839307486
20180504,"PAYMENT RECEIVED",1250020581,0,58c6f4b155a6cde9383595582de9155158af4736dbc4a59485dfcf6d18471d0d,39586281940
20180504,"PAYMENT RECEIVED",1266641299,0,9987f1322d0d4fd441583ff6ac1c9e58f650d6383ce69db320ffa5d4cd588ebc,38336261359
20180504,"PAYMENT RECEIVED",600000,0,8f749268c6170c1c8f9e50937a28898a85e32ea1958640a329e83c6be8ed659b,37069620060
20180504,"PAYMENT RECEIVED",1287331972,0,bb6ab3066a9d27ac5220582dd1cce48445e91ba6ebed9e3e24da9d2bf9ce2368,37069020060
20180504,"PAYMENT RECEIVED",1254739977,0,754c6d62a333ed66981c7b33d4f8709f0ea2338de6f4773dbd0fb419ee8d16a7,35781688088
20180503,"PAYMENT RECEIVED",1279770243,0,da0a35f34f825dcae54ab2d5b9003797d349beddc68034e828a5d155da6c81f2,34526948111
20180503,"PAYMENT RECEIVED",1276325853,0,54c96deec7d734c3f87f23dbb539b0ebec14a4f22e28542a5fff99606bf5b5ac,33247177868
20180503,"PAYMENT RECEIVED",1289497307,0,56f657ace9f78a3faad701b23f67a15af51a88415fd6c6b268f1a75e17eb80ad,31970852015
20180503,"PAYMENT RECEIVED",1253158843,0,1cd197f3f584ef6537ccd39b2436ff0cb28efd8f07b063530dd9a14fb5419419,30681354708
20180503,"PAYMENT RECEIVED",1291972829,0,ad232fe89f0047bbb75769e10ac727b39ff9e905014d503804b64605297dc356,29428195865
20180503,"PAYMENT RECEIVED",1319354322,0,d2e081b1ea9f2b853a0a1b3f5e77cfcf27b4cf0c75c47517a56686a2f4a5f47f,28136223036
20180503,"PAYMENT RECEIVED",1300740460,0,f7d912f32e3b5aa1f5c4826c818766c43e598549b9640e505b5844b034296ae3,26816868714
20180503,"PAYMENT RECEIVED",1261843319,0,263f2d168c164e074dc594631a500eb15f089da922a4578df6a381a2bcf1ced0,25516128254
20180503,"PAYMENT RECEIVED",1288078904,0,36051a0187ca921912935426240f9e5c14e65aa672a48c705329c3c8d6929bf7,24254284935
20180503,"PAYMENT RECEIVED",1266073673,0,a7125d1a88c2d75100784b2ba97df67d9e408bf58f03b037d80469d59638b164,22966206031
20180503,"PAYMENT RECEIVED",1289801862,0,c45758641d0541916a3bfeda944e3b063074b23343b9e520d02c64ad062eac14,21700132358
20180503,"PAYMENT RECEIVED",1252333536,0,c79ac23bcc9178b0b519f5ec0faff2bcb0e4c338873f644ea8777fa0d3e329c0,20410330496
20180503,"PAYMENT RECEIVED",1293585097,0,e0f537cac31ac54bd3e4bfdbc02217a58e2983c4a28b7794b3052531d970269d,19157996960
20180503,"PAYMENT RECEIVED",1254816445,0,aba92b6ababb94f2cbb8b536e371b50d28309619eb8a29ac65be106865fcc116,17864411863
20180503,"PAYMENT SENT",0,-95302915935,7dc952751230d2d6504c40f6e2534d9081505ce11749b749c60ac8524a41f96e,16609595418
20180503,"PAYMENT RECEIVED",1262983617,0,bbbaf4b1b417393e7db3d0b5228659a6e869ecae255caece516f44b6561c9fcc,111912511353
20180503,"PAYMENT RECEIVED",5000,0,8be6b9b1f26424cb73706dc0152eed089edee3ce99c456a04f4bc61044218f1a,110649527736
20180503,"PAYMENT RECEIVED",1270910181,0,72a8f0c1e2c395ef6a6bd19de8247b5d8aabeb31c372037c623a10859b7b377f,110649522736
20180503,"PAYMENT RECEIVED",1311222537,0,67e27fb21779da727514f594decfcca0769593858c2b1f6772a294389bfb0b25,109378612555
20180503,"PAYMENT RECEIVED",1252842879,0,497f5d92c8a9fd3aecb0caa9ce9357ea0ac2359347ad6a6f5cace6bc77f9fd2f,108067390018
20180503,"PAYMENT RECEIVED",1265360770,0,2aa88ed7224dcf438497b54e50bd7e382d8b038951e76011ef108b44901ee8d9,106814547139
20180503,"PAYMENT RECEIVED",1265560744,0,2e9799452551c41feb80ac819a4a81c2533712aca383a10dd340c058bb65fe73,105549186369
20180503,"PAYMENT RECEIVED",1254747161,0,48f72c6a4de349329690df8804d2ce5da6cfc5a97a56bfe4b3c4e94a4c0140b6,104283625625
20180503,"PAYMENT RECEIVED",1305834813,0,efc9d3bb3a23099c1bf2639825beba60af0210101cc94500aa328ef0e9abc067,103028878464
20180503,"PAYMENT RECEIVED",1274153598,0,436b6588c5e1d1eefc21215ca7b69123826691735b317dc3aa37f8993c0e2cc2,101723043651
20180502,"PAYMENT RECEIVED",1293044614,0,9a973c5267c096649d18b9d75ddd88cf481785a263f9c11f029b9f0a46eba05c,100448890053
20180502,"PAYMENT RECEIVED",1277115630,0,af084a588e30e529940c57ca911f0847be8ca64c2f8021472383a7201465793f,99155845439
20180502,"PAYMENT RECEIVED",1297125036,0,1ca955d107d75d64cfec0bd04a148926ad6eb90b8e9b8f200ab3ddc0ab45aef5,97878729809
20180502,"PAYMENT RECEIVED",1278688838,0,3dbee46a4f88d04d0997ef0f3272358f5028545608370e3bd12d34ee3bb1744d,96581604773
20180502,"PAYMENT RECEIVED",1271847230,0,84e69ae106880e34106aa04931d3dca6532777f4677ebc370b2fa11d4962113e,95302915935
20180502,"PAYMENT RECEIVED",1251950961,0,fbb03f5ef53311f33a9dea30a896fbe229d06074a90c164d68f96dac12b813ea,94031068705
20180502,"PAYMENT RECEIVED",1250623119,0,48e1bd3eec8a9fb267c88f6b7abc4e95b51812d46d1d78ebe185bc37b823c895,92779117744
20180502,"PAYMENT RECEIVED",1278239787,0,891afd80640b0215ff53db4c76ca1687dc601e987b63774552a64e1ffcc1d327,91528494625
20180502,"PAYMENT RECEIVED",1261943165,0,c778075e3bc4e7a714ce11ba269d2aeb95b8739f02e44ee2826ead6e4114a35a,90250254838
20180502,"PAYMENT RECEIVED",1263561099,0,a551f310e9c5615ac589d84a6fa13e8c6f65d953248fc9cb2c3aa7242e1999d1,88988311673
20180502,"PAYMENT RECEIVED",1254507078,0,129f16f204c686807eedb3461f43f1f083a7f4369bc7e8913c59cb72b10fc907,87724750574
20180502,"PAYMENT RECEIVED",1312016335,0,cd0b52377b9534754863911b18487fd380d76f12a959674ddca4051d0506d25c,86470243496
20180502,"PAYMENT RECEIVED",1251477541,0,fc74677473d9db35a8f781b508d642a6c0654bf2f87dbe7581ffe5274665dfae,85158227161
20180502,"PAYMENT RECEIVED",1367428964,0,8d4acf9b7729c6e14a5e4955cb78b7711bac62dcb5c5f761a5d54e73644ea146,83906749620
20180502,"PAYMENT RECEIVED",1291156061,0,64b8fa367190b8315048fff5cef3f76990ea8ce1225a3744578a127a52bcabf4,82539320656
20180502,"PAYMENT RECEIVED",1281204920,0,2d8ad97a1c29a7cde3bff9db937f3817f7a89ae107eb4ce01dd1a43d1aead389,81248164595
20180501,"PAYMENT RECEIVED",1256585796,0,2810807f641a74eacf0c8d704d08d54d5138c77b2708c50ecf4bc31181bb3e85,79966959675
20180501,"PAYMENT RECEIVED",1293051108,0,cb723218e664ebab8c6fcdac34f196d362b5aa98b640e44425b7ac582ac78752,78710373879
20180501,"PAYMENT RECEIVED",1261656206,0,f45192d1c171440b96f7c3d917cc60a2a13be3aea04fb0a7ba8455c00375850c,77417322771
20180501,"PAYMENT RECEIVED",1287770830,0,707bb3b0a0154c74665036ec30bf1c1796a487db5cd57505e1cadee200d571a8,76155666565
20180501,"PAYMENT RECEIVED",1265093497,0,1c99ea148bd838a6d96b5bd408fd30c85497d4881eb0163d02cc00d6bc202941,74867895735
20180501,"PAYMENT RECEIVED",1264032445,0,be4c700a65e3fb87fd5426583199072f3cf40a974e153e10a83e8650005516cf,73602802238
20180501,"PAYMENT RECEIVED",1276050634,0,f5bc87e326a186016158f4bb29d8f160f3b02c66bcee06cf68ab3ba0ad28c7f9,72338769793
20180501,"PAYMENT RECEIVED",1273025641,0,714d3caeff15f34b3d7654e630a818218a3de2d319a907bb4566f45c222e1fc2,71062719159
20180501,"PAYMENT RECEIVED",1284083858,0,3ca067bbcf355eed4b8b81f07d3df51d9e059502706ed68575a798b533569d41,69789693518
20180501,"PAYMENT RECEIVED",1251203710,0,8bacada2d9949d691dbc84d2c989431177c400c47c5b6b9146974f40f72f1efb,68505609660
20180501,"PAYMENT RECEIVED",1292648637,0,537d61ef3c0920b6e644916dc6df3447be7b586e23a840550b982ca7858730c9,67254405950
20180501,"PAYMENT RECEIVED",1279970420,0,b603749186b6c50c9c8bc1f25d401ad03f79c17c19b623a11d18be8509f8b07d,65961757313
20180501,"PAYMENT RECEIVED",1271580373,0,a7d2406e68cc6a803be77dbfef0fce6e738a99407c3d6f5e7f2b40ad86378ff8,64681786893
20180501,"PAYMENT RECEIVED",1267848406,0,11f936e7efcb912aabf5937c3688afa58572420c2e7805f52ff3359484202c57,63410206520
20180501,"PAYMENT RECEIVED",1294202084,0,f5db192e2f6024e852f74cfac4b2ce5669fd91e5ab8e4d9683f91c1c2ab7c356,62142358114
20180501,"PAYMENT RECEIVED",1280765237,0,2c27e44e8641dd414c0f5f64557b0bde20b349e9019accb146a7657fed77dce8,60848156030
20180501,"PAYMENT RECEIVED",1251847459,0,d09fc8c375f799ebd9ba442878160bcb5424b4f48e83430dbcc1197bf3b97c2f,59567390793
20180501,"PAYMENT RECEIVED",1296470076,0,981dabed55d3aaa5eb0c60fc617ac7ebfd12e610c25c41bd73d162d1fcb1a5f4,58315543334
20180501,"PAYMENT RECEIVED",1289214510,0,e6ac14a5cb2f75661ff434e73f4c7eeff92322a6e11b0f6961d1c947a08842b4,57019073258
20180501,"PAYMENT RECEIVED",1266214886,0,4b15cb2575a397dc459d8785b0bda05b086395dd04a2fa3bab68884a15684174,55729858748
20180501,"PAYMENT RECEIVED",1267590839,0,69c21cd803e124cf8706cbf2a5862f1cadf38c9aaf9f95872c79ecae19206993,54463643862
20180501,"PAYMENT RECEIVED",1257035136,0,0bb02cfc4df170a71e6e39f883c432fa97d2203e6a720755ab8978a834d405bd,53196053023
20180501,"PAYMENT RECEIVED",1255307585,0,db618f6845edaa8ad1721808b5c91561b8c9a06fc1d4bc079d2b74467deb600d,51939017887
20180501,"PAYMENT RECEIVED",1254417547,0,816e9c5cc274e47f56a1811179cd7a21e00b0fd4cc057962a12b683bc65366f2,50683710302
20180501,"PAYMENT RECEIVED",1263953285,0,5a520589d52df737400d07b53a950990535f6e8fa916081515e42dbc7b4b94e9,49429292755
20180430,"PAYMENT RECEIVED",1288404441,0,095748bcbbedf72e7e6d35b92cccd5af7b1f2e2dccbc01a1e64cc026f1a8e8aa,48165339470
20180430,"PAYMENT RECEIVED",1254078298,0,a83f29d07f5cd326eeb97cc19cbf486dd533ce330f96ae3a6bd91bf05ba283dd,46876935029
20180430,"PAYMENT RECEIVED",1256897381,0,c6c6ec7eecf1cc559c1fc7ffabbbde772a9961a072abf5d4ce744d4b6070f7c2,45622856731
20180430,"PAYMENT RECEIVED",1270524204,0,5b1fe17d6f1a4f3123f946901aa1c2eff31af1f4b8e74ea4df3573fdcd10676b,44365959350
20180430,"PAYMENT RECEIVED",1251391823,0,7641c3863afd51937831c3a8f3c7c38e84121ec34ac850e1c50ce6d71575efd3,43095435146
20180430,"PAYMENT RECEIVED",1266225575,0,65824cbdf6a54ddd2030b50e3519d3827a840b21c2b4db5235cc4a55c8f7284b,41844043323
20180430,"PAYMENT RECEIVED",1254550816,0,af8e3e5db81414a5cdd58f3f5f7826d16b791d6ceb32dfa7e6d6bb52f483cc82,40577817748
20180430,"PAYMENT RECEIVED",1283007553,0,c4251095ed8972ed0ef10c5a69ecd7970606efb4228a500828e1289dae1f3dab,39323266932
20180430,"PAYMENT RECEIVED",1260306022,0,b4741900ffe8d81fe27e4196bd321bf74b6ade83cd50b048ef1b6adfc0585c1e,38040259379
20180430,"PAYMENT RECEIVED",1328964223,0,9ad260488d6886356b24bb475cdac7b52a5b7f87282a84ee6509008bbde8534b,36779953357
20180430,"PAYMENT RECEIVED",1254923503,0,b7a67816ce7ab0bade316c101d21016996565bb130c4939b61eb44900fefabcd,35450989134
20180430,"PAYMENT RECEIVED",1253092936,0,9cbbe33b77bea5c06c403973738de49d693ae21b2b2221f7120d0b41c35c753e,34196065631
20180430,"PAYMENT RECEIVED",1270054005,0,27b980617e5d9e5545c564ef93024abfa1deb9a6d730c1e865269c87fb4e5c24,32942972695
20180430,"PAYMENT RECEIVED",1250750240,0,024dbf7986e8c148030bc14435e76e32220ae38996055ddbd69257d7c5dc9a3f,31672918690
20180430,"PAYMENT RECEIVED",1250439708,0,b381b40c84b41a337e31ccd237f9316630d51eddbee8e67058b0844d95645872,30422168450
20180430,"PAYMENT RECEIVED",1284976269,0,c5dc90ebff823a923ed09cae9e4928436d65e5b98c9f82f16345a178b0c7e9c6,29171728742
20180430,"PAYMENT RECEIVED",1286010987,0,ac392c3bd1078c4eb88e16b1ed519e0d3ce4c0d6f480e4db3d00f4be8be27a3c,27886752473
20180430,"PAYMENT RECEIVED",1254647588,0,c1377ee26dc029e20651f51e0538e178dd17868ff13417e6eba48ede73f497b1,26600741486
20180429,"PAYMENT RECEIVED",1261142129,0,35ae6f76e2fec277aad86de109fbd58ddec4df5338239d7c6aa7294ac7e780b1,25346093898
20180429,"PAYMENT RECEIVED",1267130425,0,020d349e44cd77cf42631f34f9029bcd55fbb38a600090084e8404715ef3c05f,24084951769
20180429,"PAYMENT RECEIVED",1258764251,0,1e34a29308ebf512f94a92ef148cd2a18743e53eb043eaa6a36412b804f2dae8,22817821344
20180429,"PAYMENT RECEIVED",1262508524,0,7cd4b70ef43afbd50bf4f17811450aaadcb7f54c72f0f2e3f83f1c5006fe2c37,21559057093
20180429,"PAYMENT RECEIVED",1293788224,0,9de2df40af5a1738ac59f813be23e6d72b7ce23e8909dabb29bfe0bfc61e1c41,20296548569
20180429,"PAYMENT RECEIVED",1314524985,0,f7b9ee45fb3b26f7c577507b38cffbfb2091521d72329720e96adbf8da76000b,19002760345
20180429,"PAYMENT RECEIVED",1254698345,0,0dd7e3b04a7d40f1437119d3048a7da6e4809e624771e68ce3b318c6fd5da002,17688235360
20180429,"PAYMENT RECEIVED",1292141026,0,eddbf24967f676330e6dc80a8ec88459475d9ffae9ed18b8732b810f8039d40b,16433537015
20180429,"PAYMENT RECEIVED",1258855570,0,147eb3a5b0d28195746bda6e0e28ba7c05f05855deb9294e4aac21ba40a9bd5b,15141395989
20180429,"PAYMENT RECEIVED",1253098394,0,5b7de376931383cb020e1e66c68c4107f181d3847aa45a4bb537962a37747d01,13882540419
20180429,"PAYMENT RECEIVED",1255022713,0,b2352e34dc5803f46b2552b25141bf197501050e1fb274e5345fb9132e4e8dde,12629442025
20180429,"PAYMENT RECEIVED",1250000000,0,0c930964690aa9ac8483771335469639ba1d9b5e919a38f0e1f4122610626260,11374419312
20180429,"PAYMENT RECEIVED",1259128632,0,76c20a89221ad762fb984a52084937b3f02d2ef80943b3fec2d218c4a4ad0ac7,10124419312
20180429,"PAYMENT SENT",0,-90567700417,c5786f944900c2e79ee4131f9336980f5909bf65103ef9a8f67825c85726d5dc,8865290680
20180429,"PAYMENT RECEIVED",1258856058,0,3a87a9fa9c5eaf145650ba46cb531969be8be5573bbfb61d28f5bb14762d67da,99432991097
20180429,"PAYMENT RECEIVED",1256322446,0,978fcc186923129c63f7204632c90024223827e1d47c21cb4d2d56e11a9ece5b,98174135039
20180429,"PAYMENT RECEIVED",1258164535,0,f219198b35d7db9ab3b53dcd574b37f6829f54767f5aad4a31f1f649380eee5b,96917812593
20180429,"PAYMENT RECEIVED",1269237852,0,23fbbb7606b0a6e9a17201332499acdf4d213981b994cb3300bdecd30a0ec520,95659648058
20180429,"PAYMENT RECEIVED",1287303280,0,c482c628dda28dd6da8457ca642e5d67acb4667201dbe339555a5212122acd1b,94390410206
20180429,"PAYMENT RECEIVED",1260181971,0,87f93b15196df0f07ab6f3c43bda2356d3cbcc0e079f8a26ba0b551684c01166,93103106926
20180428,"PAYMENT RECEIVED",1275224538,0,7640cdaa9e60fe75184569fdda5eaf27333d583db243e96cf8d975b5633ce5fe,91842924955
20180428,"PAYMENT RECEIVED",1285691654,0,d19180b719c352ace0ab9a9f723d7838e5fd847776a66bb391ba5ceb7636e2c6,90567700417
20180428,"PAYMENT RECEIVED",1272913217,0,33402f478c4c551552bd37c7744fd69db3a974a4aa85252d270074bbd1ae63c7,89282008763
20180428,"PAYMENT RECEIVED",1272875921,0,c30abce267eec2805d73cf66a6530971b29a21e1b0e1e95e4e14c17532bb095a,88009095546
20180428,"PAYMENT RECEIVED",1282086296,0,64bde9551f6c0d9a9abf23fb786aca354cc75a8014f5fac809d2f11e5e8fc895,86736219625
20180428,"PAYMENT RECEIVED",1265369198,0,d443b272ad0e8cb583fc0f35b2900c3805fa3a2d16289df40c641081e7128478,85454133329
20180428,"PAYMENT RECEIVED",1273201827,0,bf70a667ce2ee3ac073a6bbe5befbd713d7f07199c0d589ae4d46b382a34b656,84188764131
20180428,"PAYMENT RECEIVED",1259771805,0,479eb49f9309ba8d7337797cb00165b53564d956d21c125366b17da2bcdf6e3d,82915562304
20180428,"PAYMENT RECEIVED",1254136437,0,4d7ba2e5379a3061c37acea05b4cc9df1d40a5d5e84b73f7a31acf72f85c5220,81655790499
20180428,"PAYMENT RECEIVED",1340580726,0,892d00ba2c49a07525e2585f017fe3d949ec39c9918e5afaf139924b311b4529,80401654062
20180428,"PAYMENT RECEIVED",1275416182,0,7e1d0a7348cdb8a5192429e53a9fc43fbcae9a8df6b2501dcfd96ce89847fe31,79061073336
20180428,"PAYMENT RECEIVED",1258553471,0,413587a52e04040bd31ed3ef38f761c6f9bcd17e8b5502cad8ce17ab3250d2a5,77785657154
20180427,"PAYMENT RECEIVED",1259782937,0,f0d987341a859aa341ef689c81b911a34b0cbac3919b8249312f3ed621fe5d8e,76527103683
20180427,"PAYMENT RECEIVED",1294790058,0,c913da8c9cc11e8671f29c20d975ae2dbf1f23ab1cb58712a5b53e3fe83fa2c4,75267320746
20180427,"PAYMENT RECEIVED",1261312923,0,67a0e548205b2f92306d765d3d13034288f455bee4eb6e098a8186bb48326e78,73972530688
20180427,"PAYMENT RECEIVED",1252239350,0,94af6000adf3bb2445bc5a927ec19dbc127f7d1cc1c1158fad40d01c1c175abe,72711217765
20180427,"PAYMENT RECEIVED",1305536199,0,f98184087a0606d0dd992dad1020b1970960176d21417124461ba9214bd6bc78,71458978415
20180427,"PAYMENT RECEIVED",1307051257,0,8440989f0784fc6a13924ab2e46fd8e2b5c22d5aa4473dee29b80e26961b5d0a,70153442216
20180427,"PAYMENT RECEIVED",1264798966,0,fc57d017696492f151e400ec1112f3857fca555a85268578b637fed4f6c95283,68846390959
20180427,"PAYMENT RECEIVED",1299290522,0,8b6d4b444f671b4a5402dc7f1fa3e9dca4511d2335a3fe8a87100d4c477eade8,67581591993
20180427,"PAYMENT RECEIVED",1305829940,0,e471fc889c66b038942ad0f23997761b90e8b0b5eedbcc914e5ff09e6f68bc9e,66282301471
20180427,"PAYMENT RECEIVED",1257674146,0,a3381adc75bb16be62fb2ba9eea275687c317f70b6b74a14020cd80c5fe1f1b5,64976471531
20180427,"PAYMENT RECEIVED",1316938447,0,1ca0dac1ab9de37384f8239b14eb1423d7136e817e5cfc1251bf9249cd780b54,63718797385
20180427,"PAYMENT RECEIVED",1286550619,0,fb07a2a7dfa10ffdb86b1c893b7c0cb8cf077768a8cfa59fc6b6b25dd262d97e,62401858938
20180427,"PAYMENT RECEIVED",1332915236,0,f2050a8fabdcd845e1aa14e2db31bb5cebcbbf1f0b6db57b75f474a7d3dde187,61115308319
20180427,"PAYMENT RECEIVED",1270086411,0,715b8c870cb02445971fa4564281de9f235ecaa854182fb8ebb4b22509912df5,59782393083
20180427,"PAYMENT RECEIVED",1361199874,0,c51c09e00e6af525efd45d1dc511f109ba903d4153dd9a8b10ef2121d6c750f0,58512306672
20180426,"PAYMENT RECEIVED",1268385696,0,a20627bb4bbaa1b0020bee7462e08ca73a0a6945c0601ee9b830d00981638d0b,57151106798
20180426,"PAYMENT RECEIVED",1354601993,0,a09b7f112503c9331d4d00d7cb07664157a903937e88e1bb2939c81c55deb6c7,55882721102
20180426,"PAYMENT RECEIVED",1264416301,0,24995bcfac231ccce2c416839d39a0e98341a97a6a97e72074efe27d76cfd58e,54528119109
20180426,"PAYMENT RECEIVED",1255802651,0,e9ac1f6902f82e2cc0127775a6bf41c01d7328bf6687926d924ad3d38c6a82ec,53263702808
20180426,"PAYMENT RECEIVED",1305825848,0,6349d0dc9bd93a4f7a9e485f13046c429966c5d809533e41ebbde623a7a3d2d2,52007900157
20180426,"PAYMENT RECEIVED",1312553560,0,03a36e160f87487a34b426ca3a1fa2406ebe33592945a595c33be5f327dbf6ec,50702074309
20180426,"PAYMENT RECEIVED",1263173275,0,b5f560e3778182e9f7f4785e03253425bfac7538debbbe8e24e7981bc93ff5d5,49389520749
20180426,"PAYMENT RECEIVED",1306747044,0,61da571352158ff98be422bb1e01ea4e5ade9d59fa2e0603548d9b9b157c5772,48126347474
20180426,"PAYMENT RECEIVED",1316194152,0,ec8ebf8ecaa062b79ca2901851089aabb09154eb429eea404e5783c68112b632,46819600430
20180426,"PAYMENT RECEIVED",1324622634,0,1f3167b3089e6560c25bd7c84aaf9d3bc99dbf884d445f9b08ac0633913b95f9,45503406278
20180426,"PAYMENT SENT",0,-98424620859,85a75b8689e3908c3c7edaf828e9abbee1732eb78b23b259148f24487d444c7e,44178783644
20180426,"PAYMENT RECEIVED",1266985125,0,1b9942c9648d71a7a6a2a02a9562a8c22e48a8c976be85b0c731739aa2371b15,142603404503
20180426,"PAYMENT RECEIVED",1303415487,0,2d80db859bd113caaa8bbb02be0564974dce05161112acc446fab9434225c6cc,141336419378
20180426,"PAYMENT RECEIVED",1268525157,0,3716eb6eee904017b6a03db182d1a7f30164236d2ccd1d53e462568e1a7edf6d,140033003891
20180426,"PAYMENT RECEIVED",1253441458,0,b554a100c91dd187f7e84f58584170b572acbd13ad81be40c82588f5c53ea939,138764478734
20180426,"PAYMENT RECEIVED",1295396845,0,f2d1fd95845946f9441be1aceac690f5613d888436f80196b358688494890b91,137511037276
20180425,"PAYMENT RECEIVED",1250000000,0,c158748f812aab138611cf7f8f6cc6a0e745991c1c672b2733b8fd664cd6cbec,136215640431
20180425,"PAYMENT RECEIVED",1273306717,0,d40e5dbffffcbd8b30b40ee57c3954659aad5634fe6d1e37c37c4f083e5d2bf2,134965640431
20180425,"PAYMENT RECEIVED",1326034425,0,6ebacc7b41afabaa3c3937711fc29bc13a604ce41020cf5b79ac8fd718026dc6,133692333714
20180425,"PAYMENT RECEIVED",1357838743,0,101309b237a9891927395de7e3b2fd5f056dec26aa0a317d75e84fbfb93929ee,132366299289
20180425,"PAYMENT RECEIVED",1375964597,0,8f20ac4f1cbf67f0f886ada787c1dd616ab825af39e23fc57881a1a1c82657bb,131008460546
20180425,"PAYMENT RECEIVED",1351185495,0,1f10fda39824455ff41e7be2810bd6a53c9281d28db66874ef664b5baecd76d2,129632495949
20180425,"PAYMENT RECEIVED",1364801950,0,9e569df3d35b88e07cc55627468330ba6795cf1de6547788e49730a82e493aca,128281310454
20180425,"PAYMENT RECEIVED",1364357022,0,cb3896ab0a7b14bee0ea54e9709d34182b994491bbaccf2e3e6bc98451e59fcf,126916508504
20180425,"PAYMENT RECEIVED",1259584470,0,85e4d23934bd10e78ebac762520d49448850f48b22d351ba7bba40f2b0261246,125552151482
20180425,"PAYMENT RECEIVED",1323808306,0,5a01bc3b4d84bb9bcbc6a1971a775efe864b2cc0c62e62e78d31aff6223aa6d9,124292567012
20180425,"PAYMENT RECEIVED",1292160048,0,213fb0e69f29a9692f98cf6d5aa6c6a6920cc631d13643d68b26335eafdcb895,122968758706
20180425,"PAYMENT RECEIVED",1341508886,0,26275fdb7d2000eac2d5e22e06db9d2a5c5fc10b14d896e65e8593c225f1459f,121676598658
20180424,"PAYMENT RECEIVED",1250918490,0,1d55e0e2a8a0f2cba7b6a7efefabf3d3a3dedbeb908d43c25c050b44af5af9bb,120335089772
20180424,"PAYMENT RECEIVED",1253551458,0,e81220c8a9bdf23feafa29a01a85b9bda257edd3802b3805d47c5b1b16990d4a,119084171282
20180424,"PAYMENT RECEIVED",1260790420,0,3ce35f540bf5fc3046417ed5879bfa4d1a33381bf85796fd1b157f3df6a923fb,117830619824
20180424,"PAYMENT RECEIVED",1266628478,0,cff8a587306c1416c46af16915c1c572be7cd083607fd1e7f870500f6cfd7db0,116569829404
20180424,"PAYMENT RECEIVED",1328576934,0,f41bc6252d4482be9dd36dc7e5782b4efbca64cc4ddf4ad344681331492f6823,115303200926
20180424,"PAYMENT RECEIVED",1300351839,0,d9741be57c119260f5ff47cdc86b719497f37bfa63ab8792ac56f09c8f43981d,113974623992
20180424,"PAYMENT RECEIVED",1289208363,0,b4aef6df42394cd7e9a285392c00e733ef00c5a653d7769fcd1ec9ae6025d5ed,112674272153
20180424,"PAYMENT RECEIVED",1304247916,0,b287782e9ac4e8f9fc446d94048d60ccdcbf62609e56c85067d92cf1ed25aab4,111385063790
20180424,"PAYMENT RECEIVED",1252076911,0,5e602ff96d2a359cf711499c3e67ac5045a98f63676a8eefca5e76ec76127b68,110080815874
20180424,"PAYMENT RECEIVED",1297923183,0,90073d37bc3d2595d137c3241044c071ff79bac9b30d53103d6ee44be09f674c,108828738963
20180424,"PAYMENT RECEIVED",1265559472,0,49f165448d8d9b32ed378ba05c433bcb46134744fca8da8a6ea8b179b41d6904,107530815780
20180424,"PAYMENT RECEIVED",1324662567,0,29ba1b57af10a274e6ec6d22ff6fd0d628326701dd23ba6cbc32fc99249ce0ae,106265256308
20180424,"PAYMENT RECEIVED",1252764041,0,f65eee85198594debd494dc7fa8047e5ed96d0517f7f8ea0e1bd3c10e32dc6cc,104940593741
20180424,"PAYMENT RECEIVED",1306322724,0,3d20f7178ee6bd1cdff556d65a0f26810cd0ae0f692b195405e47c13951926db,103687829700
20180424,"PAYMENT RECEIVED",1328730453,0,94bfd9607afec96b8f920981e37c7c891f95d83e44d4c9ee0a0c904385c549a1,102381506976
20180424,"PAYMENT RECEIVED",1356330304,0,ec70d5aa080c9dd136764fb85199827f7b8f2ee8fd2f8dfbd2cf4ea20cca55b7,101052776523
20180424,"PAYMENT RECEIVED",1257237698,0,48b6ea40d2a4faa79ddc4eb4dbac79d5451b1f1794e198c9735dfb25d1e3312e,99696446219
20180424,"PAYMENT RECEIVED",1264080733,0,48f35b832d8ab7e586e80a426fae764a2b2673cbbc97109b268203663e627204,98439208521
20180424,"PAYMENT RECEIVED",1250113443,0,a83b0582908acb22486275260d3ca991286c50fcafa76e0a8c1137548ae1d0a1,97175127788
20180423,"PAYMENT RECEIVED",1252367779,0,8bb7b8f61e770c57800b5ecb2f98c8ebf4f9b66e978967deedebfa3ecc6ba368,95925014345
20180423,"PAYMENT RECEIVED",1267924046,0,8a6fb5e54304128081af5c918d84d91e04ca89b2917836f42d84ae2a13f1e0c8,94672646566
20180423,"PAYMENT RECEIVED",1277909049,0,fd5a01be30164846098153a761c7b98ffe6b6758401fe6d625b55a66219c00f2,93404722520
20180423,"PAYMENT RECEIVED",1252588113,0,50a3ca1009a9c19a736dae52bd00a97597ad88ed18f9899ddc237cc6d9b5af84,92126813471
20180423,"PAYMENT RECEIVED",1270596477,0,33f05a94d1fb58e1ce2b87c869c0f217b1eaee1743746ea8d5368c565dcdd3a4,90874225358
20180423,"PAYMENT RECEIVED",1285442292,0,96595be7909e47b5dc666b49c5f45fef83978a7c7ddc012e8782af3593534505,89603628881
20180423,"PAYMENT SENT",0,-10107800125,8f9df87785222f4ffe8deff63cf54203f07bc08532880305aec30306fa7f2101,137726122817
20180423,"PAYMENT SENT",0,-10143357314,b98177a30241899dd0c9c02bdc227bf92a66c337aaeedd8c8d48f251fc12b133,127582765503
20180423,"PAYMENT SENT",0,-8878068670,cdd4952ddd8cc86543c7d6e408f7bc83dcb7b0443dced2e1f746efb6900c1d80,118704696833
20180423,"PAYMENT SENT",0,-10115266057,36173ddc5f66d4bb5b8da621e7ccbf2026c58189711fec96b6b99bee0d022743,108589430776
20180423,"PAYMENT SENT",0,-10090702888,823139fd1b7eb2efe7905ad36af4a9614a1985fa3617328c45e3a796ef67efe8,98498727888
20180423,"PAYMENT SENT",0,-10180541299,c40fe82a072a4846d11b0b851a0c018d9f330a8d3672020070b1e84d71879d52,88318186589
20180423,"PAYMENT RECEIVED",1255244368,0,9a2a308bb78b77342264ccb335fe68cf294c47fe2e4c5edad9e0c374927f481a,147833922942
20180423,"PAYMENT RECEIVED",1277470687,0,4ff131ce78da4f9f1a8cb7ca9232a41f82bf759ca25409de376875df13978dfc,146578678574
20180423,"PAYMENT RECEIVED",1252873319,0,5c3f665ea7cd50856a97a2411480df576983793ba07fc9d92b0965fedf0d5422,145301207887
20180423,"PAYMENT RECEIVED",1256283407,0,2b709e5fcefee76e9cd27fe2803ca4b1f9a5baa26d1a92b8a3b93a523b2dbd43,144048334568
20180423,"PAYMENT RECEIVED",1272046802,0,6720e665742be6edcdcd309743bddd06cf8ad92ae881f7b9bb03a3a0f88c472d,142792051161
20180423,"PAYMENT RECEIVED",1265063890,0,570b22cfde4cc388f82bdf55c7b8b44126f68d844429d82714dba8cde902e6d6,141520004359
20180423,"PAYMENT RECEIVED",1253204750,0,bc745a33930b47e60cb6f64ccf32ab6f88d99df0f5c6f14d326ddb39aff0dbba,140254940469
20180423,"PAYMENT RECEIVED",1270830366,0,10742f0fd361c6f9d7592f031dc817cb17ca8f617fc8bad5245e6a17e80b4309,139001735719
20180423,"PAYMENT RECEIVED",1270848457,0,ec77a87a129911aba86308a186e7b12f7d65a8a74b5c7fcec9a734b2cfd20692,137730905353
20180423,"PAYMENT RECEIVED",1263483307,0,25decbb07d7a69c6e13e5b76518a547732e1bec2e3b4c4816611e96d7df15c64,136460056896
20180423,"PAYMENT RECEIVED",1256613155,0,fbedcb4aaff6435cce5e2fec52ccb05476b4b72a19bbe44d492eda1f31563a87,135196573589
20180423,"PAYMENT RECEIVED",1253199615,0,0924a35716d63464f62d16beec866483c813b3df4356db042a2831be60ca5e00,133939960434
20180422,"PAYMENT RECEIVED",1277359672,0,3aeec9caf86724c5258c2821f340f3d4e9cfa3791a96ede80ec4d435a5b54664,132686760819
20180422,"PAYMENT RECEIVED",1263324019,0,e60b8b5766a7f70175f5bf1d9e5057292bbdad6affd92483da03f96a787db97c,131409401147
20180422,"PAYMENT RECEIVED",1252045965,0,8d80b8ce5ba8e6e65c5ba2fff7661bcf7d6def4229ab99c7febe7b9c661d2810,130146077128
20180422,"PAYMENT RECEIVED",1269032425,0,43cff8a27ba9f89936292333f50581cd75ef63b5162e8037c2494688fdce901f,128894031163
20180422,"PAYMENT RECEIVED",1257907933,0,86b8955ae3ee1407ebb6809e96825921431ef49914e61a8df7f23cf88af1124f,127624998738
20180422,"PAYMENT RECEIVED",1269574739,0,3f3edb68cd063fe4f91537b6ecab779b14c2956b38e7ea5cae06ffedd071aefa,126367090805
20180422,"PAYMENT RECEIVED",1253653615,0,543ace7de3f833a3dcba875f012b7776dd6615402ba4d60fca26cf2439958804,125097516066
20180422,"PAYMENT RECEIVED",1275760208,0,036a16a0960b9eab7eda8c9a8206e9c194586907966e69de5b50e4b628b3a028,123843862451
20180422,"PAYMENT RECEIVED",1253702392,0,cb196704f04b7caa1541ad0a01ddf1f2983234bb1073985e5d519a3fc456bbcd,122568102243
20180422,"PAYMENT RECEIVED",1257685852,0,ba00a58c15677c043496e26da64e743d720a4baf57511510ed498e2afe2de3c9,121314399851
20180422,"PAYMENT RECEIVED",1266362886,0,e88078acb0968dc431a20961bfb9a0e7d808155bc1c35b72e65ce7ef8c1c0a30,120056713999
20180422,"PAYMENT RECEIVED",1251906471,0,271af90361250256aa67bf8ef21d1e307acc5dc9cd7cdb353596abe181ef33a7,118790351113
20180422,"PAYMENT RECEIVED",1251821897,0,4308ae6015dc1030872626d4ff697f2b225afff9a04a55eb40bf95f5c8744b16,117538444642
20180422,"PAYMENT RECEIVED",1277088383,0,0f97933575c25d6ae8da7e803a7c8c618d8418f7e5e22823013cdeb22ee1cda5,116286622745
20180422,"PAYMENT RECEIVED",1251493347,0,c85da8f93a9d73be616c2c57cf1fdb1a9eacd4c98ea1ad33dd4b714823467dd7,115009534362
20180422,"PAYMENT RECEIVED",1252434440,0,b062d3b429a96805270978bf66342275a66e47f545efb09c4a552520f59d8bd6,113758041015
20180422,"PAYMENT RECEIVED",1268749580,0,c76357244e92089cd4bb440c875f069abb2cee08c0614da0cd8e435f950be722,112505606575
20180422,"PAYMENT RECEIVED",1252145130,0,2a4659c2374b8db5181d9d8377f3d971a139b4810c1346c45cd3c31062132fa4,111236856995
20180422,"PAYMENT RECEIVED",1255673429,0,64e4c66e8e847bbbc4d4304058b3067eae4a763131c410d3b7c097d043fa4694,109984711865
20180422,"PAYMENT RECEIVED",1269785379,0,e1b0e8d5c25d03360dba6d936d787e304908355321e4a359b9bcd3911cd248f2,108729038436
20180422,"PAYMENT RECEIVED",1250000000,0,72587957c6ec4c7aedd0e40c425d4a09904eabbdec850d8569b87ef9ab1a9591,107459253057
20180422,"PAYMENT RECEIVED",1268357367,0,36a3cb9a8742b2777acb37dac9ca148d665ff2797ce4ba8af3496ffb763ff07e,106209253057
20180422,"PAYMENT RECEIVED",1254263797,0,68f85b91766e75a5f4a8a83de863d9109e9e1001edbadbb4c0113de1efd8bff7,104940895690
20180422,"PAYMENT RECEIVED",1251971730,0,2549d28e44f11177170aabc47be46a994a04fe6f497df8f4519342fea9ca22b8,103686631893
20180422,"PAYMENT RECEIVED",1274486610,0,490319d07a5650103c8796f5603471232a6bfef40f91657b06e58544daedd02b,102434660163
20180422,"PAYMENT RECEIVED",1250613831,0,1f7d042be6e43f5e26a143cad7317daa173f361ff81cb17e358fc9bac935d794,101160173553
20180422,"PAYMENT RECEIVED",1251741739,0,e8eb864ae8eeaebebaca9fe9dbdbb1565db640f3d234f1b89863df8fa6691f39,99909559722
20180421,"PAYMENT RECEIVED",1254905432,0,150a9717d0bb96e1ef80c9d863f7e443e14b9d66ced4f35fe5e944f42d3c8f32,98657817983
20180421,"PAYMENT RECEIVED",1256978233,0,098ede8e67046f0916f3a4d34312ce186f3552e69b92ea02786e2abd2f5dd4ac,97402912551
20180421,"PAYMENT RECEIVED",1296191107,0,07c07016736386c1a6f5dcc0f7822abae26a9cb86f4d36867406c9b5fc136532,96145934318
20180421,"PAYMENT RECEIVED",1264847442,0,90944bee976fda36013e0ffd726a89c66544e93add9cca17af8cf2b39de98dff,94849743211
20180421,"PAYMENT RECEIVED",1281142297,0,714445dd232398f0bf37b5cf02b94a7f7341be9242635c5e696e3797f2614a73,93584895769
20180421,"PAYMENT RECEIVED",1269979005,0,ed2bd1816472a59b5e8a7637ce016093fd03d7cd9f9fadf68ed0dcb727c9a0b5,92303753472
20180421,"PAYMENT RECEIVED",1276819243,0,c192a57082daa2c96cfe67633f403415fae36cc2e8936924d3473f60e9fecfbd,91033774467
20180421,"PAYMENT RECEIVED",1295283385,0,8358eba4c29b2c28ad17ed05d1fe8e1216e41905279ffe440daa245d1ea54792,89756955224
20180421,"PAYMENT RECEIVED",1252283827,0,1f496503051e0637d7df967d0c78b7f6dc04846deaea8e298300574d346c1e86,88461671839
20180421,"PAYMENT RECEIVED",1254896263,0,cec8d9fade7526363871b25849c2b07ce68565af0369f223aa1df9652658afde,87209388012
20180421,"PAYMENT RECEIVED",1252676249,0,f4d571f8b0ee1877464263412518c9de4e32e180911b480c0f4201b0c786c469,85954491749
20180421,"PAYMENT RECEIVED",1251581043,0,709364acb38c27a80ce236c99da92b7108ee299b570e7edb19c1df178335d371,84701815500
20180421,"PAYMENT RECEIVED",1254705052,0,6057bc1d8e0709565a4d153ecad1a097a8151a48c62aa52a721be3b966e8bafd,83450234457
20180421,"PAYMENT RECEIVED",1276471322,0,840e30b059835d2a18b037b34e072b7a45de7fe9c348fcc2c0a0f2c9b74b67c7,82195529405
20180421,"PAYMENT RECEIVED",1252924707,0,1485c4d9333cd132e552d6508bdbead453628b20a455e371d69ee41cb242a45c,80919058083
20180421,"PAYMENT RECEIVED",1290360296,0,542998ccbcb8b136bbbcce0e9760d07b18cfac9965ee11c7e4981c48df3f3666,79666133376
20180421,"PAYMENT RECEIVED",1256460832,0,7a9c07495ca236a7c4577b05bf1921d9e2daf4f34a4c349c4c69b4a883b1ec68,78375773080
20180421,"PAYMENT RECEIVED",1262894946,0,760897aac4af68b69cc40273a71cb4f747a3e0be2cd7c5935ac0d520187035ba,77119312248
20180421,"PAYMENT RECEIVED",1273972169,0,f6727650ca729e10f48f4c80f5f952ec1fee4a6d0f6e0b1052581ea377a09bc1,75856417302
20180420,"PAYMENT RECEIVED",1302719162,0,99d396ab148121aae83e45da500c4a8613600599417ccd25d6daf7f98b3b91a2,74582445133
20180420,"PAYMENT RECEIVED",1278565951,0,989cca9e77c4c5d60aa1921ef5b3cea23c1bea20de492c0e9d07421823e448dd,73279725971
20180420,"PAYMENT RECEIVED",1252598951,0,d369630070d18b577de2cfb9752da2aab470957747df2210c986b7d3a1ddad3d,72001160020
20180420,"PAYMENT RECEIVED",1258719185,0,76e1f79108223cf9c1f026489096743efc4ae37069f8e81a5cc347531018e889,70748561069
20180420,"PAYMENT RECEIVED",1264780436,0,bdc9a289df4a570fa4ebdf37a3379fb6e6aa66c0e08df3c81dab9749f8d2be69,69489841884
20180420,"PAYMENT RECEIVED",1260277923,0,72c9e479448e6f38c95de0dd12e9387fcda69dc27d24f6197bbb422b0c6c6aca,68225061448
20180420,"PAYMENT RECEIVED",1317536631,0,f150adaf6e4b1fba7f4be451cc29cd06754637e0ccd70eb341d4edd673fad8ea,66964783525
20180420,"PAYMENT RECEIVED",1271896602,0,d50f4534ea920c5ac501a66901f411fb5e51bb506af3a0d8edd183de468f2594,65647246894
20180420,"PAYMENT RECEIVED",1269707877,0,9ab794be93e09983a8182fa356db12ddbc0a5718fc0365cdf64a8facd4402d76,64375350292
20180420,"PAYMENT RECEIVED",1269385606,0,086dc543fd1a129c2d451bb765a8186e367a5e423f0ba225c9712158dea2ddbd,63105642415
20180420,"PAYMENT RECEIVED",1266981886,0,90b1afbb6a9eecfb55ebb1c9bae9052ae620d260518d238c3be75684b7ca1431,61836256809
20180420,"PAYMENT RECEIVED",1281411990,0,df5483fbd57bfd2931c89902d9474d61b3bd0f85edb6ad6c38c22e75480e26e8,60569274923
20180420,"PAYMENT RECEIVED",1281687895,0,7a61ddbaf4abccbfa97c7c1e76689afab82d3fe1c964fecec45b88822abf2116,59287862933
20180420,"PAYMENT RECEIVED",1301273630,0,c3b54d92c6500d96134a26956b43402d524f296d4100fc404b52fcf1a09b5fb7,58006175038
20180420,"PAYMENT RECEIVED",1250678495,0,1f02c112ee4128494fec423463f286d55db5069b9368423ddd2c0f5be02cabd8,56704901408
20180420,"PAYMENT RECEIVED",1276074874,0,0fd11a4ef3f8ecedaef080f9efb309356674e71b167339a190851aef8af3fabf,55454222913
20180420,"PAYMENT RECEIVED",1272579260,0,238ef335b9248ddb57f7708d9584f7c91aab3aa01326aa777f8e6edb4c163148,54178148039
20180420,"PAYMENT SENT",0,-97408077669,39e99ce1b146a16b71db4fe43c748046f4a1ea82441b39f7d1c7eaf4612a8a8a,52905568779
20180420,"PAYMENT RECEIVED",1260518585,0,5c7e27e05aae404a226b8c41b1b852ea4b3a9dd44eab2ff5770ae95538a0cf23,150313646448
20180420,"PAYMENT RECEIVED",1253112957,0,03bbfba1e32e57d537d2d2ad5fc63a2fcc148580374262c9a9487c7f98f6d82b,149053127863
20180420,"PAYMENT RECEIVED",1264679120,0,60929f229b4531debe9f991751b9a1a8f215788aa6117b480a3e68fc3a344e87,147800014906
20180419,"PAYMENT RECEIVED",1250423773,0,f347927cd51069b347e521db975d83399a2a494eca56ef22f2b93a5fdc513cfc,146535335786
20180419,"PAYMENT RECEIVED",1265456643,0,0eb4168e4e868d6041b2e5c0ae1c76e6deef73455efe6e05be99b4c2ff4128a7,145284912013
20180419,"PAYMENT RECEIVED",1256644557,0,6ad891ef857d72b3059811f8ea9d2bf25fe5d3792b3ad0d09d7bdde1042593be,144019455370
20180419,"PAYMENT RECEIVED",1262193708,0,15c4d6b08fb917c1a47e4af32a2711cbd50d99b4e184f651bb562785d697f67a,142762810813
20180419,"PAYMENT RECEIVED",1250238709,0,2f4c5aed739fed133097ee8c0611ebb18c817ede108a80c31f55bd2a00eea4f4,141500617105
20180419,"PAYMENT RECEIVED",1250539934,0,e78b038b28a345fc2e81ac96e98d28e28e76d0ec4e9a5229bda0dfdc0cb4d1c6,140250378396
20180419,"PAYMENT RECEIVED",1266612305,0,6c4b89d8b740ef568ee73ff4431d7cffe186afe0329a444a2515c2a7e830261a,138999838462
20180419,"PAYMENT RECEIVED",1272640668,0,41247acb549da8123da5d1f9c64b377a026a4189ac67fda7faeea543aa60ea94,137733226157
20180419,"PAYMENT RECEIVED",1259233080,0,73499f05c35b5ae5a9ce59c8884083351ab320e7326472f4896ec52e4b6eaa45,136460585489
20180419,"PAYMENT RECEIVED",1250000000,0,3b30fb0770c6b97782de57cd8e5d726471233b55eb3a4c3eb5e0e2f4d348f2e2,135201352409
20180419,"PAYMENT RECEIVED",1259762274,0,3a957e5134016cdb719d3e214718197fc8c01665e4a5452d73dccbf08f1b63f2,133951352409
20180419,"PAYMENT RECEIVED",1256965099,0,9158af7f98a6acd68e79e7b3b5d7030a2d83b98d147cfd48c62454f2663ea680,132691590135
20180419,"PAYMENT RECEIVED",1255857802,0,a0305df136f568c49dab0e7456e1aeed8249f7f3bcc88e484cea7797808d60f9,131434625036
20180419,"PAYMENT RECEIVED",1312195970,0,dd438625061f674d5de95f7fe75c435db6afbbf3b3d9ed91488b8bc042b01432,130178767234
20180419,"PAYMENT RECEIVED",1250528215,0,183a5ac30f8736d82d0b6f4612e1cbd2aea4b07b52b1afb1cf9539cb83eba234,128866571264
20180419,"PAYMENT RECEIVED",1290442377,0,1fdb3e831f8214c651fe60ce06453d20d37cf2b236047d50bedbe5b7feb67cdd,127616043049
20180419,"PAYMENT RECEIVED",1281250346,0,c90d6283e09abd995f58537c7f672ae2bf731118df854b8c2ec856f1623f7edc,126325600672
20180419,"PAYMENT RECEIVED",1257220179,0,d62ccc43f54f053f5312c1d7add021e2108a883efc06565b91f5a44a1a4d8ead,125044350326
20180419,"PAYMENT RECEIVED",1250086891,0,095e291e56e4492e4c68cf2fee4818476fcc761f87c1ec9213ccc8ff7d1621dc,123787130147
20180419,"PAYMENT RECEIVED",1288848677,0,fcd272dbc62cee5518ff45a126ceadfdd360a030a0b67be074563b5758904da9,122537043256
20180419,"PAYMENT RECEIVED",1270347776,0,8e30157f2a928f7f77598bfe95956d24c6b1ab80e923b8c3354cf8df6653f0bf,121248194579
20180419,"PAYMENT RECEIVED",1253045816,0,0483cd0810393244fa293a91df56d54e063f24a4cd6d19a39f72231e30f6675c,119977846803
20180419,"PAYMENT RECEIVED",1255622082,0,9227ec6349f87c97366aefe26ea4662f1511e0d75a5226e2e4a23bb8abc7d233,118724800987
20180419,"PAYMENT RECEIVED",1276306856,0,3e33e2797a1a4fe56f34c33ab4c3bd7c0e4783be2d1911f7d992a277226ed370,117469178905
20180419,"PAYMENT RECEIVED",1251800568,0,e2130afa1289428c3d40818c5e5950725ff0e1f3401f813cb1526ca05f5c404c,116192872049
20180419,"PAYMENT RECEIVED",1252752926,0,404b9ce2d41200b1b0327050f8bd98cab99d32eb976ae4e8c1d7f00c99c8a8dd,114941071481
20180419,"PAYMENT RECEIVED",1261411602,0,cd2c8f30b30f62f01faae6f67dabcf2216fed85254ae5d39f034e26fc1584c1f,113688318555
20180419,"PAYMENT RECEIVED",1292736007,0,9e8c48c931a2844dfd0e60e471b0cc3d668bd654c25a0a987be917062ebae367,112426906953
20180419,"PAYMENT RECEIVED",1276785413,0,8245bc72fd4321311aa83d9399ad5af46da3f7fa9f7498c858e705b2ca94b8db,111134170946
20180419,"PAYMENT RECEIVED",1250797919,0,6c00721edc6ae443b0d37a2c8bf2fef05c98af563c35020e4a801292707b156c,109857385533
20180418,"PAYMENT RECEIVED",1252382456,0,43d3f795845b5402eb5b1adcb089d61dfa2536b1a14e0726308df52463d6d126,108606587614
20180418,"PAYMENT RECEIVED",1257449378,0,efc02ebba8bd6b1e99d8feb2d25faeb38e0a7a5a1cd39e04f6a4370a3542da83,107354205158
20180418,"PAYMENT RECEIVED",1257462728,0,90206648b3ef7dc40e51bf15b1d8aba17248452b8d81d2e283e3cd7b1635fcd1,106096755780
20180418,"PAYMENT RECEIVED",1250917819,0,3a904c392e407d73b24ae9e6cf1b6fe0b3a11483afbe261cf69abcdf6e3c9b98,104839293052
20180418,"PAYMENT RECEIVED",1254141874,0,74b7995c8f65bbac471e72f6b5d97e1635ff3f7d1a4d6b5110e64fb644ce71ca,103588375233
20180418,"PAYMENT RECEIVED",1260289379,0,b4842ecf346d7b1bca36ca9254bd27ceca8133cd6fa028a44f8ce0031edec11c,102334233359
20180418,"PAYMENT RECEIVED",1276130328,0,b18613e03978c40014f739b07c3f8c9ef48aa13451ce9d31d3d342e30a5d6bfe,101073943980
20180418,"PAYMENT RECEIVED",1250662777,0,0abc705058785a6319b18a4fac2dbe16c7267b208264e3c87d709d4d60a32632,99797813652
20180418,"PAYMENT RECEIVED",1269497412,0,f1ebd812e44be2ccb0284139dbaa43b198ab246b528b7ece2624f371faa2f492,98547150875
20180418,"PAYMENT RECEIVED",1280769048,0,54470668cf3ed5d2d46fee3836deb3a458a4d55a6fa68f9a058deaf3b75ad255,97277653463
20180418,"PAYMENT RECEIVED",1257661139,0,23657d3721eea2ed636cd5c6d795ea679312c50b2d779e59478ad166e97089a0,95996884415
20180418,"PAYMENT RECEIVED",1308936570,0,16c2d260e9e5ebdcebb16bcaf480e25001aa0a2cf942f00d0823c39b1c9ab14e,94739223276
20180418,"PAYMENT RECEIVED",1262421523,0,f9f049cc27afd4e1351f9c70efc2c0c2911cc33911f48cd2830c23cf1f2df4f1,93430286706
20180418,"PAYMENT RECEIVED",1268398748,0,78667acc0ffc9a8e6052cbfb19921c0dad4020715a6b86ebb0b488c80f8c5c35,92167865183
20180418,"PAYMENT RECEIVED",1265059195,0,3f1fa50fcd439f41c1c890146762491aa15061b59214305b713d7ddc1a997dce,90899466435
20180418,"PAYMENT RECEIVED",1281928708,0,5483f0d33799963f95de5462a5acbcef5949433e1634d19f9c1bedd1fb496b32,89634407240
20180418,"PAYMENT RECEIVED",1250076180,0,6d7ae47b7d1df713fb54d3215ffd4a2f2272c79b96f41c613f5699a6bdeb7000,88352478532
20180418,"PAYMENT RECEIVED",1262005718,0,c76816769ffdfce260a0a0474a67e067f05bdfafcc0df09ac77e47bf81cabb2c,87102402352
20180418,"PAYMENT RECEIVED",1260156157,0,4884c11d789ac6fb87ef5c445ee77836488d93aee75ff2fe29519fc2dd22760e,85840396634
20180418,"PAYMENT RECEIVED",1260121840,0,6f0213d1d6f011639c8e00b00120921549c52ba7442622876612983891aba2da,84580240477
20180418,"PAYMENT RECEIVED",1264374025,0,7875b098239e177dadb57d33c40dd291e8237b7b2a431c9db4344b271f327f25,83320118637
20180417,"PAYMENT RECEIVED",1259598339,0,c728806457fb9def329a677ac0370e8011cad7978b47d47cd7141489216b856f,82055744612
20180417,"PAYMENT RECEIVED",1253433968,0,b892f990c51404e34d297f61255fbb30e9885b767bb00ec9326334d5a73e3b19,80796146273
20180417,"PAYMENT RECEIVED",1263176502,0,bd2f8c13434fa98277b1be63e8cdbc23c88622be45bcc6692c7dec4eaded5c94,79542712305
20180417,"PAYMENT RECEIVED",1253255015,0,d6b4e00734aa337829b67f3c564d94ade9fc5db4ad54dd1876ae8b2daad07160,78279535803
20180417,"PAYMENT RECEIVED",1255189942,0,b683ba0279a2575c0160b822bcb1f3541576ff7501fd6a7068b9c215fbf2c5ab,77026280788
20180417,"PAYMENT RECEIVED",1261622871,0,27e2b977ab3b6b2be6940ac2ec7d05c5cb03c78d441ea93c0fdf05817d05d4ca,75771090846
20180417,"PAYMENT RECEIVED",1270600685,0,b009f37a366e6eb16e9487aa3e773dbc46260d9d4eb5731c6838cec9fa601d74,74509467975
20180417,"PAYMENT RECEIVED",1253223444,0,2d3d091fd9e828780b7511a0cf7520a47e61460c3d78a0a4604fd6fb26b85d84,73238867290
20180417,"PAYMENT RECEIVED",1284741281,0,2a086322761cb782b232e21ccce77581fb961715a5f7f19db5b0bdd0939231d9,71985643846
20180417,"PAYMENT RECEIVED",1255444803,0,66452da32d3bcc7ff35ec4bae7a73f7428dd543018a022f7166d73bf94d9ac63,70700902565
20180417,"PAYMENT RECEIVED",1253529156,0,7f659f7243338856fb61430dd6333b53d0d6e8ee2c4f3fb09b47eb818ab964ac,69445457762
20180417,"PAYMENT RECEIVED",1250122452,0,46ceb4677d2c95d356105ada337003d8cf8c5df7cd6de7497e9cddb0f60bc2a2,68191928606
20180417,"PAYMENT RECEIVED",1253371951,0,ba93d2afc5788e8538728c46309d7862ea3e4f50ef2d3f945b6999d6245f7bce,66941806154
20180417,"PAYMENT SENT",0,-96409761073,06573c71eb4b0c6ac2582dfe9377a0eb88d5c09f379ef463818789ef998f9da6,65688434203
20180417,"PAYMENT RECEIVED",1252333349,0,9044fa1af94703153bdfe082f5955a00ac3eec789255b326af9ed3e4dea56812,162098195276
20180417,"PAYMENT RECEIVED",1286887706,0,34f5c5b963f0217b930a4053de8ef409c3860f787ac3a3ee0bd4e6b109074048,160845861927
20180417,"PAYMENT RECEIVED",1268068977,0,3c5c3cc6933669f8499f3dcbb89a1ea97e7e913349237a861674fca3b8f8f944,159558974221
20180417,"PAYMENT RECEIVED",1283186743,0,05cb257db790c8de128a50d1df64b9d4f17b7a232d28216508e0e8c0f53a8fb8,158290905244
20180417,"PAYMENT RECEIVED",1251735711,0,cca0d77028b1e3159bdc416956516a1e8917867f046639123be63588022e8586,157007718501
20180417,"PAYMENT RECEIVED",1250840230,0,61d871cd2aa721fc9f15eb5536428363ef6a87250c75e32af6ca57c3bd8af6fc,155755982790
20180417,"PAYMENT RECEIVED",1261427232,0,a822ab593b4117af7ed181dbd1be27f4139158b7661fe54324e9927b96ba9c7b,154505142560
20180417,"PAYMENT RECEIVED",1250196565,0,0b6cc96f77525072fe106788639325b2fbaaa5aebaa47faf37e43ff9e5bd9428,153243715328
20180417,"PAYMENT RECEIVED",1253411891,0,4bda26ae2b8a2c18ec6f1721d6ba0157d13bb2e69b00e8311bb2367c756ddde0,151993518763
20180416,"PAYMENT RECEIVED",1253128356,0,6434ad03a52cc5f606c28256b14b083987bb340a9eddf2432fa08010f3b78a08,150740106872
20180416,"PAYMENT RECEIVED",1257096901,0,28c968f6a35ea04c387b99170771edf78334cc02a267999c0020d0cebbd6f7bb,149486978516
20180416,"PAYMENT RECEIVED",1298535809,0,9f72e0b2aa5befaed8a6c449732f30fa0875289456b97ba4bc637f144f90e80a,148229881615
20180416,"PAYMENT RECEIVED",1279679259,0,b36c3bbdb277459380ef8f285bf0ab2e5323a641a284f1320bfa82a0c89fc7d1,146931345806
20180416,"PAYMENT RECEIVED",1271399579,0,467f05a3379fa64440d91abdec2b9697aa8ca73967f18140d5f18ec89fea0f7a,145651666547
20180416,"PAYMENT RECEIVED",1266101592,0,a067f4100e8f241b42911fe0c0b2bddf4319a3941e32ab7fbad29c23f8677430,144380266968
20180416,"PAYMENT RECEIVED",1261208606,0,6deede0fbd1676fb1ba6ee9702b77b56c1f02d871acae0e87b08be3aa0576d84,143114165376
20180416,"PAYMENT RECEIVED",1258604285,0,e21be8ca560fd75d01eea77a814475fc7d8f6cec9d6822dd0b52a6730c27b420,141852956770
20180416,"PAYMENT RECEIVED",1277370545,0,afc6d647c3960d18f99ce3621ecc12ca69abb6c7e88398aafa07ffbe41a0a1b5,140594352485
20180416,"PAYMENT RECEIVED",1277341474,0,e306d2ede9701d7a2bb7b16fd5d063658a80323303e02f8351207d0c52aefd30,139316981940
20180416,"PAYMENT RECEIVED",1269139766,0,d38aed668f25e2a9aba5cc9d07c0c3c7d3d4f174bae6562b58d0cd933e5bfc7d,138039640466
20180416,"PAYMENT RECEIVED",1267082850,0,468f9dc92fa68f1950f9fd592ca06ba3b63e02ff021cac9ad0ff7186c14a566e,136770500700
20180416,"PAYMENT RECEIVED",1252336792,0,6616eb34a3de805f0473f152d74915ad0d8aa5e9f563eda612bd68bf946c7e37,135503417850
20180416,"PAYMENT RECEIVED",1252047891,0,1a7a685518ee5271779713f4c4c0857331828f93423c43862d4aca51308613a4,134251081058
20180416,"PAYMENT RECEIVED",1254910482,0,4edb0729d014396869fc1aa11e8d8b0c20a2d8fd4ceae66f941e91f4ca37e99a,132999033167
20180416,"PAYMENT RECEIVED",1260505881,0,05bd17a270dae2a027848b0b005a1981f45d28c33fc02010e0fbda573e578d1e,131744122685
20180416,"PAYMENT RECEIVED",1254466851,0,7c8a929037dccf06629c30d78dbc36f161c40260f58cc36b9c3cfeb00cae820b,130483616804
20180415,"PAYMENT RECEIVED",1273704162,0,0b051c505c4bf956c0af96b3b2107e14f1d6e736d1c994657cd0a046bf9f67b8,129229149953
20180415,"PAYMENT RECEIVED",1256831022,0,f4230f471d13a4a941b6da4c833730c532405491ede10ccf801483fe7bddae16,127955445791
20180415,"PAYMENT RECEIVED",1269151674,0,f46eaa30fbaac10710482a64d7a4766470e960d2fffc42348894612d3b903943,126698614769
20180415,"PAYMENT RECEIVED",1255944663,0,014fa342c17a4adaeb83c18d0e0b8984eb69c9e85a53e8bde0d5198d7b74e713,125429463095
20180415,"PAYMENT RECEIVED",1255293739,0,2429f4560c4209696b9afcccdbd545ccc98aa2212630ee6c533a4afcab375ae2,124173518432
20180415,"PAYMENT RECEIVED",1267896291,0,b6ffb18d354d7c2e39a6be5795ef37ba9bd49e0d1aa591cdc9e60abaa8ea17f2,122918224693
20180415,"PAYMENT RECEIVED",1289787129,0,d261f94d23f3c1da1f8b8b58b1671c5355b13d9a727e8357edede169dc79079a,121650328402
20180415,"PAYMENT RECEIVED",1268787724,0,24c4a7454980c6d722274e7a5b851ee868d9d93801e138f2241ea1773db9eda2,120360541273
20180415,"PAYMENT RECEIVED",1304279528,0,50713ad64375ead386b93ffbff393d7e5bccdc0667a32ea5ea0d0fcdd1466807,119091753549
20180415,"PAYMENT RECEIVED",1289481520,0,f7bd53186b64840d0817541f81175b5feca13e64b2db745fce4bd3a23029c691,117787474021
20180415,"PAYMENT RECEIVED",1259529002,0,0533ad3a57e4758719adec38645c129f7c3205af761cdefadd636946857972b8,116497992501
20180415,"PAYMENT RECEIVED",1259528011,0,6c228fe6dd849a6c388c0846ef1ddce0cb45f1eaa375d100cbb16fbf9ff4133a,115238463499
20180415,"PAYMENT RECEIVED",1256700573,0,b834bad52e1e344dd453024e24f10fac2600d5af3b931a260aa2271f5e4fd9fd,113978935488
20180415,"PAYMENT RECEIVED",1252645458,0,34db22a92fdac5d3dd3028a3cbfc0b49ff7f6dbda6b6657a1693892451917d80,112722234915
20180415,"PAYMENT RECEIVED",1276570449,0,686b717bd23a559727216c4dba0ea7f0be0145ac3940a3b04959264d3ded70b7,111469589457
20180415,"PAYMENT RECEIVED",1266634743,0,3a3dbf488172388b33366eaf064ae083f8241b894d6f1863b3b9ab5570fcc029,110193019008
20180415,"PAYMENT RECEIVED",1250262475,0,5e61fe21eff7fcc9137a67e9108e628e55d85d17e2a7ffab46e52087507ca7d3,108926384265
20180415,"PAYMENT RECEIVED",1253135355,0,efbafa486d4885fe8bfdf4298ee78f5601cc4763d705d5d1cb381f9e62648d62,107676121790
20180415,"PAYMENT RECEIVED",1257566375,0,d66bb99461cc90520ffe7be60bb1701be9d71813085980f5edc090478324043e,106422986435
20180415,"PAYMENT RECEIVED",1259058266,0,c3a1d52b395b1da214b1169a9f226bc2414d39786f9b9954a54cc0a6b44b332e,105165420060
20180415,"PAYMENT RECEIVED",1254647388,0,c15c898801ea4c0b9ac8addb72a1d0c4e7b6e63ce7b86cd1d4da614d7824864f,103906361794
20180415,"PAYMENT RECEIVED",1266649565,0,1e47d26bdfd2e37fdfd17744cb465dfa27ac0d092a4be4ed0beeafbc4a8cbd4a,102651714406
20180415,"PAYMENT RECEIVED",1259939925,0,fea8dcc35e0037e316e3addca432dfa34831ed6726aeecc943a4f3c6721e049e,101385064841
20180414,"PAYMENT RECEIVED",1268826919,0,43681e1c1e73bb02cdb26793094d89ccc4582184665c79b4ab7772a65d29451b,100125124916
20180414,"PAYMENT RECEIVED",1308074020,0,1a1f06785e5a65e021089991183030574156d25eeedfef012535922d76e931fb,98856297997
20180414,"PAYMENT RECEIVED",1266376434,0,8d843f1ef16e5dd1e33ac8591b7104804d6db40a9d5cbb24d95122801a4737a8,97548223977
20180414,"PAYMENT RECEIVED",1279273610,0,c6927d30f2543ec834560b0dc8bbe25e988cfb31a60fef63c9e4d8c7d0314e23,96281847543
20180414,"PAYMENT RECEIVED",1271286493,0,bbd91afb9d2fccb78c10b48346c30d3518fc9c8acb5f0aec7f66319e298e675e,95002573933
20180414,"PAYMENT RECEIVED",1279749203,0,9c8512060f9d5464006de2f48b8b6336fb72b0f63180b7c51b18ac0c5b942060,93731287440
20180414,"PAYMENT RECEIVED",1253453555,0,f142d5e979610c4035d572661464ce59eb282b3c65121d4efe6c9911119e1ba8,92451538237
20180414,"PAYMENT RECEIVED",1253519060,0,82de0bc2dbda303784f30d281122f2b66523bfaefd03dcbaf7ea82e398c82e11,91198084682
20180414,"PAYMENT RECEIVED",1250302330,0,adcb8a769d2c444e9f949edde9f10b2bfcf9162d5de2e531a1339950209c85da,89944565622
20180414,"PAYMENT RECEIVED",1250634641,0,f5664b7d2c013c766aea912c261c2f2442f2a2f1207426d002b40da1b52724da,88694263292
20180414,"PAYMENT RECEIVED",1254754578,0,6c56d05f48c474c981f43834a76f1d5e0bcd5b6fa58f536960f657eb6b7c01b6,87443628651
20180414,"PAYMENT RECEIVED",1256996296,0,3635e4f34a6e30ca85df2406fa44e8c2a2ad0837fbdf3bd288ce3959cc381881,86188874073
20180414,"PAYMENT RECEIVED",1256093487,0,2d9a7410adddbeb82c7cbd709f2886c8ccdfed440cf9b5d14253a8d11c1ced1b,84931877777
20180414,"PAYMENT RECEIVED",1279265091,0,02b80292055938b9c61237db32f59d1b15c17a944da728a0c6c03c1c7ba9ce4f,83675784290
20180414,"PAYMENT RECEIVED",1273381593,0,daf6e2d1092e1b668a887e849c3aea263b71904a8b40e91616a567e26a3e54c0,82396519199
20180414,"PAYMENT RECEIVED",1259164064,0,6caa17e4bb6aa7dc23c5a8539ba5504d7e477fc251852e9190747aa5b2244420,81123137606
20180414,"PAYMENT RECEIVED",1255591177,0,1c1749333ea63884960b5588cc87446b5fc1b129b909c611a10b7162a1900e88,79863973542
20180414,"PAYMENT RECEIVED",1269610857,0,02b676182368ccc9e7161582ac81c1ecb880d0abb200506ee856e6a5dda50a6f,78608382365
20180414,"PAYMENT RECEIVED",1266575729,0,720f06804bfcea6034677ea132ead2bb56e3956539b929e60046fa8119af44be,77338771508
20180413,"PAYMENT RECEIVED",1253027484,0,d61374f3bf11be92bd1ffd0249cc3345c3988df304ddaa42347ef08204d7b062,76072195779
20180413,"PAYMENT RECEIVED",1257473480,0,3fbb0bc19b19052a34fdc2e73ed04fa90a7691adaa060087bba6103b5d1032a5,74819168295
20180413,"PAYMENT RECEIVED",1270715285,0,fbd9f36d335dbea100f30293a0f7283fbf114a1ad3f4e4546d289bfdaaeab6dd,73561694815
20180413,"PAYMENT RECEIVED",1258822185,0,fbf5c2b78dcec598ada690c11f2f53958d353b1dd5c846186e3e675ce200fba8,72290979530
20180413,"PAYMENT RECEIVED",1287198917,0,735c4756ff1f0648c7e4b0436bba4c51a77c9e97f1b2d0bc23d6c5060efd3f5a,71032157345
20180413,"PAYMENT RECEIVED",1309382692,0,5fcc162c22af4a7a088a6e625d91a013b2f8e47b7f3fe3ced09ba1c1b85614e3,69744958428
20180413,"PAYMENT RECEIVED",1267327259,0,636db6acc6080a454bbab4c021116d37612f2a25e5b39b8a073c3b9e3d0cfd95,68435575736
20180413,"PAYMENT RECEIVED",1265719089,0,bdb8ab73d07fae19eed788ef4e8250a02d8e49abccb005a7fd1cea1f8d98eaaa,67168248477
20180413,"PAYMENT RECEIVED",1263634629,0,9e2286071c0d95554364fac849114bf1b405ffa492a8ee62d4b0e15f9b8ddd98,65902529388
20180413,"PAYMENT RECEIVED",1317000589,0,7102315a4b93a2fda0862295050607e1bf73ef28c99d263424ec370bfedb1a44,64638894759
20180413,"PAYMENT RECEIVED",1306677761,0,54548d1f30ccf9442e132ed6420c5e377490c84f0720e3b02b945f1bebf52ed1,63321894170
20180413,"PAYMENT RECEIVED",1286595817,0,bf22975ff821aef0e759f262f5a26e88a0de3be3ce30351b059d23795b931550,62015216409
20180413,"PAYMENT RECEIVED",1259227063,0,6a2b0bcecab6801b8260768b36ef247ef96e1d60dbd7473a79324380f5f6d6e7,60728620592
20180413,"PAYMENT RECEIVED",1255251977,0,97a26f9a03998c66834e8143a3d9c40ae06018c25f33dc96d7eac15ce140de57,59469393529
20180413,"PAYMENT RECEIVED",1290243724,0,96e5ef9182b07e9bc1f480c83a2b63a1b348691b5373f25f9597412943562cfe,58214141552
20180413,"PAYMENT RECEIVED",1263242860,0,a76d1cd70b9126f5472d4ebfe169b53bccf8a971757210e2aeaa521de8dc2426,56923897828
20180413,"PAYMENT RECEIVED",1260122513,0,2751a496ff06eb37df4936317a6354119efa755fba093f40f0b3712db68016fb,55660654968
20180413,"PAYMENT RECEIVED",1257414564,0,14b249ad02e3d9bd427ecee678a1ffad6ceb406b77c0832866bdd7b1795849bb,54400532455
20180413,"PAYMENT RECEIVED",1260124843,0,b87f41e85a646d297031205e9c2daa33df0af2bd107f473be70d8b2b33b56d30,53143117891
20180413,"PAYMENT RECEIVED",1250556572,0,9dbfc96b6702937aa485ca7273f1f7b962f9b3acd9467c64aa9bed848fd617c3,51882993048
20180413,"PAYMENT SENT",0,-98554136007,f1204707588754e9bce62f158ed4ae06d278404d61ba76a81e23bd4415d2d62c,50632436476
20180413,"PAYMENT RECEIVED",1259198875,0,ba91eac8b52e958ab5340e53b962b18a807ddcd987a671b1ba20af23bde0e680,149186572483
20180413,"PAYMENT RECEIVED",1255375699,0,d01b467d9dcaf6f3067cd13ab9cfbfc55472bc6b1c45d3710f6620ff5afb10c8,147927373608
20180413,"PAYMENT RECEIVED",1279262591,0,08f6e9434993d6da8cb8a5b47acd2f8658db0bfbe53bc7eb990405615e5e5c63,146671997909
20180413,"PAYMENT RECEIVED",1250000000,0,b11566cf74f643289505999c304d7b79ccb634d5aa6b354e1972565cf9550124,145392735318
20180413,"PAYMENT RECEIVED",1281446190,0,5154b01bd83bab84ee556dea1356700bea5d2a0c6ebbef55e4bcc536c0c40e74,144142735318
20180413,"PAYMENT RECEIVED",1278886665,0,3b88029026e47ba55173c659857c8241bf046734d6e22ea0bfc7ca4eac07dfb2,142861289128
20180413,"PAYMENT RECEIVED",1293737658,0,d0fd7b88349ecf9b454465b894bc70998ab333fefb27eab39e8178369bd96487,141582402463
20180412,"PAYMENT RECEIVED",1258406350,0,be1bbc568e4234f1eb35ed88a0af73e86de37a19946dd67c786f356464fa8915,140288664805
20180412,"PAYMENT RECEIVED",1258802663,0,a636671f383dca27ba7c97ad131996517ae76ae02a9254f0d291e7ffd75f663c,139030258455
20180412,"PAYMENT RECEIVED",1277492761,0,db85e216973a301429a8ebf3775d53c23e05e0dcb953570386f74fc3a359d4c1,137771455792
20180412,"PAYMENT RECEIVED",1257599498,0,f5861ff9ae1c7a5362d3b558596c7cea62668a89f5a950f96e24ed8a5e2dbfe2,136493963031
20180412,"PAYMENT RECEIVED",1265318372,0,6fa1c2d0cbba10ab8a238f49d5274ae015ebcefcbce6ecf68bd4b50608fcef38,135236363533
20180412,"PAYMENT RECEIVED",1278861624,0,ea1b3ac7f9fd3b81a7768277ea55fbb5b39b84aa8461b365cefd0aad9b97e307,133971045161
20180412,"PAYMENT RECEIVED",1315101317,0,563d2796feee8eba738d096fa46a251803a990ca3b18f91b3810106d0757eb34,132692183537
20180412,"PAYMENT RECEIVED",1328919879,0,068f3c596315c09e9a43ba7365a08dc59bbd2c6b3b6fb3242407c7a88f33f45a,131377082220
20180412,"PAYMENT RECEIVED",1330890859,0,7fc6210c972957af9d76f57c985c2f572bdc712732bf8a659fc6338afaf60e46,130048162341
20180412,"PAYMENT RECEIVED",1297352367,0,16e480c310a797b2f32802e5640df6a1c7cac28c7e502eed06b5747cf6b940aa,128717271482
20180412,"PAYMENT RECEIVED",1259110148,0,242399a2fd3e81c69c46da0008e040b6003727cfbb33250c7e35995e0976304c,127419919115
20180412,"PAYMENT RECEIVED",1262938955,0,1b72a9a258babb0dceef8c0289723e0c5b046f9d9686994d8db8a3cf6846bb0a,126160808967
20180412,"PAYMENT RECEIVED",1255184178,0,0efaee7215c9bc15b238984d554f288830873b628201a48fb912eda00dae4258,124897870012
20180412,"PAYMENT RECEIVED",1278055382,0,c4b1a5e764221ca217d51317a60a242cde3c1bf7c1a8db37a280f44c8cb3eda6,123642685834
20180412,"PAYMENT RECEIVED",1250053633,0,e71a50e70142b8e0c98103eee6dcd6ab21b96ee29577e847317acb92869e1ff5,122364630452
20180412,"PAYMENT RECEIVED",1259248800,0,4974ae1c2443a703cd5154e6d2b9af5cb28b13bfcb428ac180f24dec9efd86d6,121114576819
20180412,"PAYMENT RECEIVED",1250449557,0,9b7aaa0647551c9521314ba519bc0e5406eb557f1adfa04b7dd63ec567f4700e,119855328019
20180412,"PAYMENT RECEIVED",1250928149,0,e0691485bcac3bef54658a9011cb6d4527a185641c4b1c9b3dd4ac7576d54875,118604878462
20180412,"PAYMENT RECEIVED",1278615096,0,4d76a6be6e51990a9623342c9875c6a88c501f45e3010526c1c8486c9ad49ae5,117353950313
20180412,"PAYMENT RECEIVED",1255028655,0,7a3fbcca2ff3ca502586083ce2991a55f76164b497d7bf3cbf261149bc4b8616,116075335217
20180412,"PAYMENT RECEIVED",1254257865,0,d79abfc4302865c9b47fcbb67dc5a49907385c80cb1fbf19c380bf85a5a1a265,114820306562
20180411,"PAYMENT RECEIVED",1258620435,0,ea505c83f820a1d87f2a1d81b95fa0ba60cfaeec8ac813cddaf363edbc058b94,113566048697
20180411,"PAYMENT RECEIVED",1254064639,0,fec93ad065c04e00b0dd2149ca7c9149e08a764864e26fddf1c748a8aeca5e6d,112307428262
20180411,"PAYMENT RECEIVED",1251636504,0,0fda2210c0d0d9a2f5674d557f1eb9c946fcc6dd8801fc477eb44042902b0813,111053363623
20180411,"PAYMENT RECEIVED",1254540512,0,3b8cff2aa425fdaa6db1ce03c933f3d9819056844c008ffd4292af2d829acc4c,109801727119
20180411,"PAYMENT RECEIVED",1250324436,0,f46c9a0f6ab9a3c70834da176cfab7681b390c376ecde2b2c7ed4cb1280a920d,108547186607
20180411,"PAYMENT RECEIVED",1274100272,0,d75161d7fdc408036accdbfe5397e224e63888e9107a1069ba590c2f56e78eae,107296862171
20180411,"PAYMENT RECEIVED",1263612597,0,2c4a1aa07d0eda309069f2fff9507791467f60a3476cbf69a53377496d27a190,106022761899
20180411,"PAYMENT RECEIVED",1258438874,0,f0d41f68b1f4cf8c0d7f39ee921dcb94a5fa73d0a5e166b186692679430a6532,104759149302
20180411,"PAYMENT RECEIVED",1253617118,0,7bac49914be16a180ef7c0359ce146ac776b3ead83a2abf7246d50ff77ff0e35,103500710428
20180411,"PAYMENT RECEIVED",1256930110,0,f130ddc9acc748e395a9da37b61184bfdd84793688248f4e5a0783ca619ee1c1,102247093310
20180411,"PAYMENT RECEIVED",1254589642,0,368a49aa69e9413bfe6867560f98159d1798e6b810ab32efa5e4458cf7ef257d,100990163200
20180411,"PAYMENT RECEIVED",1255790234,0,85d00ed9c5b3ac2e70ab289e419e724cde25aa7756e0c651d9669f28845767df,99735573558
20180411,"PAYMENT RECEIVED",1258754703,0,5ee1d389ad94a2fa9e6430796aba2128bcb391036065ea632dd41a135dc93fa6,98479783324
20180411,"PAYMENT RECEIVED",1264376533,0,432a6989b890bf500b1970a8da275d5a3604ace994340a74ed520d388b33e807,97221028621
20180411,"PAYMENT RECEIVED",1255336742,0,3c34afac0616dbba3133c084c7198c7f98301214025e43fc6f83b09b7fc53ed5,95956652088
20180411,"PAYMENT RECEIVED",1257523239,0,d1875772b7aab22c462faf3994a0b6bb8fcaf70ee8504069ad198d4b2a477ff4,94701315346
20180411,"PAYMENT RECEIVED",1252550400,0,b2c09252b80ab1ba084347f4a31bebc308f14ce04a19179e26244465e47a45a0,93443792107
20180411,"PAYMENT RECEIVED",1266030897,0,e45ac5579cffbfaed3b7c53ee266240984e7b4138c07c74db0d13b8cd4455685,92191241707
20180411,"PAYMENT RECEIVED",1280232024,0,0ed1397dfa59de49de89204bd32ccd0376508f8ae722d4deafe1a142e864683a,90925210810
20180411,"PAYMENT RECEIVED",1256672147,0,900a6baeae863870adccf04945e1c6a7360e4c60b94934b8c247139ea3089e9a,89644978786
20180411,"PAYMENT RECEIVED",1285253416,0,10677996c195c182d37c355f29441bf5d41f6663bbc543575c4d2e173c6716a8,88388306639
20180411,"PAYMENT RECEIVED",1250262085,0,1bafad778ccb337d14f147ddcf475149864f9c729e594f1ff44a1f61fa97d6af,87103053223
20180411,"PAYMENT RECEIVED",1260960455,0,ad4d2bbb3da51850932d0ad2e591a681097638616e0735a5d36af392f26cc824,85852791138
20180411,"PAYMENT RECEIVED",1266234423,0,763404b5d46738edea028f7b7791a889cd166b6200168881450bf72d1c87d502,84591830683
20180411,"PAYMENT RECEIVED",1256163674,0,76bec4933a66a17fcb510931bdd0fdd6d0b61bebe1b1974d7f507bc1e0df96b6,83325596260
20180411,"PAYMENT RECEIVED",1263840287,0,34a30946a95cffac6b04a7ce5566f582c814317a4464b289a93ae7a1c234a0b7,82069432586
20180411,"PAYMENT RECEIVED",1260050951,0,a83084cd2c11eb6b14003815b7f3276891483ab73965f39674ab62c5b3a09b73,80805592299
20180411,"PAYMENT RECEIVED",1251757886,0,03eb71f66902937b857dc7c522219b350cf816ac6396635df643e36e7e7ba404,79545541348
20180410,"PAYMENT RECEIVED",1252465164,0,6832a3f813de21a420f634e656910606e05a657e0bcd0a3c9d350a3e83214e2e,78293783462
20180410,"PAYMENT RECEIVED",1253448700,0,2f4f4816c660cb2ddeb73dd6bf44bce3d04bf52857c069b857de034f932a864b,77041318298
20180410,"PAYMENT RECEIVED",1250228645,0,da11563e62cea160dae5d4fcc744edaa45e2d5eae733059abc1febd8da84e411,75787869598
20180410,"PAYMENT RECEIVED",1250166874,0,511cd15528aba6c618182889333e951ebf247c91785c952fc1b0be9e23979775,74537640953
20180410,"PAYMENT RECEIVED",1277798410,0,56289ca48b5d9286b1b92470fb560f7ac8010b1c105e2e78a2bbb7f0779e1335,73287474079
20180410,"PAYMENT RECEIVED",1254109920,0,86339fd862e6935ac4842b360f4ab7c3b7d60d1ed9f8ecbd982cdb673366b5c7,72009675669
20180410,"PAYMENT RECEIVED",1264798031,0,60042782a27bed067bc678777bb3a1052cce10e38cdf39672b1c53f341262238,70755565749
20180410,"PAYMENT RECEIVED",1267118700,0,4430d560bf50bbf0e95df9b9fa1a83b36b3e6b2159bfc2eeab3137a4278b3cf2,69490767718
20180410,"PAYMENT RECEIVED",1305664571,0,544e6611d6f1b447cc533e8ff9f25c6ee50ff20cb3d44cd353701b96d17eb53e,68223649018
20180410,"PAYMENT RECEIVED",1298253098,0,8697276e627a2dd2a973b4b91da39a3529a6418a0c356299eda99e2c5d3b992f,66917984447
20180410,"PAYMENT RECEIVED",1258990084,0,496be17503ab85dcaf4c2348143419604feee29234097cae0f44ac6d2725abb6,65619731349
20180410,"PAYMENT RECEIVED",1277042161,0,9349750e161c7282f6913cfb2dbb55b33955efd30c3f468b222adaaf57f68e4a,64360741265
20180410,"PAYMENT RECEIVED",1286251629,0,a1f5064a0c0f6f133855af6b9ef62f88f61098bd1776a61f0dea9530e914078d,63083699104
20180410,"PAYMENT RECEIVED",1258632433,0,2e53e84bbd6877ff5ae761e20e144101fef18a522f0de1fbe8b326f41531b79c,61797447475
20180410,"PAYMENT RECEIVED",1272348497,0,04ca4a4da3f82afa948a2ebe9c92c3ec51616c71e578e5c8152c65aeb239e1cc,60538815042
20180410,"PAYMENT RECEIVED",1269604760,0,3a67202a6142a2c81159837955870228f8b8725a8a8eb839502d841797b4d1ed,59266466545
20180410,"PAYMENT RECEIVED",1250026272,0,0bfc6936253c38866d086d1dda5c551413886dc8313cf339a19dfc1f959ebc48,57996861785
20180410,"PAYMENT SENT",0,-99997569133,247c17d4c95aaf6dbbd11225eac5d8fa7dc3f6831a2ec31927c2bd3c52e8d5b3,56746835513
20180410,"PAYMENT RECEIVED",1259672578,0,3f73c7301b7bbaafacc5d81c6ee1d1934a1e396663f983acbfcc4d6d9d860a46,156744404646
20180410,"PAYMENT RECEIVED",1255166333,0,39dd3bbaa860cf77dad4d110abb1b9cde8b72202260bd864e3237d240af6d0e6,155484732068
20180410,"PAYMENT RECEIVED",1256422737,0,40cc6e61c063fa5717baf2f92e711cdf208b6efc19f7433e7945d1fd8661cc5d,154229565735
20180410,"PAYMENT RECEIVED",1250416445,0,3f384649687cef8b73e4d736b49c390ca7667cbaef51bf20c2f26af254ed112c,152973142998
20180409,"PAYMENT RECEIVED",1250000000,0,a8db5e1c6fb11ccf7dc35f3c488dded37144ae8b4e2edb3a48de6a9937518f19,151722726553
20180409,"PAYMENT RECEIVED",1283552026,0,fc6cd0af76ea3107dc9ca5974a8e2df9ecacf2a2e6859dde155e474264868e4e,150472726553
20180409,"PAYMENT RECEIVED",1250000000,0,2be0218a7f991632fa4f957a1980c88c126941510a8d05f6b7ac127351252be0,149189174527
20180409,"PAYMENT RECEIVED",1262801292,0,c0718ed617565f55ed82c55cdd2fd522fc388f802ab7571b42f0afab7a87efa0,147939174527
20180409,"PAYMENT RECEIVED",1291441060,0,5e2a1ada685628056e0a97353cde976784fcb2a849348500978c44cef43fb0ec,146676373235
20180409,"PAYMENT RECEIVED",1260545558,0,faa3b21d8fb925f7cced1decc111db1d878281ff4771fad65633bfa1b9b9e90e,145384932175
20180409,"PAYMENT RECEIVED",1273650813,0,9d675c7ae55d31319f031f1367e0afb96182f138b9b5fa5b1d76a238de7331b7,144124386617
20180409,"PAYMENT RECEIVED",1271386649,0,033bb66cc39d265e56a7f5ef4a11350f46af744007fc638180517ca9253e31fe,142850735804
20180409,"PAYMENT RECEIVED",1250067766,0,2e40e946155f016557ab7921e7147635c64143b818ada865ff447f76bf37c5f5,141579349155
20180409,"PAYMENT RECEIVED",1253304997,0,765ca7799fc514e5b8824202f5ec3426919b27e83aaef183b6c71fe085c72bf5,140329281389
20180409,"PAYMENT RECEIVED",1251555283,0,44226c3f0811d822557527a823fe5911f95c3b1c891bbab1d68332a2038c8929,139075976392
20180409,"PAYMENT RECEIVED",1262780251,0,7af3486b1156488260be12e13a736822add125d882caf9dffeabc2163d716f85,137824421109
20180409,"PAYMENT RECEIVED",1286845135,0,0f470f19f687c809cb2e900f852085f9d403dd02d0cb484e72fe87b8f6c76e26,136561640858
20180409,"PAYMENT RECEIVED",1253344692,0,936cffcf99b8aec8e056ba2885d4f1bb9f10fcc7a798d5712e5d3e210368ceac,135274795723
20180409,"PAYMENT RECEIVED",1260725751,0,ce5c5b0b872647d20d8f9affef8af14013ce676bc25733c13f96cf2f7c497ec5,134021451031
20180409,"PAYMENT RECEIVED",1262828495,0,7aef5b1c8f9869c48f53308d386de21cbbddb6254a26eadac52d65c2c726a6e1,132760725280
20180409,"PAYMENT RECEIVED",1253110749,0,42ca09195c7f026bd928fffc98dcfa3df6967a33501d5d1302da62ff218e77ba,131497896785
20180409,"PAYMENT RECEIVED",1269222349,0,c1fabeb630b1ae9d6afed3e3009a9ead7d6ed994a132d3c4fa66620cc9c69e31,130244786036
20180409,"PAYMENT RECEIVED",1253846173,0,7b1cdb67a4321368dc41465dbc5d4e512ce50ce6fc876354e4c52628f23a9a41,128975563687
20180409,"PAYMENT RECEIVED",1279500475,0,ea74fcd0be82d0b6b46abf9971056b0f4f510699822de45a9023fa4d7e6b3597,127721717514
20180408,"PAYMENT RECEIVED",1259363441,0,a26733d1abd2200b0088b27572d16464a844037193c7acdd3439c9bea0f2fb74,126442217039
20180408,"PAYMENT RECEIVED",1252096676,0,87d7ac73aaa1d844b241f01ff3c62b21983bd38482f2a26750f2119b37ee6671,125182853598
20180408,"PAYMENT RECEIVED",1253142178,0,cfea84e8f5f27b6da2bf3a698d839bc695d60d8c91a90ba14dbc1e573d1f9fb9,123930756922
20180408,"PAYMENT RECEIVED",1250972292,0,fa95c021857797a76d7050a5d33c0abc34a87aecb23070351c80120cd1b7d21f,122677614744
20180408,"PAYMENT RECEIVED",1263835039,0,138134a51feb640ee4da5c627cf95852e976dfc6bff5a5061610980486d896ba,121426642452
20180408,"PAYMENT RECEIVED",1255324756,0,91e035a51be532770f851a3236a8080120d6d47ccfe812c7a1f465995aae8212,120162807413
20180408,"PAYMENT RECEIVED",1266717820,0,d70bd4f0e80792edcbe68b9ff9cc7aab485192b53fe5f01b84b127906cee592c,118907482657
20180408,"PAYMENT RECEIVED",1272139615,0,1575fec871c0d263e88b3f03e74da0731affb8e7f5577a45f0fde9bf21be9991,117640764837
20180408,"PAYMENT RECEIVED",1269528276,0,aa06c85f609bd11f277c2999f52a7df7620b716c3e900634585c8e05d83d4742,116368625222
20180408,"PAYMENT RECEIVED",1261817495,0,b5ed384ec3ffc73d103f7f833d4383fafc4a69efbd8bbabd1a6aa3b7a9b28cbe,115099096946
20180408,"PAYMENT RECEIVED",1251978479,0,6be82d58718617d40ac444b0708ba24285b2759d25ff3f6e18e993f2a65557ac,113837279451
20180408,"PAYMENT RECEIVED",1266310446,0,02a3c8c537a34b1a5db1797831791e7f3f9a0830975406c910b662ed241fca63,112585300972
20180408,"PAYMENT RECEIVED",1254468349,0,fd638ac295515f190f9fff4380aff1b521aae240419fe2fe78fd8b3f348d3a1e,111318990526
20180408,"PAYMENT RECEIVED",1295055347,0,e2718a040ae1dde8978d16f5bbd3c992ac86f81c5b60ac9e10b7c52eb01c6c7d,110064522177
20180408,"PAYMENT RECEIVED",1271385735,0,692dd53b24b0f2a38b7ccada7fec01a4cd66fcccf5af0b6da10266425d653e9a,108769466830
20180408,"PAYMENT RECEIVED",1253066912,0,7fc6f3a0fdbf93fc5edbd9fd488b94205a53481db178062e55309b953885c85f,107498081095
20180408,"PAYMENT RECEIVED",1261581359,0,c8fb25892a71e4a24d3d6b2825cdd93244a29c17549854659152b331d4b05953,106245014183
20180408,"PAYMENT RECEIVED",1250313893,0,1c37dee759a2e2ae5ea7b159f7b36261bc3fcfc3bfa0cb941881e09c4c25083e,104983432824
20180407,"PAYMENT RECEIVED",1255125187,0,a937c00ea617ac451ed6cde9011584c819f95da7e992d9dacf7224707589bf47,103733118931
20180407,"PAYMENT RECEIVED",1254487149,0,a4bee45e333457e527f17e9c7c4ed75c9b2d31127744296d4e0bac23ec9765bf,102477993744
20180407,"PAYMENT RECEIVED",1255619111,0,19930d58a6f4bb2b91228203567151672b9a2f365c60b5f434c160c3f6ac4ea7,101223506595
20180407,"PAYMENT RECEIVED",1253456745,0,d48a15baf8bf81867245b554046c956148421b7c83a118a3241364a0dee30097,99967887484
20180407,"PAYMENT RECEIVED",1251977905,0,80fbb6e322f7b66ee3ca448c8011d1b762a3a1612be4a78583e1f2fb047b25c4,98714430739
20180407,"PAYMENT RECEIVED",1251038164,0,686e9831a5443c12655bf17b6bf1d072b04cce8b869348fbfdadba9aaba0b5f4,97462452834
20180407,"PAYMENT RECEIVED",1254579195,0,a9fb4c2805cc50d1f87f50aedd5ae60afa10bca34163d3ad4f96ffbcc3428123,96211414670
20180407,"PAYMENT RECEIVED",1258097902,0,6f04282e5c9b7b234c237ec6cb3b5335a87ddbc893474d6eb4d6d74b2dcaff95,94956835475
20180407,"PAYMENT RECEIVED",1257125844,0,b22bafaf2a812cac0f06ca1267d7f9577b434b70e200fbd5b4a559322d9b956c,93698737573
20180407,"PAYMENT RECEIVED",1258111118,0,7413df40a737f29ec6e1ef7d11ba057ac808ac6edf971205a83bd48b05f7e5e3,92441611729
20180407,"PAYMENT RECEIVED",1256875654,0,1b168ec3be11b764eb0d929900f5c279a98cb703e2415ddacdd6c93dd2e5d94b,91183500611
20180407,"PAYMENT RECEIVED",1287432829,0,6ba601e8614b418945525a460d9175bbdc9a1bb97add47005b410714d101c17a,89926624957
20180407,"PAYMENT RECEIVED",1297115916,0,5d9f1b56f70e347be711ccda7bc1f80e1342580d2a139ab58b0336645eb399af,88639192128
20180407,"PAYMENT RECEIVED",1257969352,0,c61bc407194adef040b599528139848da41be55b319d127debd78f1d7ce128e7,87342076212
20180407,"PAYMENT RECEIVED",1288662746,0,737177a640c8274d6840e14f9233b151d3d34a6d54918c84b78f461f45921b3e,86084106860
20180407,"PAYMENT RECEIVED",1320827195,0,198c85a9b845ab005ce8574dcf94042f5314425963843c328b8506f927e565e5,84795444114
20180407,"PAYMENT RECEIVED",1252252970,0,167b99a39eacfce41258cd8540869076089115d83b93e5bad40d33a3af8838bb,83474616919
20180407,"PAYMENT RECEIVED",1251641791,0,a069a97ec612a7b5b12935ab7806c3e71a24a6778a846b46278730752294a2b3,82222363949
20180407,"PAYMENT RECEIVED",1280862002,0,cc65541a33ebf0c89e4c95f3017da05558206ee224c8508be99146c00f3a17e5,80970722158
20180407,"PAYMENT RECEIVED",1253649003,0,a5ce2efef820bbe3bb98c9a4533b51d916707dcb40a4c30d85cedb637bc89f0c,79689860156
20180407,"PAYMENT RECEIVED",1263574290,0,05e401ea57dd7f9728b48cd80272f505cba76c58f4de1ed032732a48073cb637,78436211153
20180407,"PAYMENT RECEIVED",1264468263,0,88b318869891b9618b43cdc5e602bdd607663c7c2b0262dbea780bf53a7b2ffa,77172636863
20180407,"PAYMENT RECEIVED",1255171425,0,9d8cfe77f318b1be86336206acd88aa5682883bd6794b83b232e94d91a84eaa7,75908168600
20180407,"PAYMENT RECEIVED",1251654046,0,59097ac9ac50f7d5e211b6bc6f60dffee41cb4ff7cf16731472eac338991fada,74652997175
20180407,"PAYMENT RECEIVED",1253622354,0,c203cba620fd955e8c98372b9c002370af3d23885b60bcbaf4f2389d6b13ce37,73401343129
20180406,"PAYMENT RECEIVED",1263967862,0,3e7b15892d999aafc75ebc673efb4c773e002e6fec7d40d7fb8fa3b402aa0166,72147720775
20180406,"PAYMENT RECEIVED",1264785007,0,f5fcf7c636bd625e091a2ed8373ec52295a02ae5c8fddb7d9a562dc83d9a3e2a,70883752913
20180406,"PAYMENT RECEIVED",1398041507,0,1b22537a8bab1456e3866ef0954a95df451fa2aff4efa705fa5ab6dc2458a5a3,69618967906
20180406,"PAYMENT RECEIVED",1304368617,0,7a6387bacdd5c06198dee8d50efc7db8d3f4d6867f8397a4087eae8a785cbaad,68220926399
20180406,"PAYMENT RECEIVED",1281627746,0,246f083a410bb88369ca043e62bfef7199ddba4a4f466e24ddda2769d201d5a9,66916557782
20180406,"PAYMENT RECEIVED",1258396150,0,7ecf4564aa58b02f84a435669d4384b9b3c85b13845853d113ca40eaaa182f8c,65634930036
20180406,"PAYMENT RECEIVED",1294326007,0,1ce859b6f2db61ee510128f3d701ca3eecaef8da4e4d88b8f97e78a4c31ac737,64376533886
20180406,"PAYMENT RECEIVED",1273279156,0,609fab2239f094d532ebf481d81514bb0686bf9c98abc01bc849ae99a0ff630b,63082207879
20180406,"PAYMENT RECEIVED",1256566661,0,b0311be5a4cb1dae10c3e5728fce32489682dee2d7e00392fd88d886d9b46f04,61808928723
20180406,"PAYMENT RECEIVED",1257628379,0,04d2d4404b0b300c8c56e25ab865d857e53aae2aeaba4c815ef706653795cab1,60552362062
20180406,"PAYMENT SENT",0,-93680223574,8d35f76aeaca277b913e819f0dcef6f52b2a75c3d6e13e5f7d4c338451f61044,59294733683
20180406,"PAYMENT RECEIVED",1256272875,0,328ad73bd9fec1bfa1876e7b7e924cc03c3d4167f1125ad8ebfb5d32b7475ee9,152974957257
20180405,"PAYMENT RECEIVED",1250579978,0,d5ff1cf8ef822483d8618a6d20a1393942730fddca3b7ba5fb3abc3f065f8e6c,151718684382
20180405,"PAYMENT RECEIVED",1253836217,0,ed63b64f3dad68b9c20fd7fbbebeeff9866bc381d3b0768133399fca1ecda38a,150468104404
20180405,"PAYMENT RECEIVED",1253086178,0,66e6d2399bfd5ffeb423a828e390bcb3533ca3177bb7ac7188e8d6dcc0db6040,149214268187
20180405,"PAYMENT RECEIVED",1252054390,0,9730551ed952518de27f1e80c18da5bb34cc9c125bdb7203091e0cabf0d4d1b9,147961182009
20180405,"PAYMENT RECEIVED",1251272203,0,0615d7948cbfbcecd21188de4112183139b0de7d753849159d7e3466ac052305,146709127619
20180405,"PAYMENT RECEIVED",1284475661,0,d5e1f477354030ff0723676e04a11f1523e1c2a5d04a262a8db98fae333b3bc8,145457855416
20180405,"PAYMENT RECEIVED",1292496260,0,c409b395b824d0187e8c94950d95d637d59d367cbf161efc3f75693176d8848f,144173379755
20180405,"PAYMENT RECEIVED",1257069213,0,55bce80c41f3ca56ada3e9bebb18a2c19ba348f716decb906ae8f792f9261679,142880883495
20180405,"PAYMENT RECEIVED",1254964587,0,5edc35e9ad71020f99a844f9a0ab76c01810d8805cdfa23a163d7b65f7fbca55,141623814282
20180405,"PAYMENT RECEIVED",1258433150,0,38b158e6b5fee9f4642e2adc71ff88dc30f3c0044e38f4158ca05e6e47b131d1,140368849695
20180405,"PAYMENT RECEIVED",1292610210,0,edc15b0b99969262f4d1b7d9bbc1a75a08e9c9166a4e26fce2c9e27a741240c6,139110416545
20180405,"PAYMENT RECEIVED",1256534764,0,3725ec26025511afbac8f86300b57ee2afef267df79e62a3a14850a855a9152f,137817806335
20180405,"PAYMENT RECEIVED",1264899671,0,50b17ee1ad4c84091c2429182459a02ff446c4562ed9313eeaaa28614b7303bf,136561271571
20180405,"PAYMENT RECEIVED",1268821363,0,b8d4ec21936211cc2f85c2fd4e0e4b0e9f0ec7710f99c91c124a56d05c25a28e,135296371900
20180405,"PAYMENT RECEIVED",1310146519,0,efaf3880f5ba97c999cd51f8c1174ae29fa6d435170ccca1e527f68882ce5bb1,134027550537
20180405,"PAYMENT RECEIVED",1252156132,0,18d249a3c2a52f9c416a7e0957154e7846466a5b969323b3f19260738286952a,132717404018
20180405,"PAYMENT RECEIVED",1261314751,0,83974830c1df6c9b63bf6f6274dd2b6830b8f0d465630f14d8cb9046a83392b4,131465247886
20180405,"PAYMENT RECEIVED",1258880303,0,e29c3082b912a7c13c32c10287b0ad3730e8bb3d77bc982ea4629c415ef9abd0,130203933135
20180405,"PAYMENT RECEIVED",1280174406,0,6c8c985492fbc2dcb510b88a41d0209c224e4a818856cddae471da644437667e,128945052832
20180405,"PAYMENT RECEIVED",1262649995,0,5182dcb6eda07bf1c0928f1a9b4a493be642179da02390cb89150752ef7d1788,127664878426
20180405,"PAYMENT RECEIVED",1263378291,0,125bffa460a6f2d60743745b749f12e50d05bd73b9ac3066f68d2ebf1d691e9f,126402228431
20180405,"PAYMENT RECEIVED",1259414605,0,23a99369ba1c7b0ff1f4caf66ec0d357b8fd10b7ac0cd67733fe61b86b952e58,125138850140
20180404,"PAYMENT RECEIVED",1271786306,0,91ad028073e9efd600110c4fbf8e538c9b1790a2b2c2ce55aa7fc60c55a01a7b,123879435535
20180404,"PAYMENT RECEIVED",1251560705,0,27529c300185681b7a1d8713174cba031b2d0d53fdb5225b5b6407936d0e189c,122607649229
20180404,"PAYMENT RECEIVED",1265006152,0,1c843a9b960d128f115a9fbe21ac2e3977eb4364f8c4a9afe4a29a17e4d05feb,121356088524
20180404,"PAYMENT RECEIVED",1278841914,0,291eda6f7bfed4568a1e58aa8567fc1291d670b7ee5a61365b8f2038dd5b86dc,120091082372
20180404,"PAYMENT RECEIVED",1255890789,0,645ff37c6e6fb3134b48f4b5039c8e58ba6050c45b2f3d6825e9585e953e6511,118812240458
20180404,"PAYMENT RECEIVED",1253607673,0,2510288725561d3c1815c303fa62219682217e07f6d72b5ed8b7fb3d1e198779,117556349669
20180404,"PAYMENT RECEIVED",1282061733,0,f6c129c6a0af01bcdd7185e9054e54e6c96e3b222ed72da345674a132bd59aa3,116302741996
20180404,"PAYMENT RECEIVED",1282027498,0,ed094ca432341c8196850d6a9b7640fe75bfb75d8c14bd89e59e53ed59c79dd0,115020680263
20180404,"PAYMENT RECEIVED",1285376970,0,faced02dc08c28b29c47761c9e7290d054f03627fa83a82cee0b3abe0594de86,113738652765
20180404,"PAYMENT RECEIVED",1262451669,0,276083a56765ac81e8a0dfc6db6e79db2b70afe0e648faef09a6160e73e5afec,112453275795
20180404,"PAYMENT RECEIVED",1263912810,0,bb1eb41f4890d095023cd8a47b91d7a3e0e015cba1de4158653cee055748007b,111190824126
20180404,"PAYMENT RECEIVED",1268158271,0,41b4b80564717fa7a4edee529bdc9ac05516fd7bd02161bf283b3ebc2dbaa3d5,109926911316
20180404,"PAYMENT RECEIVED",1253099642,0,53ed58fe37d6554fa2675f78387ccd160a0d675c0ffbbd2c7a09fc382cca6683,108658753045
20180404,"PAYMENT RECEIVED",1296060875,0,64573871cca3d861bbfd7497f5379d48c20487b3d5705d804165c7da874b873f,107405653403
20180404,"PAYMENT RECEIVED",1258458403,0,55676ecda6dcc8879c6b91bb9376b51b786af12e36cd28427f0a0e18e1282908,106109592528
20180404,"PAYMENT RECEIVED",1251559624,0,2148fed1184aae9d3feed05ec52a4b71fd739cf789cf921787dc2a2ca083673f,104851134125
20180404,"PAYMENT RECEIVED",1253487601,0,c4504fce6a8318828b4c5cf5c6ed4c4dfcfc45d23b11af0eaf0ee8dd60cd500a,103599574501
20180404,"PAYMENT RECEIVED",1270555857,0,a2a0094b11e532c51ea9d43bb3330126cdc9923f3018b355a1a1c6df83e5ec34,102346086900
20180403,"PAYMENT RECEIVED",1263202934,0,f0813d3732f8f5140e9ef12deb13af53b69698960d89806f0d23a1faddd8b43e,101075531043
20180403,"PAYMENT RECEIVED",1264214210,0,dada4b149b0eae9d3dae291e3decd041ded534188993fd70a9e2a9ab7e99606e,99812328109
20180403,"PAYMENT RECEIVED",1250052256,0,971ebba45dce43eef433a28b852ed6df98368efc4177b766e0e718aebed713fa,98548113899
20180403,"PAYMENT RECEIVED",1267887583,0,94a15b5b5325da18c19099311007259ae21fdc3bba6076ddabddb081e186f7fd,97298061643
20180403,"PAYMENT RECEIVED",1256653317,0,40ac778c2702604f16554448333fd7bf4d18fcc2d566306d407d1b653c3c3a1f,96030174060
20180403,"PAYMENT RECEIVED",1272634295,0,6543e623911b7c8377074e63af2e01dd995caa47d9d18c1ff348e4f25b950fd1,94773520743
20180403,"PAYMENT RECEIVED",1258156393,0,450342ee9b343ce02032c0108df114467b0dc69097ff57fa4f168e1b0ad8e638,93500886448
20180403,"PAYMENT RECEIVED",1252688331,0,da9ab8676482d8687656e0a508f10b068a96d6159e47bc6332c29602939cd487,92242730055
20180403,"PAYMENT RECEIVED",1279691930,0,cd66abba73beb0be3dd4f79d22d3b42c4303486f0dc3f7ca3e6f64ab5b0e1d2d,90990041724
20180403,"PAYMENT RECEIVED",1262510645,0,5dda5c75ca39711974a1aa1829cfc2e94b1bcf272511916f9f380cff6d3a6178,89710349794
20180403,"PAYMENT RECEIVED",1292014661,0,6785799e2a077cdc3e33f7ff099066492e0663b6a6e329cf40192a345550ca2e,88447839149
20180403,"PAYMENT RECEIVED",1250491161,0,629678a056cf8e4185ef044c9addb42322d60717bcf1bc12cf0cd7c170c2c857,87155824488
20180403,"PAYMENT RECEIVED",1255465240,0,6c8b05c9c925614f2eb7d99c5af3529da75b5cd35755460ba70ffcfbbeb06e69,85905333327
20180403,"PAYMENT RECEIVED",1269329393,0,964e0ad6672f173035ee70963875dc783a20b557f26d462c06822b0cf36beac3,84649868087
20180403,"PAYMENT RECEIVED",1263648034,0,b1dbac1782ef3899682931a3321eacdb3f6d51787c4011afbe8ee78b66cf355a,83380538694
20180403,"PAYMENT RECEIVED",1253681154,0,38e9beb556aed18a53ab4b4a3be7f12943befd199b0fc4375d3ed563f20a89e1,82116890660
20180403,"PAYMENT RECEIVED",1278339412,0,34212254107c9cddbc2bdab1cac2a5a397a8a54d46126a419ddac9ef49f3b3a7,80863209506
20180403,"PAYMENT RECEIVED",1250323533,0,77a44ce565c3b176b5d560812d060805bf358d94d8049d1fa130c7995e2239a5,79584870094
20180403,"PAYMENT RECEIVED",1253068056,0,29b855eb2faa23d3a14734baad6852606320146949a268d28796eb3b8bcf89c5,78334546561
20180403,"PAYMENT RECEIVED",1285365129,0,da47d990e794dd687990f6f4d792ff0f7262a77b858c51386c8b33b71d2d77c8,77081478505
20180402,"PAYMENT RECEIVED",1263314439,0,9f84c460c392a37a0bf056c26472e6ff7e4e29f5fcf93530b763bee397995f1f,75796113376
20180402,"PAYMENT RECEIVED",1264672676,0,b68e392d50937b466fd5aff7b2ce6cc5ae886937d75ee5e87a356b92b7b91a7d,74532798937
20180402,"PAYMENT RECEIVED",1255407896,0,57cdb4fac64eaaedc089eccec211ab41b52b4badc0e652fbd6f623c1777d1cc4,73268126261
20180402,"PAYMENT RECEIVED",1273417824,0,df6407715b4e11793f99aeaec33edb12669941dd9fc99fa92424b48588a13e2e,72012718365
20180402,"PAYMENT RECEIVED",1252728274,0,2932ddf4cbf5cefe93ea2bfbcb4d79e2966961e2fe753eeae5923b155da689f9,70739300541
20180402,"PAYMENT RECEIVED",1283267470,0,ae7069af98e456d95dd31464b4700540079bf6e9cb2266ee5575cdf0d48dec8a,69486572267
20180402,"PAYMENT RECEIVED",1267268842,0,26713d3041437aaf5747f809f5daea7cb6f4abc5fafaa841467588d351647e09,68203304797
20180402,"PAYMENT RECEIVED",1250349292,0,db186f37108f2d7b9f56151e50811acce5fb295592527eca802c7ac035597ede,66936035955
20180402,"PAYMENT RECEIVED",1268278110,0,adf0229943773d5d1bbe630fab0981e13df81b22cdbdf3129d13430fc8551999,65685686663
20180402,"PAYMENT RECEIVED",1256796034,0,96dcc3058e884a126fac990401c0d171246946ffbbf38becf4bbf28c002d2cfd,64417408553
20180402,"PAYMENT RECEIVED",1251267817,0,28d42018720365c13fad193da87fa0907d4683775de60cc4f73a3fdfbf1d8126,63160612519
20180402,"PAYMENT RECEIVED",1269763106,0,0ac5639530a15994e5841c7a364b3029ed7e433e1f71694f46a25039dce02c9a,61909344702
20180402,"PAYMENT RECEIVED",1285397450,0,e82a76fe6bbc40b1a411b0e05a61a481322673d9c01b01089dbb0a6ff1c9b47c,60639581596
20180402,"PAYMENT RECEIVED",1253367438,0,d2dcba35569925696b89a7d6b26941b2acb96c7d25ad634c471caffdebc2e179,59354184146
20180402,"PAYMENT RECEIVED",1275804183,0,763e8ad8cd49328f4cc35b986d2cef3617730a1dd02906ac8693db97cb1f0aaf,58100816708
20180402,"PAYMENT RECEIVED",1261039032,0,2cc7346f76324abcdf06c338f417078f5d79f77cb710322697bafd5b8b06e35c,56825012525
20180402,"PAYMENT RECEIVED",1266547647,0,7649cf5e2ae0a4fd018629ec56eed27dd29d6667181dc465d95466a0ca97c27d,55563973493
20180402,"PAYMENT RECEIVED",1259781241,0,29e3a6a8378d4a4ee0fa7b2436df37cbb7bd6450a49eb81e8659d3c1ffa1c241,54297425846
20180401,"PAYMENT RECEIVED",1263985065,0,68763a3e251e0d65cbce5036ec0356d97758ce8a8d9d34d976be4f1e21629ccf,53037644605
20180401,"PAYMENT RECEIVED",1262570691,0,c32d3b3dffe18ac0fe2a003400f15ae49d0818458ff7c9f0ee16cb75e0c02efe,51773659540
20180401,"PAYMENT RECEIVED",1260407003,0,b270a821dd9cce72eed481c72c15603b96ecda6f706262ec9ba7fad72dac2507,50511088849
20180401,"PAYMENT RECEIVED",1261576185,0,e5512a1fbb8d52c8899480ef9c6ca54980a10c43f9ab3374b4bcefd6c731f294,49250681846
20180401,"PAYMENT RECEIVED",1253801199,0,31502c3204da49acc68af41cf016854426015ea019062f725dfb84d0c6babb33,47989105661
20180401,"PAYMENT RECEIVED",1258810493,0,25875e6f213b1e90213a9ffba7e2bc0b54859271fa3c39a3c6278a8a906a5dad,46735304462
20180401,"PAYMENT RECEIVED",1250656224,0,80d0660a5fb3832ed3545dcc2b032b743713ca6b95a56811df91ac65d35e108b,45476493969
20180401,"PAYMENT RECEIVED",1256978009,0,ba06703f53d78c56c28f9d1874b6dcccb1f2738cb4f275c8dd324133e7944d05,44225837745
20180401,"PAYMENT RECEIVED",1259854492,0,929e06e0496d3105385babe884032360447869040f1f1974e9d8f7dfcc8bcf58,42968859736
20180401,"PAYMENT RECEIVED",1261418698,0,d23e15d7625ab1a5606dbb3b10874d3a5e8e5024f2273efa0a9b58844b2fa21e,41709005244
20180401,"PAYMENT RECEIVED",1268997791,0,1f11c8b6bdb771a68bcfffc9e6961f8b4e2f4f95e6d1699bbe3eca0a64523218,40447586546
20180401,"PAYMENT RECEIVED",1264830826,0,45528e5bf7b9ad5ea746bf6c0e5518ea4b57d4dcbdfbe0969a03580e0d094b6c,39178588755
20180401,"PAYMENT RECEIVED",1257371604,0,be624ec657241a7964c4c9e60cb70c5a0d733f960183cf7c34281c8ab3b7a37e,37913757929
20180401,"PAYMENT RECEIVED",1328161557,0,0c18440ac6471a66a3a7e767e385b33628dd61e2d4fbca8cf39497e3927c60df,36656386325
20180401,"PAYMENT RECEIVED",1250328053,0,010db8d1ab1b7ba26bc0351b2ecb9dbcb29997903457745bc0afa4dca2e7a9c7,35328224768
20180401,"PAYMENT RECEIVED",1255414976,0,bfcf39fafed9d16e7d5c0585e30f0fc5c076ee02819d9c82e665473c47f8a3bf,34077896715
20180401,"PAYMENT RECEIVED",1258059083,0,e0d35f9291b1cc47a14590c6dddc79646fd89486d08f90757c3ee27c0643fae0,32822481739
20180401,"PAYMENT RECEIVED",1255676181,0,1eb9dd5193ea8e23d11e8de48d6520fa16b9053fd53d05ab49ce3a4df099c5d6,31564422656
20180401,"PAYMENT RECEIVED",1253194339,0,012476274c7a8556f841319ae160d74223adae9425e4ce26209123373ec9b648,30308746475
20180401,"PAYMENT RECEIVED",1252132377,0,cb95a9abaea867ec38917fe7a2b9d7c61c289b4b19f6135611b6d228db85e584,29055552136
20180401,"PAYMENT RECEIVED",1255904584,0,3b436f5119658e631709002942d6c319f63cc53b416099e839e44a1b1962fb28,27803419759
20180401,"PAYMENT RECEIVED",1252405773,0,db58c4eab8153add75821f2f58a7bb67dba774f6aa5417b0bcf221e991d3ba4a,26547515175
20180401,"PAYMENT RECEIVED",1257941738,0,716c41bf2c4a51e387c79cc03e0fb0c4369e00d1fc45187c470712a621c5968a,25295109402
20180401,"PAYMENT RECEIVED",1257385880,0,8923cf98999efec2ef4d80b671fe881d241c94235c718ff6c4d0c559135699b7,24037167664
20180401,"PAYMENT SENT",0,-75867617752,8f0dd1b2f7bd109627dc360f8507e275a468235e62a6426923790bf963bd8292,22779781784
20180331,"PAYMENT RECEIVED",1257881013,0,f1dff3b671b9dabe5557101e5625b46f08bde178bdea6a462d6fa4e30c11dc58,98647399536
20180331,"PAYMENT RECEIVED",1260267310,0,a49b4feec250e50914e8631b740b811b9f30e021f2ef8e521655b96e1ee24d36,97389518523
20180331,"PAYMENT RECEIVED",1253846465,0,7d7c5caae54ec5e0afd2946d93f1ca0dba0500ae189722870d6c74408ac1a2d4,96129251213
20180331,"PAYMENT RECEIVED",1257779732,0,05efaf8ebf585a2410628f27207b5fe617ef1a03ae63d148433a19ecb854cc39,94875404748
20180331,"PAYMENT RECEIVED",1250508360,0,a8606de1762edf1ce6fc267e70de0b5b584f103e4a5ced1122f241e707211f83,93617625016
20180331,"PAYMENT RECEIVED",1276617829,0,f7007376609e99bd13f623987411cf0b20aab364cae7169d90564516b27d46e5,92367116656
20180331,"PAYMENT RECEIVED",1290781726,0,2a67af5c39904633dacedc81e20f13e301089d7c0bc0b35398717ad1781c5b03,91090498827
20180331,"PAYMENT RECEIVED",1288279792,0,1ecf665f299b172e834776fc8e36bff269a9dc2582903e193ed89f8953fa41ab,89799717101
20180331,"PAYMENT RECEIVED",1271906085,0,83e0fa047f0fdcdbc10e30c74f444ac7a923eb2bc9a92fb60a33e69127d17b70,88511437309
20180331,"PAYMENT RECEIVED",1266687645,0,73745ecfa94774511192a16a7f0396a6bb85f1e2c270e38e5323d8def52f91d8,87239531224
20180331,"PAYMENT RECEIVED",1269406852,0,50dbe58e29dd61e1fd59a1839b52d1ffa9c1d07a526f19fccd2e0b92cf052566,85972843579
20180331,"PAYMENT RECEIVED",1262996666,0,412ef50399758930c48ec27fddeb94bc09202917ce9b04c3dc8c958896146feb,84703436727
20180331,"PAYMENT RECEIVED",1251406886,0,4693d307016e81c65b90200cfad7a63b49bc1276b521777ad3c824568c8de8f8,83440440061
20180331,"PAYMENT RECEIVED",1263946997,0,c2eb1eed99060f746cb58b7305dcd89a357f1f6cbd99746e3398f3046f555224,82189033175
20180331,"PAYMENT RECEIVED",1253114390,0,a29563b64afe8091eb79fc8f28a0eb441be050bfb88842a3b5b115256170518c,80925086178
20180331,"PAYMENT RECEIVED",1283541068,0,ae166f3f3e2a0c86392c8b9bdd5926b3f8db0b8c97f01a3e94167bee892111ea,79671971788
20180331,"PAYMENT RECEIVED",1251066233,0,5cc4e5d44da965385ed9aa9290ea4f6c2ceb87f261fb21c776891bee50866b57,78388430720
20180331,"PAYMENT RECEIVED",1269746735,0,60f237add53d46a3055a63ab052a5248f3ab294c9461faf49a0b585462dc2367,77137364487
20180331,"PAYMENT RECEIVED",1260473667,0,e328db78d15cde4d09df099efc73714e88da7883a055c8d99546ed84072d494b,75867617752
20180331,"PAYMENT RECEIVED",1259526054,0,4f0128a30c220f389d5863d5eac17cb4e477fa0664a61a8d6c32655fbfcd7308,74607144085
20180331,"PAYMENT RECEIVED",1254164036,0,50e045e0ef722b8056e0525eb72ab4d5fb0cca9996111e1b5bbab8a40f7b63ca,73347618031
20180331,"PAYMENT RECEIVED",1272228798,0,d0a7adcaf5c183a3c8e8b7b539d4a429eec88327eb1271867267dda1bef1024b,72093453995
20180330,"PAYMENT RECEIVED",1252026064,0,e26dcbdaeb636e761196e5f2775599d3d3963179d41bf35e1b79a652b80934e0,70821225197
20180330,"PAYMENT RECEIVED",1256197496,0,9e1de2fc96fc34c04a2e3fa59b662a1ab6442874e346e2fbd6861dcef2142fca,69569199133
20180330,"PAYMENT RECEIVED",1299688070,0,6abc07fcc240d85d96d461ebb54cfb288d817af5149814adbbc8892ff1bd6f4b,68313001637
20180330,"PAYMENT RECEIVED",1265992210,0,0c738787062b663a05590a25fe3737f906cd0eeb1eddb94ff96545bb65f100f0,67013313567
20180330,"PAYMENT RECEIVED",1262504460,0,fd4f5459263a5250f56664a034b8b05dc99044a47844ba529082d07b370742b7,65747321357
20180330,"PAYMENT RECEIVED",1290699180,0,8df0ce5b4233fdee5db0fdf5af8b32371c2c5a5196598f352d1b72c662088ded,64484816897
20180330,"PAYMENT RECEIVED",1298408510,0,cd143aef85b15aa7c78b99f8dfd2c87c1474b03804f9b5be483512ab8082cda8,63194117717
20180330,"PAYMENT RECEIVED",1282298885,0,c6a292f36edd64955eb4091d00af88a5830e10c7722aebeedf8aab4e4597bfba,61895709207
20180330,"PAYMENT RECEIVED",1264166318,0,ae97499290ffbaf3aa162d774748fd2776ba857dcedce648da6a6c6fc57d7bd7,60613410322
20180330,"PAYMENT RECEIVED",1264587968,0,9912e406244069cf4c9ae6ff93e6716dd16313259224303c39964785c8b10f3f,59349244004
20180330,"PAYMENT RECEIVED",1259971915,0,3a8886116c66bc65d1994bcb64f094f261d296a100d0d6602555c5fb48635fc9,58084656036
20180330,"PAYMENT RECEIVED",1282415448,0,5db04c9422d46ef560469476c047ed3481760866b3b0064cadacd511fe37fe24,56824684121
20180330,"PAYMENT RECEIVED",1264169114,0,64de92d5d862b7bdad04792fd13979d8769017777a316c12fc44a0291daf1f7c,55542268673
20180330,"PAYMENT RECEIVED",1250579470,0,079bacf45df5732a6bbe0e7f9b4a0fe9891737cbe7319901a650861ade38fd45,54278099559
20180330,"PAYMENT RECEIVED",1255443330,0,696206cf2bfe9658f9f0c21f62d38f30e0df2e1ab05d1a4a7e88abc9661fb6b8,53027520089
20180330,"PAYMENT RECEIVED",1266503171,0,f1fd58334312cf5f4dc51837f072bdfd75636ee297d8f9fcb8cf63eee6af578d,51772076759
20180330,"PAYMENT RECEIVED",1265919658,0,e8fc57b5f91ff84f39ecead6d8aa54247bb008e5ff7ed48c099d7772f60e03a0,50505573588
20180330,"PAYMENT RECEIVED",1254139518,0,ccf5adf463edbe81f62c1d34d79389af187507e7761080d354f60eaafd1aa111,49239653930
20180330,"PAYMENT RECEIVED",1272271992,0,772afd0c3fad8e079b9a5bfaed5f53a1d4bdcf94cbcfcc7684af3dcea3b0bad2,47985514412
20180329,"PAYMENT SENT",0,-98860378295,609a1109c67c1a5abe39caa35fc258c9401011b85717ab68bb373d46d381b166,46713242420
20180329,"PAYMENT RECEIVED",1277168429,0,70469fc731d8d32913941b3c247284d6657542bce86b38d4ba0ca5546b66b088,145573620715
20180329,"PAYMENT RECEIVED",1250187915,0,c6f86fa68f3f847475d42ca197ee5fdce266245d8a0e9ef918e7c86481b304f8,144296452286
20180329,"PAYMENT RECEIVED",1267658560,0,361988093a8b3e0321d329680679bddf57f0f5b4ac5280270e35e9d343c1274a,143046264371
20180329,"PAYMENT RECEIVED",1251166851,0,cc2eaec4e94e54c3e8c576200cf28a7102b690cf12380a86f0073cd934aee4b2,141778605811
20180329,"PAYMENT RECEIVED",1284975745,0,d2fec45a10eafb3ddc94427556e5a93e1521429c64b794d4ec6cf9241e2a7586,140527438960
20180329,"PAYMENT RECEIVED",1256456935,0,e3a21f05d58f22ba98def8512a45d9a98a9652625fb9a1cf555d413868861f00,139242463215
20180329,"PAYMENT RECEIVED",1280165866,0,68438bc86c6272125741aa029190b008dfc4b0bf51cd38cc0651549c77d89445,137986006280
20180329,"PAYMENT RECEIVED",1250344215,0,fc3b3637fc133d5bd1ae84c93bb8e643a68894da956ab0497fb6f95620ab208f,136705840414
20180329,"PAYMENT RECEIVED",1255284888,0,b53bdc79e459755bbc5b77c438da73b6afd4ad8bb0cd972ec872bf206131d568,135455496199
20180329,"PAYMENT RECEIVED",1275737661,0,a4a3a14893fc1022a31b729ec537328ce5d344327734a2ee755608306dd9fdad,134200211311
20180329,"PAYMENT RECEIVED",1292754204,0,418a5041c01b561735ab25fce7cd4b4090ee85d0c62021873cb264bbb34bbf53,132924473650
20180329,"PAYMENT RECEIVED",1255470488,0,c684a46ff3a4964bca4085912eb224a043e61717de31b5ef6afc5458febfe8a3,131631719446
20180329,"PAYMENT RECEIVED",1269477098,0,3d65628a81d0280b0dae3ce711274c5f6a1d12b40a3829228e71dcb29659eab4,130376248958
20180329,"PAYMENT RECEIVED",1253362096,0,bf0e41e77cffab5c1f98e917f38473aef5bc34513e462439748fe3c330dd7f69,129106771860
20180329,"PAYMENT RECEIVED",1250164213,0,01d3968ced263dbfa40f6b35b17b063ab6117669c4d2ffecdc0037c9a60ff963,127853409764
20180329,"PAYMENT RECEIVED",1298709990,0,afcc24ab2e40b1ff4d871cdb5090c28a9747c63c84f1b0dcdad862daebe24039,126603245551
20180329,"PAYMENT RECEIVED",1269554893,0,2414ee1265c5060453716514351aad29cf3ff2f6b9eb66a98942cff851c3b749,125304535561
20180329,"PAYMENT RECEIVED",1264949526,0,8cb0261a5921060ee800cd278b5cc180e7542f2bfda79f74b9e79b2e81771f22,124034980668
20180329,"PAYMENT RECEIVED",1250953552,0,790ff634ad6608e9fce2ec4f84ac65a4bc42f640e72666cc0712d94b913e5ef0,122770031142
20180329,"PAYMENT RECEIVED",1273883255,0,b03f0391a74264093ae21278943facb926ce68473b6da18a7fb524aec73dc7be,121519077590
20180329,"PAYMENT RECEIVED",1254475357,0,c935896b9dfe98d77be250042f408851438e7319f5829513a59c8e600f23475e,120245194335
20180329,"PAYMENT RECEIVED",1250282786,0,af7a52432bc3f470b1ead240571075fc3ed2a0a8b377c1780f833dca0dbc8eff,118990718978
20180328,"PAYMENT RECEIVED",1285579468,0,0a910fa3958056e082799eaec4e2019f112a4ba73696051de1f6b059ea80d60a,117740436192
20180328,"PAYMENT RECEIVED",1288264938,0,24c489c57b581f1536ebb54da862cf2acb64993809787b9e7d6efe2a1b8e9dd4,116454856724
20180328,"PAYMENT RECEIVED",1267717306,0,c8a6cb775fb9cb1d41ab55eca9381bb143bbedc9450258b344291d5ba93dcf93,115166591786
20180328,"PAYMENT RECEIVED",1252399532,0,998b6c2e052ceefd24d047d9f9c70e174ab05036b8b292893720f14e4ea9320b,113898874480
20180328,"PAYMENT RECEIVED",1250000000,0,009a48ac739790416c2cf61792575bf3318669df6d664920c1185a3e4f21e28f,112646474948
20180328,"PAYMENT RECEIVED",1263862813,0,8017717c3d2b43a72a816809d6bb7d9b1d40e1ca2397e85982d5894f9dc2dee2,111396474948
20180328,"PAYMENT RECEIVED",1262394967,0,20c5889e23e8dd7f1ad28a70abb489aac612424aa4197babd1d39c517f09e508,110132612135
20180328,"PAYMENT RECEIVED",1254666127,0,d2d98e4c93b5739495d119e60a34f5e74070e3642bbf324b1bf991e0b5b555fa,108870217168
20180328,"PAYMENT RECEIVED",1251022101,0,d842307cec245baffb84c86dc66662ddea95d42a45ecd72449cf82f6a439b502,107615551041
20180328,"PAYMENT RECEIVED",1272937629,0,ea6bef3bbbe221ea0e85b4202c83382c3dfb4a67dbd0a96904b223d227a1bbd7,106364528940
20180328,"PAYMENT RECEIVED",1267917068,0,15309bf42b237850e661baf5400f166884c5e13659ebbdec8acc873f533d7a29,105091591311
20180328,"PAYMENT RECEIVED",1282061719,0,707d6ad9331c7c963e42b2efa97940907d06913f95b3aac4138f793a1732e354,103823674243
20180328,"PAYMENT RECEIVED",1258355806,0,3aab4a61cbd343b17b248cf1401cc2b9bde95bf567efdff4ad44e910fa007961,102541612524
20180328,"PAYMENT RECEIVED",1261982581,0,fda110e48abd29d4c820f217e574f4aaa38aa1024c2bd5b07d50ee48a33e39be,101283256718
20180328,"PAYMENT RECEIVED",1251908983,0,8f354aa0da76c8a3bc4313456663775d6a885f023bba2fcf3df6b2c7f339cc27,100021274137
20180328,"PAYMENT RECEIVED",1263704562,0,51afb50634aad953311fcd3c296ac473e6084cadfc617b8bf7052cae1ef7bc4f,98769365154
20180328,"PAYMENT RECEIVED",1251443444,0,50d6e4f35da33625c4d55d5b24010746907b73f2006da79f94ce6e6f1a131975,97505660592
20180328,"PAYMENT RECEIVED",1273353000,0,1606840a19bd8d050cccbb7f47a6fc8550c7b3086af6aca3e4b29efa158de6cb,96254217148
20180328,"PAYMENT RECEIVED",1267603639,0,4b4d4c527be1197f6efa4bc5ff7ccbb65a13190ef348ccb2c8947741df2dc434,94980864148
20180328,"PAYMENT RECEIVED",1269189460,0,b608924858a6e069995b01d7a063dd9ab0ceaffc7210608659e739e3aeab27ec,93713260509
20180327,"PAYMENT RECEIVED",1272464325,0,b83794c91a1fef830d99de85858cf6dab6027c7a74a0c19ea93f39043268636b,92444071049
20180327,"PAYMENT RECEIVED",1261049832,0,f8de1eb86a9df5c784074d1fc7210a2765679e2638c509242cdb9c102d822f5c,91171606724
20180327,"PAYMENT RECEIVED",1272317931,0,64df589fea647c93ad825648bf293904a3f25e5114a76c0bea74257ec88a06a6,89910556892
20180327,"PAYMENT RECEIVED",1252873278,0,f928e2526ec17b6fecc32c690093be82b481f1fb3329a39215c2b371cc9c1f0d,88638238961
20180327,"PAYMENT RECEIVED",1250230613,0,f51e11f2595246a54d939721c1642ae5d052c6ab1801d48d5097c84b31e92416,87385365683
20180327,"PAYMENT RECEIVED",1259642127,0,bce77bd2a14153e558e144b7beb4ec26877c7915569cdee0ed6ca81da8d79d9c,86135135070
20180327,"PAYMENT RECEIVED",1251441286,0,ef46186ad7be1388f7de3198e421df2e1fa8ee7431ec2d1477edd5090a1d4dee,84875492943
20180327,"PAYMENT RECEIVED",1258380132,0,6fd344853e5f1ab68d79180ce3a8474ab9b0c616f25707be589b5c7111fc1d9d,83624051657
20180327,"PAYMENT RECEIVED",1250947067,0,11cd2450ac02601c65c879c9ababe4a34460a0240a5959eb101047956d26e5ab,82365671525
20180327,"PAYMENT RECEIVED",1277115146,0,9df227198257cb4180b36ef1b1e97e8438a721320218040ce5324376b814f642,81114724458
20180327,"PAYMENT RECEIVED",1272368322,0,cb15229604fb28bc7e6b271834ed9cff522c87c4e4a74b20f09d94c250f4451e,79837609312
20180327,"PAYMENT RECEIVED",1285604743,0,f323a88a7ddc12a9013d276872437b4bab607b067df1ae6a300ec7aa54898924,78565240990
20180327,"PAYMENT RECEIVED",1287423787,0,4ddffc0fd989a3117858f17311970faae3e302e771b489389e2eb2bea8ffc752,77279636247
20180327,"PAYMENT RECEIVED",1283942238,0,e4a87f911a9543a11aa3b34cf4f604cbf8b9aa91386063d08d24ab138995f560,75992212460
20180327,"PAYMENT RECEIVED",1283195914,0,4c610c0482f0d436f29ac296975cc84d9d7a4612e12a9164f49d9045e5087040,74708270222
20180327,"PAYMENT RECEIVED",1259376226,0,826044cf61a835e5e85a01c86f04608493a16ef8e7ee02ead1852c47a5de9822,73425074308
20180327,"PAYMENT RECEIVED",1305684746,0,4a2e26cb03b0efb1ab8a1480e14c6460a5d20d8a75a434cb4d3dc9f917b98c60,72165698082
20180327,"PAYMENT RECEIVED",1251435032,0,b4aff9f9b0f8135f2551d74dab56b1676a87d6ed862f85f88e9966867d4a9c86,70860013336
20180327,"PAYMENT RECEIVED",1251525888,0,0db13e0f6491072b58fb207262306904ec9eeefb3e1004cc445f6f75d92ef1c4,69608578304
20180327,"PAYMENT RECEIVED",1257051389,0,4227b7718ef9e9f025e7ec820735cdc295d5dc5564043952fa4554b41c6e9b71,68357052416
20180327,"PAYMENT RECEIVED",1251442214,0,8b9a0999acd392e7715848610653125bd64a227bbf3ab659efb784eaca0ea1e3,67100001027
20180327,"PAYMENT RECEIVED",1298941910,0,00f5d16a6e237663aefd285e77bda2d3e5e3acbb629f00ef5c32514401aa094c,65848558813
20180327,"PAYMENT RECEIVED",1251971806,0,98152d7d5ffca7a1e1704ee691cd85c80b1a2c59df9a92548d8c4c8884fbd43d,64549616903
20180327,"PAYMENT RECEIVED",1265062832,0,9222b54c2ee3180525d8e8444325c388b96ddc2ab81327cba6434296aacc25d6,63297645097
20180327,"PAYMENT RECEIVED",1255662317,0,14511277f71a915136605f28ca535992f3c51b9a4ad56032f6feac49cf810f1b,62032582265
20180327,"PAYMENT RECEIVED",1272263130,0,7aebe8fd0035a8075ae44bbd8e8a8d50112ad986409d1005a026a71249580ac4,60776919948
20180327,"PAYMENT RECEIVED",1251337849,0,59270446c0eaff19ab832805f210459ad40599b57a8b2ac10144c64b5894bc2e,59504656818
20180326,"PAYMENT RECEIVED",1268805173,0,9143d896934c4e5011765179922d0d0a563b48697a374ae4940c02b7df8c0980,58253318969
20180326,"PAYMENT RECEIVED",1254701896,0,f2e984a3c0a087a8a3034f909a3711773ab8f30636b30b035eca606fe9b44a8c,56984513796
20180326,"PAYMENT RECEIVED",1295712423,0,5b16a9834b80de6a375a03bcdc747f680042ab61a30e0e516e1d43553117b3c2,55729811900
20180326,"PAYMENT RECEIVED",1260707863,0,bf89e82c628d1bf20ea623317a6eb98b2a6891a9ae022a69aae690cb2f812d6a,54434099477
20180326,"PAYMENT RECEIVED",1267020466,0,0ce1a99ca12e1d963cb53ddce5c7d46fbdebb4f4c13d64e967a8673b8c8fa5d2,53173391614
20180326,"PAYMENT RECEIVED",1262565255,0,989437ef2f51abf52fc0001c1d5c8264c799e6e4bac25a53fc55f622dfb82074,51906371148
20180326,"PAYMENT RECEIVED",1262475121,0,337da7cabd1204571100545de230ab7ddb84c1050c882b44b5d0443e097d2106,50643805893
20180326,"PAYMENT RECEIVED",1286455898,0,a0ef81c90a521b218203d43c982d197d14eeef8c7a65fbb8d3c14c7a083aff44,49381330772
20180326,"PAYMENT RECEIVED",1252360623,0,ef27102e81e3e6c1c2be74d5edfff56109a24b125f66835ca8ee2e14f7bf7509,48094874874
20180326,"PAYMENT RECEIVED",1254280073,0,77d0d261455d3a830f031e5d2457b2909f94ac443253007ab5192e3448879424,46842514251
20180326,"PAYMENT RECEIVED",1297711318,0,a66e287095bf32ea4ae9283ff39439d1c8e20c39eaf06e6d8ef3c70e1eae202e,45588234178
20180326,"PAYMENT RECEIVED",1314429306,0,6b9785228e2f1dd006bfb384fc107a35cae1c6c62116d9f4661424ace29a6267,44290522860
20180326,"PAYMENT RECEIVED",1324616771,0,d747e2cc8e4b43e0e8263ef8e2806f82e444f8e882b08d16927a1d4f5d2ac885,42976093554
20180326,"PAYMENT RECEIVED",1250000000,0,5c1e1a5a37ee9fa7f4b2fcd9c9b432db446b9aacbc827809f464a7f4ddf7cbfa,41651476783
20180326,"PAYMENT RECEIVED",1264928241,0,defb7eead102b52cfeb1f287292c94824057ffd3d5761cb8063c0a7474585793,40401476783
20180326,"PAYMENT RECEIVED",1263648935,0,d6ba019ff2f53a4b4aee905b64e061c3d2b3474a0349b17e70abd0983a39418f,39136548542
20180326,"PAYMENT RECEIVED",1265921552,0,5b2dd173750a22c8ff02c661acd78d16702d6f97b175686c4c008c5e8f3ffb11,37872899607
20180326,"PAYMENT RECEIVED",1250000000,0,84797b1654bfcb053469b42dddcea22d233c7d7a0a72e524d8bad5d08deef5e6,36606978055
20180325,"PAYMENT RECEIVED",1251470469,0,285c33a2e788371c151c8b070dce53e85ac188dfbd6dab369bfa9c3e016537c5,35356978055
20180325,"PAYMENT RECEIVED",1268001299,0,073498979af1122e0111a8ed90d7dab1a908b610bc7fb3233374df0ad8a83468,34105507586
20180325,"PAYMENT RECEIVED",1259348323,0,749b7f550b70bb56b665e3f023a72b88c36837593aad2471470edf615d3c3e22,32837506287
20180325,"PAYMENT RECEIVED",1260741993,0,6ec332fe8e06bbd8388edc16e0dccda5f516048350dc1a248685e6b0daf8d479,31578157964
20180325,"PAYMENT RECEIVED",1251211695,0,cb3b2745d015989cd6d9676f76fff31d078fe7a1da879375874dd7bd1d673b7a,30317415971
20180325,"PAYMENT RECEIVED",1257819995,0,a4b75dabb37b7f64df8c95313726ea3ccf9746fa8c8856b126466adf8a75cd90,29066204276
20180325,"PAYMENT RECEIVED",1253976664,0,eac439bb160fa0eb4a8854e8fec33175c93eb677a21a41aa4e860937d754eaad,27808384281
20180325,"PAYMENT RECEIVED",1258964944,0,63f8af4c8f1824cf7f68ea877b5c9393b1f2b62eda5de64757d675400f1dfb56,26554407617
20180325,"PAYMENT RECEIVED",1258850549,0,cbbb7e7bae70a9ea9b8fdce97631feff2807a716bfde8e2f306086f97c42d8cb,25295442673
20180325,"PAYMENT RECEIVED",1273593091,0,ddde89122bc8c40f1e8d3066b934ce9ffde352f286a388dd0f5f647da7a2dcb8,24036592124
20180325,"PAYMENT RECEIVED",1261187730,0,6136830be6a7d93b9bb6bdbb01f2d532eda5956394faf513ee092b9a1e3c7a4b,22762999033
20180325,"PAYMENT RECEIVED",1276867357,0,0ca148b95b3b4747e273c22b8e9d54a78d16b7e2b3c33dd20fd82b3d4c011daa,21501811303
20180325,"PAYMENT SENT",0,-44417498582,09e37f27f99aad7c5e151e13f390f16a68fb654ffad758f3bc8b1bc5912e0c58,20224943946
20180325,"PAYMENT RECEIVED",1275902998,0,3d5c362a97f31af96c656da88e5b9462b6999c46bdf6359ad46c295f01be33b7,64642442528
20180324,"PAYMENT RECEIVED",1250093824,0,7f4925b81619d66fed42e6af15db10a8190bd2e446fb27c4f0df3d4abde8cc3e,63366539530
20180324,"PAYMENT RECEIVED",1262722002,0,bc02c677ac3dd63adc55939cbdc04d34da8eb6e9f36f275ecaa2713effa0c6a0,62116445706
20180324,"PAYMENT RECEIVED",1258917818,0,4dbdf18351ce839705da155f0a685c78891a9dbb46ac618d26aa88b958f76110,60853723704
20180324,"PAYMENT RECEIVED",1261906517,0,989d0f4e258c268fc9fbbced8c2591369e5cb6144fb7a09d7547eb5e9cb464d0,59594805886
20180324,"PAYMENT RECEIVED",1268200701,0,804d70238358c3daaecbf9e76f3ec1fdebedc536e3a79b2f541e05c6a058ddff,58332899369
20180324,"PAYMENT RECEIVED",1251015745,0,6372da7827f7ea8f7e7830daaf3a51b0e88f9d173e668a46f8ccb4e8dec34617,57064698668
20180324,"PAYMENT RECEIVED",1250049221,0,f4bf807cb9611ce6695ee26ae5b34c0b51630bbce270d8cc55d28337483c9489,55813682923
20180324,"PAYMENT RECEIVED",1277291025,0,3df7707057b471e9f3922f3013e5234d9ceea7317dfc0cb643e082a4116d820b,54563633702
20180324,"PAYMENT RECEIVED",563,0,99c535c495f103f71a477efcecad04c30e4cddeac6e39933b0adec041265ea42,53286342677
20180324,"PAYMENT RECEIVED",1272253709,0,85c6beeaa6bcfafbad9a21f8d42a6d6c5e9b7480b61975b66340dad1baf00c47,53286342114
20180324,"PAYMENT RECEIVED",1253490402,0,0fed205fbf2dcdc1ecc284975b72664b73dba36b4d490d269223be0924bdb9df,52014088405
20180324,"PAYMENT RECEIVED",1265546585,0,af3751bd516b0d741140c126d1c1bf987e1b6a73c6e3c4155a547092c2e07538,50760598003
20180324,"PAYMENT RECEIVED",1300753151,0,5f40a20949960194c631fe92f3d7de456d2d9556fa67a465dcecf158dfbf936a,49495051418
20180324,"PAYMENT RECEIVED",1252881072,0,82f37acd57469d9fca73406c870fd8ee795abacfbcddfdd92f10cc04697e5a8a,48194298267
20180324,"PAYMENT RECEIVED",1272219461,0,02df398de593eea19b6a20c07fa66968723181819faab28170bf9cd2986b794d,46941417195
20180324,"PAYMENT RECEIVED",1251699152,0,2dc1faf692b640135302227d7c5b0abb6dab44585ddc666fd5b42a66835b734f,45669197734
20180324,"PAYMENT RECEIVED",1258601729,0,42b6dcb4218216890f6afaf8518534baeb72b76fd2fb401c60c21027cc5025a3,44417498582
20180324,"PAYMENT RECEIVED",1285312915,0,5153ef07a8f866f06dbb184873721166b817526b4e4ea3513c0315ab75418df8,43158896853
20180324,"PAYMENT RECEIVED",1281956785,0,556d3a3b2755892608f6f233c1a38a8e5e8774b2b5cff6a53793c4c07a962746,41873583938
20180324,"PAYMENT RECEIVED",1276440543,0,3bcc06b9b08b37c7f56f4e0f0d65dba80b95f93d87f58d08d11244040b56b98b,40591627153
20180324,"PAYMENT RECEIVED",1291052023,0,c7fbc8a36b18595d1fd4d079a6a76404dee7960813d019ba902f708ffba792a7,39315186610
20180324,"PAYMENT RECEIVED",1258632240,0,6ab3f2118254abc12663359ccb66a04a80fac182d01e59344d5fa4cd9b0b8f6a,38024134587
20180324,"PAYMENT RECEIVED",1254668366,0,cb507cf37ae87cfec7e86318d89cff0a1826f5e4e1e10025e1463625d7e02c25,36765502347
20180324,"PAYMENT RECEIVED",1283406743,0,3d6b3eaa3f17bf8fd84a395949dc00262713290bd82050ff9a5fce643374fdda,35510833981
20180323,"PAYMENT RECEIVED",1256814091,0,259d2b21b659e9c70e44175aa78f04c9e0a66a9711dfbbe160ccf049d8b68e71,34227427238
20180323,"PAYMENT RECEIVED",1260354794,0,49966569bfa906d5ddec4056e017fdac76d278d069403f24136375781f88a6f4,32970613147
20180323,"PAYMENT RECEIVED",1257431545,0,93c02c35073c67c78535e5652c45dd5610cd7adb71522e76e3d95e1b76cc91bf,31710258353
20180323,"PAYMENT RECEIVED",1256057210,0,f6ef40013cc99e9025cf7bc31395875a242084de04a8b9b0dffa10b562863558,30452826808
20180323,"PAYMENT RECEIVED",1276374404,0,472903cf646f0c7a1bc387c7462d2fa29b62be08bfe60fd84ad2810e98232c1a,29196769598
20180323,"PAYMENT RECEIVED",1267462809,0,ee16629e871c05956be2636c80941a8a0d8532dced15676638d37911306b2655,27920395194
20180323,"PAYMENT RECEIVED",1254013179,0,d582ab33e22d79d54de9025e035187e9fbcead0366c58d2f9a812d60c36a957b,26652932385
20180323,"PAYMENT RECEIVED",1279105771,0,d403f7cd545f541063342229a714c17a4e8c55ee8c985ee6ea0f41d9cbd209b4,25398919206
20180323,"PAYMENT RECEIVED",1278595044,0,bbcbc2f410b9f7d69c25a26cfb94ac0681e067ada58f76af561a31c515e32be5,24119813435
20180323,"PAYMENT RECEIVED",1279807771,0,ce00a70ee561a607ee1e7daa5024c79a3d035c282a3d959b7c1d1cf6bdae7ece,22841218391
20180323,"PAYMENT RECEIVED",1287550306,0,88feebc28f45e8beb49375d72b56fa3b52fd674f60917c04f5cd7b89775371b1,21561410620
20180323,"PAYMENT RECEIVED",1275345417,0,9fc67dc8a709b6110478062318a2fbebcdb8340f71740942fe89e71ad18dd929,20273860314
20180323,"PAYMENT SENT",0,-84888543415,978d264d50d65d5e0984263a193218ab3d0058192f4d9c3bbaedac909cb991af,18998514897
20180323,"PAYMENT RECEIVED",1288353346,0,36c2cd3ee8e36b2706121236837bacca1d0caeb8ef9251dcdc02a5726f168660,103887058312
20180323,"PAYMENT RECEIVED",1282968320,0,d49676e255763ca790087d0bd7ad68f6a537043b3bfe62fc079a1bf5c786e817,102598704966
20180323,"PAYMENT RECEIVED",1251904119,0,d231193b29af12fcfc78cb996d47d46c97f7ca96af8255650ac83b18b8dbf5cb,101315736646
20180322,"PAYMENT RECEIVED",1250232112,0,4112d770c6132a61a8d0d7ca9b68bd215f668fa440188a47dad034c4e4bfc406,100063832527
20180322,"PAYMENT RECEIVED",1253650392,0,48d0bd29faad899a06b65282e771f7acbbf837c7743b8dc98546fb1a3f8fefdd,98813600415
20180322,"PAYMENT RECEIVED",1276671930,0,5f93a447712eacf11f0c3b0af70714be05bec6661e1b566fe34f12ced3deee1e,97559950023
20180322,"PAYMENT RECEIVED",1264107285,0,c5f8c907418956287bade23bffb402631060e807e3938cf5dbaf404e1c1410e4,96283278093
20180322,"PAYMENT RECEIVED",1263084660,0,9b68bed7342bc0f4c04c8a8271046dcbc3d6d38a3a626094dff4f5680bfdbb51,95019170808
20180322,"PAYMENT RECEIVED",1250861707,0,fc06ae70756970564f66b02f4042c24f5e16871dca6bece440c5a17ba908c34c,93756086148
20180322,"PAYMENT RECEIVED",1277537115,0,f22840595c5d5353d397028a6f5007de49e6f277cfaf448695d18ff39503562a,92505224441
20180322,"PAYMENT RECEIVED",1266313864,0,c5983d9da9756f5b3059078e88ac5e2dff7199113ac750d9b0e6e87ce168187d,91227687326
20180322,"PAYMENT RECEIVED",1298030164,0,dc29034a7a0727ce797fad8181b9d5f1bf0d5fdf12511e063f845a5ec999d1be,89961373462
20180322,"PAYMENT RECEIVED",1263427209,0,f34744c51e38e5e317d480a1d65484db3773d6130ce511c00e9b14d75eafbadf,88663343298
20180322,"PAYMENT RECEIVED",1251856379,0,df3ecaeeaa27d0b01b2c3f9bd95cbb08dd8b998d2a2791a724fa3de9c948ea7d,87399916089
20180322,"PAYMENT RECEIVED",1259516295,0,e3532d9a66662e035e4c9ba469722ce388b0c4104f05084e6cb582cd8f961c99,86148059710
20180322,"PAYMENT RECEIVED",1280469545,0,3931236fc3141840e87f75d1a4c555e3f7228366f918c20e11efc88f9c4dbd18,84888543415
20180322,"PAYMENT RECEIVED",1262078714,0,2b0aac8027cd5e5091183c97e37c6d2a27415610f2a30a4e4c289d091f0fef86,83608073870
20180322,"PAYMENT RECEIVED",1256893800,0,1da765d14bf753526653540d5fb019e8c4d64228091ec5d1d6f36cf0e9aa73c4,82345995156
20180322,"PAYMENT RECEIVED",1263664827,0,9a86b9e95a718f0b9512cfa6abde6da22df5aaab6d4395ca8a070afa615ccc63,81089101356
20180322,"PAYMENT RECEIVED",1254130154,0,d8c6870d57cf45ea1511d904011fd2f20e9d9a8a01f860312b4d9d25203c1d14,79825436529
20180322,"PAYMENT RECEIVED",1256688372,0,b64d5ab5fd48301de0c9419494b16b8e332c380555887c3ed02bfb7940c17762,78571306375
20180322,"PAYMENT RECEIVED",1252053495,0,847da3cabb0266e08bf87da5621151f404ad0412ca35ecaa009061b98fd0f2e5,77314618003
20180322,"PAYMENT RECEIVED",1280077394,0,35e128f409b670fb31f4c9de1dd817bf4cb42b4dac24241cc5c6af49734978d0,76062564508
20180321,"PAYMENT RECEIVED",1250000000,0,4a913a003751baa081f592519222ba92ad5ad6f8e616819582751c1b14c7aac2,74782487114
20180321,"PAYMENT RECEIVED",1258593326,0,2c02673320e6d28d16263a7aebe964033050292c2889ac082af22635d374491a,73532487114
20180321,"PAYMENT RECEIVED",1250261199,0,5c3fcc598a594cf23bc3e6dd34594382d5b6c37017c707a0af999b25a87dfea1,72273893788
20180321,"PAYMENT RECEIVED",1251370120,0,e7e46f303e3899bf042b67bc78930a200083f57156172b5acf21aa9a356fbb98,71023632589
20180321,"PAYMENT RECEIVED",1263982370,0,0374c5399312593b74521500abb9668a5e90071fb10af0df30441b359b20e546,69772262469
20180321,"PAYMENT RECEIVED",1278164085,0,2dff87176afd48d0cc1cd9c39be66f3d60410ab53bebe0983287472ad3e72246,68508280099
20180321,"PAYMENT RECEIVED",1268326373,0,0de6ce78ce095493b4da3b6f0a04c099a52cd9f61816f56153184621572da23e,67230116014
20180321,"PAYMENT RECEIVED",1284471252,0,0a45653333a69a670765f2429a5b59c8a7aa10bf0b28839c822624cc53f5d7e8,65961789641
20180321,"PAYMENT RECEIVED",1270469748,0,dd8c199fc40a28d7ccd83f16536447adf98848aedaed60354f9ea1011fccaeb8,64677318389
20180321,"PAYMENT RECEIVED",1268804656,0,001d8f0ef0c9bbd3668e745e711df7952874becf45bf90107e37f35a618c5dfe,63406848641
20180321,"PAYMENT RECEIVED",1270260106,0,ea430fc1e64a53070033aa424d836e5e6b57a113eff092e81f3004ac4cc1ffa7,62138043985
20180321,"PAYMENT RECEIVED",1277589996,0,d1747232928db1e66354e433da0260413d175df9c18e502530bc2ad1f4215689,60867783879
20180321,"PAYMENT RECEIVED",1262738289,0,4e4deaa223ceca33b07800cd42b673cbe69df1be7ad1a7f384143ccfd4535cd7,59590193883
20180321,"PAYMENT RECEIVED",1253499992,0,dc833ec6b2c487aea4a9ab03b37e85f30b8643ebf75d009dc89992376693c0ca,58327455594
20180321,"PAYMENT RECEIVED",1287570093,0,6edcca649a6367ab35c91f888b36b23eb6d5bf0e3986e3b0b13225ebf107d765,57073955602
20180321,"PAYMENT RECEIVED",1268266290,0,e55ccaa64fa2f5416eea26dec87808b4e5172538401ba829b7d24cb9fce86309,55786385509
20180321,"PAYMENT RECEIVED",1275227173,0,7f4ad0ec3cfc4ecaa4feab3d6099861ecc7799c790cd994aa5e5118771568956,54518119219
20180321,"PAYMENT RECEIVED",1277058090,0,ca491a6fbbfe9988969aaead7b075f40920257c801dcecc31a9f5641f10ce554,53242892046
20180321,"PAYMENT RECEIVED",1267532908,0,adf1d27dc4b485f3d677cb5cda7825d01ef37d859fa29a9f49c4350550d2e261,51965833956
20180321,"PAYMENT RECEIVED",1270587543,0,4568c8aec404df458f9673a19dce8fd1eccb66ba7a802ff9aad32fbcf546c320,50698301048
20180321,"PAYMENT RECEIVED",1254914786,0,9b127a3464d9a6b8ba4ca62cb7eec56cbd694a24fe8d8cba013ee498725fe57b,49427713505
20180321,"PAYMENT RECEIVED",1291749146,0,15024e786c49c6b7e9bacf6a2e18386b5ebcd21a1b70d623bf1c57717df967fd,48172798719
20180321,"PAYMENT RECEIVED",1276650235,0,cfa3123e805b28e3746b4099744187da8cd0b9b1d5def41fa91e4065e6bc7c87,46881049573
20180321,"PAYMENT RECEIVED",1254569376,0,3f63795bc7a20f296c4b769660505b5071463c4d10e5190911232a77ef24439e,45604399338
20180321,"PAYMENT RECEIVED",1250047003,0,72fa0c8f93ad7f83b0cd2fcc16bc3f3c2a4bc7f3801f54e3e81341cc9759020b,44349829962
20180321,"PAYMENT RECEIVED",1270744281,0,b667817d9f8f1e4e47090d4b7d7cf46ecddbba3c93a957719d30042175bc315f,43099782959
20180321,"PAYMENT RECEIVED",1270668034,0,0ee5bb1599619d6cf2c50343521bfad2860675556fe0c74f591607a1c04334dd,41829038678
20180321,"PAYMENT RECEIVED",1257246758,0,d9492b7efebf7cbed18287a2d4d2de5f6344e3bc52a8854353f2a1f1784f4413,40558370644
20180321,"PAYMENT RECEIVED",1258873445,0,8151f7e5c27f2e6f53e241cc971b3624e2dafe04522b0d3d266029ceb724d7c7,39301123886
20180321,"PAYMENT RECEIVED",1322790185,0,ddf44af73b8e3c11afb26da9fb915fe73fda47b877e3ed7e9717d09261d0d6ab,38042250441
20180321,"PAYMENT RECEIVED",1265620143,0,ea0e90abc20afd993473a21df84655db3c78d96ce3d7247a6c2c7df0a26fb97c,36719460256
20180321,"PAYMENT RECEIVED",1255199623,0,41eb90e7dda7194f1e2e4e6dc7c512ad549931551360129dacf7bfb4f714a271,35453840113
20180320,"PAYMENT RECEIVED",1277718574,0,20bc2c9d67d2a6ad17b1a261bf5b191864f95cf779476229a973265e46a2911c,34198640490
20180320,"PAYMENT RECEIVED",1284738311,0,fdd01c810c775c36c6edfc487131c1c6d8fe92511f9cd90d9504c15ace5fd049,32920921916
20180320,"PAYMENT RECEIVED",1255239909,0,2e9761ab32a8c624115d1d91aab376248ab74cc06df588eec26c5964f983ac44,31636183605
20180320,"PAYMENT RECEIVED",1263708434,0,c6433afbbaadd4ad621c208399167e9b13657b8f5c44b4b8200afcf7068765d0,30380943696
20180320,"PAYMENT RECEIVED",1272151722,0,bbb27ca82685ac5e18147ff54bae0ad9aad37b9f060204b58f27324ac3afbc51,29117235262
20180320,"PAYMENT RECEIVED",1271836189,0,79b398b75c7899b41df9745a32f0e3fbb913856993496d343ab6a56ef184d8da,27845083540
20180320,"PAYMENT RECEIVED",1271477503,0,6096e17b7e87ce74c4affe9390d3c6db1f4b1847950625b839e87ed9b688eb98,26573247351
20180320,"PAYMENT RECEIVED",1271792013,0,f42ccebace3d31dbdcc3102c250cd9cf1ad40012dee8cfa3a334d7111dd92737,25301769848
20180320,"PAYMENT RECEIVED",1254514288,0,c60ea27b386a7e6d5573070667ba1b44e0a6c26cb5ea380dfd78bd299e7dbb2e,24029977835
20180320,"PAYMENT RECEIVED",1275627914,0,5255309d180e6663ece1a8d3befc1262e39aecaa53da1afcaeaeb8dc9484b745,22775463547
20180320,"PAYMENT SENT",0,-99253312413,e85424c3a0825c5b9769f57e0bb5a2872a9b983f79ececc5d8188eeee3dc16ff,51625264445
20180320,"PAYMENT SENT",0,-30125428812,bac5eb2fd84cd1626cab861f94e4ad172219668a48740a055bfef38cf2844af5,21499835633
20180320,"PAYMENT RECEIVED",1301332605,0,b05c8a4a7dd650ffe27661eccadb01c9a49c3ac66b444127fdbf8302ae67da50,150878576858
20180320,"PAYMENT RECEIVED",1257943600,0,426b7fd65e0defd213e9e31690f0a273d24fc5731b8c088b6fc09cd5894b9e90,149577244253
20180320,"PAYMENT RECEIVED",1255889837,0,0e9352a70a6680d0315e3ab8d3af798cdcc07225659f0d0eb8ea6a02072561f6,148319300653
20180320,"PAYMENT RECEIVED",1265083598,0,0da5bb8b6aa64df1c80dc008a9e1635e75ebae18d595ef3df3f2865916cb5caa,147063410816
20180320,"PAYMENT RECEIVED",1263819178,0,042e09f8203fa7b9bc022dd79cc6ba81058eaa2fe1d8b82151d5e6079ef1b941,145798327218
20180319,"PAYMENT RECEIVED",1254217125,0,e65bc7a16963e1c4444d50a9f0502d8d25e655c3801d0aebc3625a515dc58c99,144534508040
20180319,"PAYMENT RECEIVED",1265017641,0,327e9392a4e4f9cf78e419415a9199fa3f55bd00db9e927490f8e5a163456ea4,143280290915
20180319,"PAYMENT RECEIVED",1270739988,0,276761a923e084c16e544b3e5390be3e064f61ce54a7a934ec05d30477cf1c8a,142015273274
20180319,"PAYMENT RECEIVED",1259758570,0,2899c7ba4fa43731bb57e07922c2c004327509947f1e49a95110d1f1bff2b4cf,140744533286
20180319,"PAYMENT RECEIVED",1272603948,0,1a4f43b8172d3ea6299c6a4c20abe0294b0eb73b2ef897326899b6410c429868,139484774716
20180319,"PAYMENT RECEIVED",1274385546,0,a669bb8513b1731181c79c9265be248e55416fc453bc8141a7487ae7ee0bb13f,138212170768
20180319,"PAYMENT RECEIVED",1270381189,0,7d8d1206b6a387cec55b9ccb03eea38b48cbfecc292f2e629cf41cf2b04495bd,136937785222
20180319,"PAYMENT RECEIVED",1288782550,0,3fc35d8dd6e3715839288f1827e9c2e7d2a7dfcd38f8f0df91168aa9cc7c80c2,135667404033
20180319,"PAYMENT RECEIVED",1267172709,0,6f0803f7e482a8f75dc7c90ade481b4cadfad5867f3b38e8c4864aca48e01365,134378621483
20180319,"PAYMENT RECEIVED",1274775052,0,868b29a0f6e5ba7ee01c592cc5f7d99ac519c3d1f3b8203a6342a83513592b00,133111448774
20180319,"PAYMENT RECEIVED",1263115142,0,760b61b057ddb876c8d2342fee8ab61cc0681f154ef0fc21d1388c7966608f21,131836673722
20180319,"PAYMENT RECEIVED",1255432454,0,745cbb7a00aa38146d9ef8ed5ea5f42f6197f108f31d350ec55e4d4430ec14ea,130573558580
20180319,"PAYMENT RECEIVED",1270419375,0,1c00a288076f82f48a4faec2b08d9d57f00b88171f7ef261b3aac889f8d54b3d,129318126126
20180319,"PAYMENT RECEIVED",1250131393,0,337912147e37ced6fd01eb630b769344a082b68851ddc21a9e7b9016ba626468,128047706751
20180319,"PAYMENT RECEIVED",1250483426,0,f1738ab88c0528fb68bb41508ab3d6c45bf79d0504786fe03488f8655afa482f,126797575358
20180319,"PAYMENT RECEIVED",1286144723,0,9ade29c8d1f474db44497914b4da4f7b689cdc3881e084b0509e0784287f6e38,125547091932
20180319,"PAYMENT RECEIVED",1256854798,0,529e921feb00465f4d2c9332b745708ffb3cf96a09274ffd3f32cf450ee63577,124260947209
20180319,"PAYMENT RECEIVED",1253025650,0,6c4dc55bfa073015a053ecc5f11bd7167383a8a47f41924ea3284e95373455e7,123004092411
20180319,"PAYMENT RECEIVED",1306962854,0,a2ad211f3e4cebe1459855698dbaa7d549755ce6cc8acdbb0f8ee0fda958c06f,121751066761
20180319,"PAYMENT RECEIVED",1269277005,0,722951baa765d69b8b9fc27e24d11bb6a08c8e1fd9fa7d14af11025fad732a09,120444103907
20180319,"PAYMENT RECEIVED",1274076695,0,81dff41b60da1438a253f5ba5e5e74599d03e24833f391ad81a1b8863d79a89a,119174826902
20180319,"PAYMENT RECEIVED",1251988732,0,14dd093eefdb76ea46329a9bfb64270239048ed8e57c08b5ba8f301ba4f9c553,117900750207
20180319,"PAYMENT RECEIVED",1273440510,0,969abb9e3d857fead45d8f9a6c682fe093f4cc45830de180c9e3aac6eb0c9b40,116648761475
20180318,"PAYMENT RECEIVED",1257253588,0,c1669dabe1bcadf50c4b712e42da7b3d3152aef53752731b04a4f585dde6f5f2,115375320965
20180318,"PAYMENT RECEIVED",1253424414,0,6a8fc0813ba60566f499560cfc31a277c3e024960a7213df19a88f6352152f94,114118067377
20180318,"PAYMENT RECEIVED",1254082245,0,9caae4f43871d0c21e732e1805197b3be04a94cb562a56e42318be9cd2abae38,112864642963
20180318,"PAYMENT RECEIVED",1274112511,0,78f4086c7fc52d71a678320381a375accfcb217342551095a7974873b7bcdb73,111610560718
20180318,"PAYMENT RECEIVED",1267046130,0,c8309e4c4df51653ca64f2a5fb93a24965c97d1fb9d2d026f79951fb57d8cd99,110336448207
20180318,"PAYMENT RECEIVED",1260648046,0,8eeb30b0690688d27b480d79755a52a80b377533fca6d4f5c30716905fb3b9a9,109069402077
20180318,"PAYMENT RECEIVED",1250105308,0,9d4b5de4d567440c199ea86dd1aaf3b8ca5afd7cf75e0b0f682ab590bb5c7b5a,107808754031
20180318,"PAYMENT RECEIVED",1252807026,0,d5e81efc01f2cb4dc1c3a304bf65e9175c27ced36573d044bb62969076a90e95,106558648723
20180318,"PAYMENT RECEIVED",1254223799,0,0c8d544e92177a0cd27c8db0b71a5c60383a739dc58fc2b7224a9a76f7297ecb,105305841697
20180318,"PAYMENT RECEIVED",1250286277,0,1b8ec24d37a534522200d99d50eb0f0fb82ba8dbff9d15aab56b5dc81a6f376f,104051617898
20180318,"PAYMENT RECEIVED",1277911093,0,f690d5e2e2ac10baa567781f97bdd0ebc20dd33d418e5c5df17599a148e4307e,102801331621
20180318,"PAYMENT RECEIVED",1250000000,0,d8fe6dbaf806b700f0c4e7582157cc00b5ab6ba78aae08624c884a13f6c229db,101523420528
20180318,"PAYMENT RECEIVED",1289237061,0,f633bf0ea796923c54d47f0a41d1339e380d5b6475478ee56bbe9cd1f739f88f,100273420528
20180318,"PAYMENT RECEIVED",1269008583,0,08003a682c66af60fa9bb8ef2419a53533d09c8a0688cde3dacdbe4b849e5f0d,98984183467
20180318,"PAYMENT RECEIVED",1271570938,0,bf8acf3a82077df99be3fbd0124444d165de4de8b37f77eecc1de9ef0b837d7a,97715174884
20180318,"PAYMENT RECEIVED",1254010504,0,ef08d468ac0fd79448047a6dc29acc07521c5ecc7310c51fcfa96a10acd35237,96443603946
20180318,"PAYMENT RECEIVED",1271431739,0,630513255ed500c0f23badf592d2546fd7ad672b2557802d05cbb416700194d5,95189593442
20180317,"PAYMENT RECEIVED",1253280160,0,2d23887916cf84c5ac3c5a48485da717a6a4962eb7950376dd07040fc6dcfbae,93918161703
20180317,"PAYMENT RECEIVED",1252017957,0,5b995a9e6b7fb2d88c31892a930965092351b6ef54e05c03be0aea48be758ed5,92664881543
20180317,"PAYMENT RECEIVED",1282741245,0,96ed697ecc0e5680ded77658e477617366aabb068c4f7fe5cc957d3995ea728d,91412863586
20180317,"PAYMENT RECEIVED",1250298364,0,7a3cf536ee9446eaa66ff2268edb1ea42e69449d1f312484197928f1a56aee3b,88872313215
20180317,"PAYMENT RECEIVED",1257809126,0,2120f5411685e05734c0bae7e9cd103831aec64abc5c09773e620a6189776c72,90130122341
20180317,"PAYMENT RECEIVED",1262199025,0,b828146bc48c00aeb388d6747f64e43a5ebf6f31d45443cf3e11d908b63d1c59,87622014851
20180317,"PAYMENT RECEIVED",1258477877,0,a07f84dca4b19ed94f05885a4410103651fac5c6b5faaecb8a8aff7e6f5e0ce8,86359815826
20180317,"PAYMENT RECEIVED",1257810108,0,115e5ab4bd5c4227667b52af2420847da3738f5bcff39138551eb5396b1f103c,85101337949
20180317,"PAYMENT RECEIVED",1282340110,0,1b319fd2f14a0bdc33933e104a3c49b80f0ee0df838915292f43e3234f6aad30,83843527841
20180317,"PAYMENT RECEIVED",1264615634,0,948c6c45fbe9343e7acc2bfc2edb378f18b1becfefaf36df69eb0e701d6c65bf,82561187731
20180317,"PAYMENT RECEIVED",1286547150,0,8975a920e49624e97abc3ff682f8a98125c944b60b1f37ac275f542b43888c90,81296572097
20180317,"PAYMENT RECEIVED",1278555416,0,4f21721ca48701b37d849a6e3ff8e146b07ec979aca6b6c61dd44dc8376e135e,80010024947
20180317,"PAYMENT RECEIVED",1279884621,0,89d7dd487bfa5f8fa0cb445ba03dd6f7346cc01ddab6d90751e15bf03ea129bf,78731469531
20180317,"PAYMENT RECEIVED",1275150877,0,8484c9c28f43daacccac9db984a4eb0615d8a333e26afdaae99c0d8e32d3ec3f,77451584910
20180317,"PAYMENT RECEIVED",1258643655,0,674a84696739da78f5174706b7a2ae5108d33356531a8e9a9cfb9f6b8d97f6e9,76176434033
20180317,"PAYMENT RECEIVED",1261908477,0,536ad7d8eaaca2b0b9d50cf4e95962f189eb5e1eceae5a6562de34c9f3289800,74917790378
20180317,"PAYMENT RECEIVED",1263527334,0,f483e5b0d86ee6feb92060a770c34bb22481eca359bb3d33fa1385560af53edd,73655881901
20180317,"PAYMENT RECEIVED",1260761764,0,c4c96468e99598ce4c0ce20adf4e2f219419068474f9902d241747e0179b51dc,72392354567
20180317,"PAYMENT RECEIVED",1270540740,0,1a7adc186b770aeee0c4ab9c1a4949b28a7fb7919dea09d0d2988e140e0faf45,71131592803
20180317,"PAYMENT RECEIVED",1262829440,0,f21b5448adb2633ca4440db7a2277c2b84b9888e1826ba3b21adacb281bd3108,69861052063
20180317,"PAYMENT RECEIVED",1282293152,0,4bd0ff63804cc7737116fd963bd4bcc45f89f62a47c0589299f83f201ba134aa,68598222623
20180317,"PAYMENT RECEIVED",1265671243,0,f218f96d13522e612f35fd6c3f3d89153847a19fc312810a96253bab0f98be81,67315929471
20180317,"PAYMENT RECEIVED",1255444198,0,59f72d3877a11ac76c9d535c5e65f7233350c458310da41de7230e564409e8ab,66050258228
20180317,"PAYMENT RECEIVED",1255945858,0,a448bbe724d36568d0fcd7e87893dd3e5abd7ead7015a9a94916ba2f34659b02,64794814030
20180317,"PAYMENT RECEIVED",1250252845,0,1c3f76a9cf48746ce3f6f6b2ccb5b7d283f5a5445c7b302fe04d1136e014fba0,63538868172
20180317,"PAYMENT RECEIVED",1276488680,0,6b157eaa4f815efd5c69a513408c4303f0d4bdc247a83cd24819babd46031c54,62288615327
20180317,"PAYMENT RECEIVED",1256777852,0,beb37894b415bca85eb37d2026419846447359bfb96dd7028470b5a1bf5372c1,61012126647
20180317,"PAYMENT RECEIVED",1254383356,0,9dde763984d1fef3109321b49fca5d4f4f8ce9f6a8403ba62640b1bf851b031d,59755348795
20180317,"PAYMENT RECEIVED",1250952273,0,6d401ca15c18083776e31db3b306db66d6e49bb28c8b15329381c24aefa0e040,58500965439
20180317,"PAYMENT RECEIVED",1285196802,0,7b7cef7fa71b6236a189c4f02709c3c7afa65b803f91f67187faba05713acf5c,57250013166
20180316,"PAYMENT RECEIVED",1272132811,0,1f7124f0d277f35dcbb1cb0b27d363537908e094193aebc9d7a4832d14b3aebd,55964816364
20180316,"PAYMENT RECEIVED",1267758555,0,29f92136f1af5ebc38b6cca6cf4c4cf2ae9699088c9690dbf441e8f438990682,54692683553
20180316,"PAYMENT RECEIVED",1274846032,0,d5ccb5b6e82314b147df175fdf0afd83ca739c86a31a160d51333d67a71aa88b,53424924998
20180316,"PAYMENT RECEIVED",1276335290,0,9e61acbd092d8f0df0609a70b67233885bf0daeb1d4bd53fae4d86549fa5b85f,52150078966
20180316,"PAYMENT RECEIVED",1262183586,0,527200217349ca2a630bbd83194afa5d5afaac1202e0585a23e7b42b6bc72ea4,50873743676
20180316,"PAYMENT RECEIVED",1310334661,0,b0f7e72201c8a2892e7f0da27fccda2db74101e4846ef0dac116b0dccfd99ad9,49611560090
20180316,"PAYMENT RECEIVED",1255329354,0,0f70340810908bc72ffdf6d2455c690712629bf6f5a1eae0410037ef8a4d4a54,48301225429
20180316,"PAYMENT RECEIVED",1262183915,0,7cd3c7cbf237dfe47ce14069b8552aac2c37f476689b693ee71042e686940d43,47045896075
20180316,"PAYMENT RECEIVED",1281932694,0,bb023374a3823a7204c361bb470d8034eee21fafef3b2453c812176982c0517e,45783712160
20180316,"PAYMENT RECEIVED",1259987471,0,d754f485b4d34c378ce6a5d422b3893d057e7bbb647bc2b954fdaf3d67168174,44501779466
20180316,"PAYMENT RECEIVED",1282471451,0,f83ab309ce6b628f86af4f656433c5f776046c7a257bea143b3cfec0307573e5,43241791995
20180316,"PAYMENT RECEIVED",1293601915,0,6782961a2e4bbb06d1207a2b0a5d339f4a45abfdd21b3b0cf0a6b486eb91bcf2,41959320544
20180316,"PAYMENT RECEIVED",1291531961,0,69c1e44a7e95d7801f5bc6e593cc23d7012a03b4b3fa2b21fed0759ae49cecd3,40665718629
20180316,"PAYMENT RECEIVED",1252490691,0,f39c7b6cd96b25730c83477243d20b89b5ae9f87761cc963d5d80767960485dd,39374186668
20180316,"PAYMENT RECEIVED",1272330786,0,9224b117dbe8d23cdf96bbbd8cc57080b6e29925d8e0fc1cce92bee505255c2c,38121695977
20180316,"PAYMENT RECEIVED",1303108515,0,785ce92a4b2b5b6c5d22346b86acaa278178f344b4c39a326ea120d274b371eb,36849365191
20180316,"PAYMENT SENT",0,-50746648974,2b32224de46b463a39d413f1afc2a200f1a09663f65391e32bd4f62e2646676b,85041779700
20180316,"PAYMENT SENT",0,-49495523024,76ff7309ba3a56d7b0bb0c5e35739bc5c6a49e4d56018a2cac7388a5fcb1abe9,35546256676
20180316,"PAYMENT RECEIVED",1272296982,0,3d0fbe98743a5562363b4f5500ec130b39cc163893f8263a4d0c7c7ab4e94232,135788428674
20180316,"PAYMENT RECEIVED",1273579241,0,e35ae0fc591d93226ffd133cc8722feda830883e1da3015952ddc96b4d3276bc,134516131692
20180316,"PAYMENT RECEIVED",1290429158,0,9710e52271d5c7655419caedf0641a4f7c08c6cc5148acde24d0259876711ec6,133242552451
20180316,"PAYMENT RECEIVED",1287688995,0,619aee785b4006d76629e174e8252e5cd0666c225b1f7e46546b1fe9250e6408,131952123293
20180316,"PAYMENT RECEIVED",1250465251,0,2f3e3690ef00e585daa09b23b4bda3bab8d470885e166f6f9258144db4ad9c0f,130664434298
20180316,"PAYMENT RECEIVED",1258446953,0,c190371a88d183fc2d696837236c78c1289af1b7894e8c5a9d7e20db131bb43f,129413969047
20180316,"PAYMENT RECEIVED",1257534163,0,ed2356bb06d888eee26951e52e7d33c5f2a9df8c0166c181ada6f8b06ca8f6b5,128155522094
20180316,"PAYMENT RECEIVED",1250487358,0,f96aef1251fd4aba0ed723f75ecf76189a64fc874f917303785c4a71b08d7d0a,126897987931
20180316,"PAYMENT RECEIVED",1284513052,0,ab8c482f04b56e3351eab92b039e71108e87c715c11b7bd5833da41c2afa02cc,125647500573
20180316,"PAYMENT RECEIVED",1257652085,0,8dab4dc14dde4a72b0bd1edbe10df5a3bbbd6e5df12b39fb3ac5aa751629f157,124362987521
20180315,"PAYMENT RECEIVED",1265957646,0,43ac63b604a508be4ebc1eef4d71634d6816acfa0dcee42937a6a9cf27583b63,123105335436
20180315,"PAYMENT RECEIVED",1250460814,0,eb9c8ead39fb2c3f0822b422527ad888bd8c38088dc115845d3875ed6e36a6c0,121839377790
20180315,"PAYMENT RECEIVED",1261885882,0,65325cd91c4c632095323ea0033cc1473dca2369a796856106c48d7fb52e438d,120588916976
20180315,"PAYMENT RECEIVED",1252271108,0,80e0757e1eb27fffdc71a9d6a6b04bf8b9b3a0f91f858a286dba8e324130da6b,119327031094
20180315,"PAYMENT RECEIVED",1299586220,0,5c4969f25c2a7d32905c743cc074d2408c3bc8d588c55a349419c257333d32ae,118074759986
20180315,"PAYMENT RECEIVED",1304572663,0,bdc58dda9095a83f3e1176687a6c693563ba7c1fca889a16296b0f9ec7914f8e,116775173766
20180315,"PAYMENT RECEIVED",1310795772,0,555dcb5547a7a266b5143735a67be680bfaa02508e81fdcd388c858a1ef36482,115470601103
20180315,"PAYMENT RECEIVED",1297784809,0,529621fd728d944029646bfd33ad29458670ff0712919ea8c9d2262eecfdbde2,114159805331
20180315,"PAYMENT RECEIVED",1278981261,0,d2a2c3b1e16a4dcfdb291d2b43360a6e996cd07056831dd9ceb1503054ee524c,112862020522
20180315,"PAYMENT RECEIVED",1260146776,0,ae21fe5165ad966118b42acc89f8ee4039c7b516065b18858fcaaefec5db17bc,111583039261
20180315,"PAYMENT RECEIVED",1265660665,0,95dedb56a847b577c1a24b4fcc2ac96caaae8cf84b91663e556a6373a1d17ef6,110322892485
20180315,"PAYMENT RECEIVED",1276197079,0,ec91c0e00a75bf60276263825e310da5f328514b6f29130a6cd5cd96025fbd67,109057231820
20180315,"PAYMENT RECEIVED",1265154186,0,5a894c99533bd39bde2a977e9458f983d6520de9ce0438ffc0faabe58fee1aa3,107781034741
20180315,"PAYMENT RECEIVED",1278403851,0,bbdc549bcf0849e32aed70690ebc6bda0da9a46bbc07edba30eedf175ec4e428,106515880555
20180315,"PAYMENT RECEIVED",1254753907,0,54d7d0690a06e09b19bfac7d4115e529d1852e9b29a4517b7dfd11317be5c151,105237476704
20180315,"PAYMENT RECEIVED",1262544460,0,29d09d58a838d36700bb154b60da54b6217e6ac68da93f6c59e0be63f446edab,103982722797
20180315,"PAYMENT RECEIVED",1261632266,0,08ed3bdadc986b50ef039a413329109b1154759daeffc8ab9ed4ceedf0483396,102720178337
20180315,"PAYMENT RECEIVED",1289469147,0,35364479482460653e0c4ba8db2585003ec6f56cce1ff45c472b96141b7873aa,101458546071
20180315,"PAYMENT RECEIVED",1255707050,0,5f366c2c077bf57ca29ae85a532d778bb3729a44f1c0d56a26ff0f5a820bca87,100169076924
20180315,"PAYMENT SENT",0,-96157911878,ab17dc3f8152cc1b3d293fe5b05e94072f9d13ae404aae3ec8fff8f4ca0c36ee,98913369874
20180315,"PAYMENT RECEIVED",1258521143,0,9c01cf490b03a4071c477ec02cf5f691510e348c674ac4e27849cc1f73b94a20,195071281752
20180314,"PAYMENT RECEIVED",1301838984,0,9ac2f185903253b4fb2a0a1adf16e1e61ffc863e0b1aeb99629abec1b441bf97,193812760609
20180314,"PAYMENT RECEIVED",1267528812,0,7c978ecab390e9617c744054a04b0b6178312fd76577b7bf9b065bf269e9130f,192510921625
20180314,"PAYMENT RECEIVED",1264641740,0,952ca5416c12ac4ffaec5ee4be63c96b99b1b12ee27abc009b6e721a144333a9,191243392813
20180314,"PAYMENT RECEIVED",1263078776,0,191642130d1a2384197e28806e2dc1bcf1b00a7af3e161a9543f7099532b3d91,189978751073
20180314,"PAYMENT RECEIVED",1251329281,0,2d13369eb2c6e1e4bc538c9f157d5a3c70fbd7d1669afe636ba06ff7bb87e9b8,188715672297
20180314,"PAYMENT RECEIVED",1254140472,0,46648bd5f029559187691d2e0ac1929a99d2abca5c09e917b930c3bb1e252fc0,187464343016
20180314,"PAYMENT RECEIVED",1258115209,0,f313364308e0ff96ce54497d2575ccabc074fa302ce5e68803687b84fc261bbd,186210202544
20180314,"PAYMENT RECEIVED",1263506396,0,8ca6bdb842ead7df60bd5eac5a6bf96277202750d0cd839b4fc99bb72bc174e8,184952087335
20180314,"PAYMENT RECEIVED",1280982517,0,8068bea1882e0b58c3bdbc8ab36644d0cb1ed66b6c4d6b49a8c1d312ce7775cd,183688580939
20180314,"PAYMENT RECEIVED",1314646713,0,16b1b9f27f819a226fa04a571a68d6978ca14a7b980aaf167e4d629071d02f04,182407598422
20180314,"PAYMENT RECEIVED",1294074003,0,61f8ea0a05a1d2dc751e88ee78e8964a81e3fb8aeda061e24f2db3bc424dfad8,181092951709
20180314,"PAYMENT RECEIVED",1260876892,0,9b8001bdfe9a11e6c2864e55fcac892bb43c8ec171d0bc28567989ff1a5fadfd,179798877706
20180314,"PAYMENT RECEIVED",1293781997,0,e364e83fbfef7187810d0eee154831583ebd0b4047ff1fee80b71d4a906ca81e,178538000814
20180314,"PAYMENT RECEIVED",1318661189,0,57c2c31056d77aa1c64c9471ab79d6cfd78817b7a3ca3e3e9f9b01b367489e8d,177244218817
20180314,"PAYMENT RECEIVED",1260309009,0,5c7d251e756bcaa1dcd131cad844ad1b2e1b85371768c9e2adc4d9e1ac19acf9,175925557628
20180314,"PAYMENT RECEIVED",1272775400,0,7bb2e1f30b978cd36f5228eb49089fb15514fd9556812b5c4d747f63949aa1a4,174665248619
20180314,"PAYMENT RECEIVED",1264000500,0,c29283abe275857d795d3edc073f6a3b3b9084467a02df26ed2b4fb8026d981b,173392473219
20180314,"PAYMENT RECEIVED",1261217717,0,d5fd3cf90268e9b8bcb132ea91cb080a4b6a7e8a64a83cffd11e31f9260d17b3,172128472719
20180314,"PAYMENT RECEIVED",1314442730,0,1e081e01151938c6f01ad3cce094e04203145b4d6f7e8149e7f854248d9b9d29,170867255002
20180314,"PAYMENT RECEIVED",1324214506,0,880cc99a07a2b083f34e3ac6e9fbabb28be504c65c81f5b9bab71c1b565860a7,169552812272
20180314,"PAYMENT RECEIVED",1266200028,0,119100e23a87393c97b90c29fdbdabf1f9e5bc6d946bb2260d18e2d86c996f27,168228597766
20180314,"PAYMENT RECEIVED",1282823402,0,91254e577a7b412d09a88c0d30dea3b9a377dc20c49fe5b3bac0ddbdd08491e1,166962397738
20180314,"PAYMENT RECEIVED",1256455203,0,aa659401bc71a730766c4c962b6855798e956f6b2ca3505a27e69530d48c9330,165679574336
20180314,"PAYMENT RECEIVED",1250595691,0,bceab4b7789fa24dcaa7ed3443dc899a9871ebb167d252276e08f108fa641b7e,164423119133
20180314,"PAYMENT RECEIVED",1251417358,0,b746a8b034867dd5db06732e79d565411158595c393940a07ad1c7e36539e849,163172523442
20180314,"PAYMENT RECEIVED",1253967563,0,194d12e89992c03266744886de9ca7c1989adc9ab7b7fa224d62d38547e3f45d,161921106084
20180314,"PAYMENT RECEIVED",1278920755,0,b4d8981114320b5c74f3663f703c860eea0a21adfba638318a30ed65b59bf2eb,160667138521
20180314,"PAYMENT RECEIVED",1253138264,0,ead2982e5b802fb6d451d80d3526fabec663d915b28ba3bdd168b87acaaf4be8,159388217766
20180314,"PAYMENT RECEIVED",1279380856,0,facb2fe23bf1759e1bce9416cc62990c278ae4b2108bf929ae799e693d31a67b,158135079502
20180314,"PAYMENT RECEIVED",1288932215,0,10a12aeb22822ae99c4b0d10d8c6df4c4d8cf6f9890994405b8b82b6373e14ab,156855698646
20180313,"PAYMENT RECEIVED",1301006594,0,f0436b36dca3181421877772a76abb2e5533f782c37ea4ba6321d06688d3d9c7,155566766431
20180313,"PAYMENT RECEIVED",1278114912,0,d6b4ecc78c8ed42fc9abc97540b7e74e3ed03173e1045b5b4a091fd559c3e91d,154265759837
20180313,"PAYMENT RECEIVED",1282544281,0,ea2b966c04753df28a668c511ce3f09ee92f683ecf99101a7b8d3c1316a56315,152987644925
20180313,"PAYMENT RECEIVED",1313719833,0,ebc775f9f5ae4ab1cf6a62129347f495f86171189d5636f5574aed89554348fa,151705100644
20180313,"PAYMENT RECEIVED",1292918554,0,78d538f3c4e2ba8476317bafffd911220bb213b4f4f889461aa2e7ac9516aafb,150391380811
20180313,"PAYMENT RECEIVED",1310581022,0,fd6a171e13a2def97a39cd9ed1feb779b256f12f87ac462187f5cbb196f95605,149098462257
20180313,"PAYMENT RECEIVED",1288079214,0,719696c46390ae301ec0db8b749e459090fcee2c671645148dbb4b7ae1358fc1,147787881235
20180313,"PAYMENT RECEIVED",1281534839,0,f1c56815b6e8a644eedd4a9022a8a48869621dde162016a67e899f7108be27ae,146499802021
20180313,"PAYMENT RECEIVED",1304002623,0,e8fb48764fcbd3099373465b3ec601157f15a0fde6e0a95a10b3afd466e87c3c,145218267182
20180313,"PAYMENT RECEIVED",1310058502,0,0e900a994935767b785a74f403e58b914c48ac1e0244e9b44a2ef11d12a52396,143914264559
20180313,"PAYMENT RECEIVED",1310367219,0,f4471b0f68fc376e8d7023dde1a459947ce5f36833b57e2c38e614003e85e334,142604206057
20180313,"PAYMENT RECEIVED",1302522755,0,eec71db4e571cecc6596a098384fbf5737f136d124bb8c7e93f57f8089a1fe60,141293838838
20180313,"PAYMENT RECEIVED",1329559962,0,17e73ad6949926d02de1336607e9321af91034fd36bc92bbb366a76f21c532f9,139991316083
20180313,"PAYMENT RECEIVED",1354368946,0,ccda05fefa008ef259e6900808f59cad169e6e3f9f256ea3d3a036e9942ef9cc,138661756121
20180313,"PAYMENT RECEIVED",1304543823,0,5d6fd5112c2e72127ccb42ca67bef94c17e31e1482724b82c9bae8cb5e1086d5,137307387175
20180313,"PAYMENT RECEIVED",1250000000,0,449940e831ce75c254234dab964275f512579efe78127f078271e3e3ffe67f70,136002843352
20180313,"PAYMENT RECEIVED",1253006037,0,b3aef4e8f6a16f2c07722f28c48f5da85188a9ac213ebc0949791f46868c9a6b,134752843352
20180313,"PAYMENT RECEIVED",1252930364,0,db4c53e0c4c85ba4159322d481e0e96424df57500a9fa8eb1719f8b37c34d83f,133499837315
20180313,"PAYMENT RECEIVED",1259947845,0,2058b61e61b6a7f3aed0c1340f8b3438b874c96ac9fdfe1fe24f74168c37517e,132246906951
20180313,"PAYMENT RECEIVED",1291778557,0,e65e127a119d875a66ce62095d510072a25dbac8a5d0789e2d7fda4ce8ee051a,130986959106
20180313,"PAYMENT RECEIVED",1273783647,0,1f4354aa9f6b4e8e60dbe94e0b27c995bbeb862804936d7325c7a351188edbaf,129695180549
20180313,"PAYMENT RECEIVED",1250314114,0,87913e1b472d0069520f9e1e8f783f9a3f9fc7018ed2f14bb78dd435dc1ab731,128421396902
20180313,"PAYMENT RECEIVED",1270647186,0,ef80268715b89cf69e26e5a42943e42d78128de88f2c9a0adbd72e0f2d160fec,127171082788
20180313,"PAYMENT RECEIVED",1276140474,0,9ea6200869e785b8ba251e653ddba622f488fc7f20807be39ba18c03566dd935,125900435602
20180313,"PAYMENT RECEIVED",1264182152,0,c106ebb35d42d644a3e79606ed33455e16107757757c24fb9e9e7d173f3e67ca,124624295128
20180312,"PAYMENT RECEIVED",1268336404,0,2c9f6d19b3375f7bc6ac1006a7830c04a57d89bc88e2cecdf6e73f26891ecb7f,123360112976
20180312,"PAYMENT RECEIVED",1271548748,0,e4400fa009b3e0dafc56ed3d7af914444dc8f894c79e60fb595c94170af646d5,122091776572
20180312,"PAYMENT RECEIVED",1337012668,0,d820440bfeff30a60a5cf131189aec686e318c0593b6f517c7a9b020c5881cb2,120820227824
20180312,"PAYMENT RECEIVED",1258638305,0,71cb2a46243774b5a8a96303a10cfdaddad91bc6da57abd148c3e78fac954dbc,119483215156
20180312,"PAYMENT RECEIVED",1296434065,0,350a9b29f56e699950f7c3449ac09e3b9dcbb9e746605e6a1b7c77b90d431a12,118224576851
20180312,"PAYMENT RECEIVED",1297509110,0,31ef98735fd6945c504e3b7ba21f317599e651557b4c88fbac83bc656e80967c,116928142786
20180312,"PAYMENT RECEIVED",1294675685,0,81c137610d565c348568d09adabb66b4c1dae9268b959c4aa37bd48709927b22,115630633676
20180312,"PAYMENT RECEIVED",1260481188,0,5072719704b7622fda86d4e77d0fc6bb40bc51be638ec19afe259e2566d2a2db,114335957991
20180312,"PAYMENT RECEIVED",1267935118,0,fe2ebfd6840423bd6fde9eb60e08a5654d4cc73f2cf983fd7e09a76bc89815d7,113075476803
20180312,"PAYMENT RECEIVED",1290108432,0,003a83f6578b25a71bcdc4f8c136a02230407f3dcfda11130574b98c263be977,111807541685
20180312,"PAYMENT RECEIVED",1267291577,0,c680bcb6a8d3f9554eb74c96d4f21842d9556ced988e0fd5d76f063b6c381256,110517433253
20180312,"PAYMENT RECEIVED",1273633384,0,e11160a11c5b54b1c9d4e787931be4ba9685f0c403fb8a14735f426a52b1d73c,109250141676
20180312,"PAYMENT RECEIVED",1259858791,0,a5f8ac01bf08d451adafff37ee0ad2df56b3fce3d544f76a1be70b7f4dd2b8ed,107976508292
20180312,"PAYMENT RECEIVED",1258789665,0,c30c77a59d57a4220df18d926e73320c7564d3796a8e5486ad2df5c7fc61ed00,106716649501
20180312,"PAYMENT RECEIVED",1262571078,0,5b83d58aa1dd0a79f1b02a9ae266a0889827de05898d42514b9c13add966c7eb,105457859836
20180312,"PAYMENT RECEIVED",1258677472,0,d1ab2a1cbcdfd4f12952265708bc850944b66d19a2a278e313daec1104723c5c,104195288758
20180312,"PAYMENT RECEIVED",1262504751,0,dd44e39c409cf690e5af42ee4dd9ceb4fc1a90aac7e430bdee702935ca639cba,102936611286
20180312,"PAYMENT RECEIVED",1260907045,0,d529b5d6ec96f4716650de75790be954bc6f86d3f01475479b6b71a2a6fe1558,101674106535
20180312,"PAYMENT RECEIVED",1252698824,0,3a92a7112b360fe5e48c15fa9051477ef78bcc1202c46af3022d6b9d1056de3c,100413199490
20180312,"PAYMENT RECEIVED",1252473150,0,879d47011aa84d08d48ded312ee971542b867dfef231cc604ec647678637718f,99160500666
20180312,"PAYMENT RECEIVED",1273727264,0,6b48665c846c2f1303e207d383e0d74a12a97121cdc4fd8e9ccd7868fd5e28d7,97908027516
20180311,"PAYMENT RECEIVED",1250000000,0,5f28c49e437e182d645f9908f8cf1a83b28cf9280ec848e9a163eb612ccc54a2,96634300252
20180311,"PAYMENT RECEIVED",1280081881,0,60349b93c675585d6bd3cdafdb6590323f99d60b081342d7e7602dc5cad106b0,95384300252
20180311,"PAYMENT RECEIVED",1313990385,0,a3f35ec1966fc09d026f13e076ac3c14e44ccbde089dc4da38c9f7fcec1ee61e,94104218371
20180311,"PAYMENT RECEIVED",1278400417,0,836110f9f1465d04dc0f12c9e06b5479798415ecda84a2935dcc9c1e86551255,92790227986
20180311,"PAYMENT RECEIVED",1275374171,0,64579c58827d273b59eb06fe0cbe96689f6b40948b59cf2fc100cb1f93c89ec0,91511827569
20180311,"PAYMENT RECEIVED",1251565267,0,99bdb86c1f805679accae80a5032d71fad42a9c0aa6dd1698d48712ce0d5377f,90236453398
20180311,"PAYMENT RECEIVED",1287314312,0,feac2101b81294543289ab16b9ef53d6c9f9d85c2cbabc82d128b6e1db17f660,88984888131
20180311,"PAYMENT RECEIVED",1288524759,0,2d99fd385bc06acbb5d7f38acc5cab227b5b301505cd15d3c835032ca63f2eb0,87697573819
20180311,"PAYMENT RECEIVED",1274063162,0,2c48bc66f5d8e1126c9b68c682ca3e28b8e2b5f3586d2497c3ac80b920a05c88,86409049060
20180311,"PAYMENT RECEIVED",1260992852,0,c01a0a9520e388897dbf253703c74ac15ce611364adab22f11099ee2297249f7,85134985898
20180311,"PAYMENT RECEIVED",1291826677,0,49441aa6d107ff5c00771cce9a8ea21cc94d164b158f59450000d506b45b2f96,83873993046
20180311,"PAYMENT RECEIVED",1251864333,0,8384f963ce1eee97281d87cda0b48e4418dd8ae0227ddd95415639d5c94cd08d,82582166369
20180311,"PAYMENT RECEIVED",1260778375,0,61c0e283ef543efe9a6c0d34bdfabd6722dd714d48558ebddc87900ce3b40324,81330302036
20180311,"PAYMENT RECEIVED",1250934828,0,37e6394edb06abf5c18efdd652cb3d74dbdb66a82e6be15642ef6cbcce683016,80069523661
20180311,"PAYMENT RECEIVED",1271409692,0,43127db93b37e1824881fc7722012190f8730bd8a340a57e4f08abcb10c7f12c,78818588833
20180311,"PAYMENT RECEIVED",1265028361,0,ec2c03cbb2cbce1ea0b03090712db0125a23ebbddc65e231bfe4d4ac491c7bd0,77547179141
20180311,"PAYMENT RECEIVED",1254664590,0,1e2a778593b1b9f4f7eef5d1b2ee9eb36159c597a4199951805dd21b59e95465,76282150780
20180311,"PAYMENT RECEIVED",1270772842,0,39db2408755c358a9c9a49ca87df6994b19121747d50ad81f66445a82c43f126,75027486190
20180311,"PAYMENT RECEIVED",1262906348,0,a5ad7dea57c8cf96ed1dd98ccb09d9e5d780917d9718f278dab8cccc3c574a73,73756713348
20180311,"PAYMENT RECEIVED",1258549190,0,9fe5ae1426fccb830e45a8b2f74ce7e0bd604059093abe787539e7eb8f72bf41,72493807000
20180311,"PAYMENT RECEIVED",1275039032,0,143f7b5e9f41aca60cc17ef513f3fffa9f44df7551f8091fc77b448a7e20e24b,71235257810
20180311,"PAYMENT RECEIVED",1263234397,0,ce5a343edb425a409e850136b4ebbd5bd6124ba5c6012e892e8a897c8a8845f1,69960218778
20180311,"PAYMENT RECEIVED",1256230884,0,c265cc8d14836c637072c037a718d8bea2142b847b54987808c18da013efd601,68696984381
20180311,"PAYMENT RECEIVED",1286007165,0,1810bd52cf4a4f5fe37d415f8f922aa72a2c47c815bca49d141864959cb988d9,67440753497
20180311,"PAYMENT RECEIVED",1376583374,0,9ce304fdab8397907b90731788685b9a41717fa8916b039003480522b0a372a4,66154746332
20180311,"PAYMENT RECEIVED",1266706560,0,dc300a99db96d6a4d3d7c87d6d911b8d46380eae7149a9497002a9bc627809ce,64778162958
20180311,"PAYMENT RECEIVED",1251929342,0,f157adb2908a7614aedcd6276a7bfcfbc6ae759349169430afd167fda8348239,63511456398
20180311,"PAYMENT RECEIVED",1259800455,0,feb42464462cfe01c1bdbcf3cf1fbb9aaad6df1b4b0679acd984a531a0dbcd66,62259527056
20180311,"PAYMENT RECEIVED",1263661883,0,76dc59724fce6131c790a45baa18fa947df2e982b3e15ba2d881d05f8921bc10,60999726601
20180311,"PAYMENT SENT",0,-94187342399,c1f504037ade6d8b0ffe7fe6a0f771a6e01ee736e85ca939c8a6955afd502ebf,59736064718
20180310,"PAYMENT RECEIVED",1279307205,0,f5d7643759f0d6fd0e44c6172d252199d3299270ffbc36d6aa306dea727947c7,153923407117
20180310,"PAYMENT RECEIVED",1253428582,0,c9433530e7a459b7490f83841f9ac578c71655f17528bb9e7975bebf6c73e442,152644099912
20180310,"PAYMENT RECEIVED",1252386330,0,e02b3b5895315720783f5cba1b84f1dc45569661ae46a19db895fbca635d763f,151390671330
20180310,"PAYMENT RECEIVED",1259705003,0,66a0106689ac4fef046c3c499650685e2261d4ed2b9b4cff39529c3f1105c56e,150138285000
20180310,"PAYMENT RECEIVED",1252576152,0,6d8063fde51b69345966124bff3efdefcb17c59fa861a6214216fb6abae6f1bb,148878579997
20180310,"PAYMENT RECEIVED",1275370820,0,b08d433f3fd8a317e4972764bcfef5b3e03104bb57e458ed9eeedd8ac2e7f5c0,147626003845
20180310,"PAYMENT RECEIVED",1310083395,0,0752bed6bca200371c9035392a38db725577b5c212b6c986717c4c7fc64394a3,146350633025
20180310,"PAYMENT RECEIVED",1266644074,0,963d1f190b42e15173cc1bb4023a8cfa33c1e0ce04bc2294d2c265b5c2a62e70,145040549630
20180310,"PAYMENT RECEIVED",1273741574,0,49490ecf087ae340c5c06104a2e3979946301cacbf9d08d9e67e1220c6430fa4,143773905556
20180310,"PAYMENT RECEIVED",1279065575,0,199367dc4027d58b9979e43c5bf03af433d0adabaff330ddfcc2102b7f8df02c,142500163982
20180310,"PAYMENT RECEIVED",1275784405,0,411294e84d347597cfb75dbd828fec3615fe4cb01b5e352ee68e03fd340d5e13,141221098407
20180310,"PAYMENT RECEIVED",1254718922,0,84b7c6f62b4da95ededf39225b016d485bfc00c1fe0df9218e7fbf2f09884e15,139945314002
20180310,"PAYMENT RECEIVED",1257795989,0,75ff8bea2e3418902e37d0f8e426dc9381bfa9534124f8bbb62b0bc99017ef35,138690595080
20180310,"PAYMENT RECEIVED",1271318958,0,5aa5ed6fb92aafaa22ba8161934e583895b5bf8ecb250e7edfaaf7630d278d5e,137432799091
20180310,"PAYMENT RECEIVED",1325816781,0,8dd28b73832b64d0973c1f4a7634b4c31807926b7dbc07ebfe77818b06ec525b,136161480133
20180310,"PAYMENT RECEIVED",1264839236,0,df0d5d0fb3ccc41a812300e7c68a9fbcf953f49395b89c7ac934f07595407279,134835663352
20180310,"PAYMENT RECEIVED",1267432930,0,90ea152317a0a9ded26b460a36c1111480e10d8be51e8038a8c2c0fb13dd89e6,133570824116
20180310,"PAYMENT RECEIVED",1264797199,0,feea8062a0bcf130a653cd0c6082a9948cddae5dc25e8eea05e517cc841a346e,132303391186
20180310,"PAYMENT RECEIVED",1352741366,0,6fa7e5b5de04eabfad89b238d25de84d0069f5e874b8d660f8a2c0df01920084,131038593987
20180310,"PAYMENT RECEIVED",1363166817,0,66b8e9d33524ba43ebdb0271f61a320b8caa61222a9c04422ea318260233d613,129685852621
20180310,"PAYMENT RECEIVED",1267664370,0,2590790ba176e6241fe4a7c83e730a07043216daa7522dd5869de2beb7e12522,128322685804
20180310,"PAYMENT RECEIVED",1255124386,0,1132343c7c4829eebb436b54b4e83c0a6b553614d0b708ddc35a2bab2fac54b1,127055021434
20180310,"PAYMENT RECEIVED",1250192643,0,9bda540e5fd08431815ed1eacd59eb02395e033405e19f2d85ae4722efa8c01c,125799897048
20180310,"PAYMENT RECEIVED",1255795456,0,a61a5e93c8d4097db1c45206007ca0aeb9c9d5d6596657e97c0383cbae60faed,124549704405
20180310,"PAYMENT RECEIVED",1267440858,0,68816020c440798f4631d2c2fbf10545cf45642890dcaecf3d6c54458fc88b49,123293908949
20180309,"PAYMENT RECEIVED",1262908605,0,677211dfe5bcce6239dc7c88ade2123ef373d982f1b5638b1a5a4599ff1b7ba9,122026468091
20180309,"PAYMENT RECEIVED",1259061030,0,10b8f26f452182da132db399194f3422f0ddd27619f72aa0bbbcb71fa7579d1c,120763559486
20180309,"PAYMENT RECEIVED",1252438464,0,40676419d38c340b8bd431f8c48f3d659683bbecc34c73eff74d08e353c2b79e,119504498456
20180309,"PAYMENT RECEIVED",1253189677,0,839ceb52b02de1299b4937ee5e0961b82793a26b8e70b6d2c2d1c00689708cf1,118252059992
20180309,"PAYMENT RECEIVED",1266988948,0,ee6f9b4ad5b73805c903940c38ec072623268cf10d8418e7ed8e7642eb40c2d4,116998870315
20180309,"PAYMENT RECEIVED",1261506675,0,03c72a40926e9062fed40178450fc885b761df27d6cfd2fff4733b028143dd60,115731881367
20180309,"PAYMENT RECEIVED",1255986241,0,a689d9ef058742c7b292b01d53231c1fe81867eba534bcf6bd42994b1449cd88,114470374692
20180309,"PAYMENT RECEIVED",1265171572,0,81b97b032e7fb90bb128c46082ceccb9f39f2eb289d583698aa401f0faea56f3,113214388451
20180309,"PAYMENT RECEIVED",1259754830,0,89d3247a7d79436aecf66ef7d9c79cb2c0237715b9c9a53607b023ecdf3ffaa2,111949216879
20180309,"PAYMENT RECEIVED",1288674646,0,2850a46c6a21b40ac2f3562e6da61e1b2175a4ee6a41068907c9cf3e6608cdc8,110689462049
20180309,"PAYMENT RECEIVED",1254229720,0,ee741eabbd4c639925150eba5d8a69b5bb2d9cf2f02e625b55ae006d89b5d05b,109400787403
20180309,"PAYMENT RECEIVED",1316484281,0,c4a100e9683cb763b3f124e483f9be2fb27e199c3e93e02ee6d9e8bf7fdbf116,108146557683
20180309,"PAYMENT RECEIVED",1283814093,0,84d4fa29424b1d0dd0f9adbacb689cd4eb3b79f944d76c51df1f66a3da14e30a,106830073402
20180309,"PAYMENT RECEIVED",1259756123,0,f968f8b0fc51947c15e6bb00a76ec58faf88d89c12164400a07a0eb8c2bc7b1f,105546259309
20180309,"PAYMENT RECEIVED",1284652724,0,38fb28dfb95cadb9e2182413dfbc97ac4a5386a53dbfa45a03240107c9bd2c9e,104286503186
20180309,"PAYMENT RECEIVED",1267273113,0,8e202e30a206aa02f6c5a06a60dbac0b65d247b2fbad8f223310fc4148d35e90,103001850462
20180309,"PAYMENT RECEIVED",1336037703,0,4d9e9fd237308abe5538ed10533315e6a7680a10c0b5b303d9add849f1bee8b2,101734577349
20180309,"PAYMENT RECEIVED",1268790473,0,0d7ef377bb111eac093d4ba752e92bfce754e3ffba23606f8d86a9015809ef7e,100398539646
20180309,"PAYMENT RECEIVED",1255111518,0,2be255123fcd2012a9bc768cab3af329e9376a63d07b59ace2038c6c6ddb783e,99129749173
20180309,"PAYMENT RECEIVED",1272446516,0,a966345c30f68e787fc28967bc5896cc5aecd4039870eaa0fa9bdb749451b6f8,97874637655
20180309,"PAYMENT RECEIVED",1259854400,0,eeab965f47b5a553c6452d71c7ba718a9efb91abfe7c5555b88d11179b71c78a,96602191139
20180308,"PAYMENT RECEIVED",1260244494,0,260d123454018fe56b427d4f5d59ecae86e78edbf4c7aea8b87a668cfd2efd76,95342336739
20180308,"PAYMENT RECEIVED",1446155628,0,f4dbec64f57897d5c44fb356c845a81ca8aaa6f80a31e11acf46e0a8e4d70305,94082092245
20180308,"PAYMENT RECEIVED",1268740885,0,566245762222134fe4726bf71e886e5a6e8a085c76041d23e6385fdedf7d264b,92635936617
20180308,"PAYMENT RECEIVED",1261249695,0,84980bd4b0d5ea07be3350fd1b3a910a4104e22f1f7c9e44831105cfc3a0d861,91367195732
20180308,"PAYMENT RECEIVED",1266825305,0,6a2a86a09bec70a92552cf5c97bb86b94dce4deecdaf7900e8ea184bcbe6cff5,90105946037
20180308,"PAYMENT RECEIVED",1278526307,0,3d561c892d5871a286def75f5151e72df31ecc37b2429d973657af527e7d881d,88839120732
20180308,"PAYMENT RECEIVED",1282905469,0,f758882b9c81ff14fcda3d84455bae5504b6ad08c1a4fcc6967a166aa70494b9,87560594425
20180308,"PAYMENT RECEIVED",1308843415,0,0dba97ecc2ac3e248fc44ff8cdd1f41275ef86ba6307d799a04b98da9e30769a,86277688956
20180308,"PAYMENT RECEIVED",1283281723,0,eb66a4327b949fa6d293beb95a3cda45d7b1295065b38e72ca3b7353cd059a4b,84968845541
20180308,"PAYMENT RECEIVED",1266272478,0,980c12ae8a5b204383e235623159df133b46bb984ba94ecc9edbe4dc7bab55a3,83685563818
20180308,"PAYMENT RECEIVED",1280229488,0,fd6ba3132c8113afee10a264d345db3dfbc6117af656ae1d62eef10fd204febd,82419291340
20180308,"PAYMENT RECEIVED",1275932537,0,22f8360fecc5ad67953e3c14e7a5642395bcc2734b65b5d77db31d3813b64a5d,81139061852
20180308,"PAYMENT RECEIVED",1250155350,0,436c7c90113223c833bfac35a8f058b7a67c80820e75f3799350e6817219d374,79863129315
20180308,"PAYMENT RECEIVED",1282150960,0,f546bf7b59f825a6c36cf1ecb89b6e5fd92d2e2a12194b0b98e20fe2388d1414,78612973965
20180308,"PAYMENT RECEIVED",1262914821,0,58a15f7f121eec41b0488112dd8b96c9c55378f5c8dd5987079f720f0144f8d2,77330823005
20180308,"PAYMENT RECEIVED",1278671129,0,fe260fc45970fdc0685c7d70fb2bbff3adbbcf358adc41d02a6aeb3aa1a2fa79,76067908184
20180308,"PAYMENT RECEIVED",1260419790,0,b78729060075302f4c5737e5cad075c2c493f8e0114fe603ab43bf1c961cc4c8,74789237055
20180308,"PAYMENT RECEIVED",1260595411,0,a577f3fcaedd81b6d5a38ef9f281ca0444163b1fb73a82e7d05e5b972a5ab635,73528817265
20180308,"PAYMENT RECEIVED",1257132815,0,1f3715dfc4f1c5c7ec2e12049c63138ae069a309d763d1bd005f0c50a1dc21de,72268221854
20180308,"PAYMENT SENT",0,-97298375081,43b79b58523c13f4a995ece0d680d4cd294aba4e945c4342980d57a5381b9556,71011089039
20180308,"PAYMENT RECEIVED",1269818206,0,00c8c5a055c958fd15f778cc95ac911e2ee4855234ff03eb42ab65211ef8c670,168309464120
20180308,"PAYMENT RECEIVED",1291278545,0,49cef6e304d99029debc3c0aea28339f5641ec856b712ee5813352e5205c62ae,167039645914
20180307,"PAYMENT RECEIVED",1280761062,0,6ea60a916e27852077600dc04c283317d3967f962a6cce11145fec1c7120edac,165748367369
20180307,"PAYMENT RECEIVED",1265927451,0,ab99844abb72b3d3b5a6557e67ac42ad3526ad0b82fc820db8aa6c5b1254987d,164467606307
20180307,"PAYMENT RECEIVED",1252179984,0,2a97e1d2ef52f099f8c82b37d8c7c69c5599793a99306eb30bf8f10c8b97431f,163201678856
20180307,"PAYMENT RECEIVED",1303553853,0,1ead691e832d54f2776c314281b3a9e07355bb8955df8111586241b48f4abc5b,161949498872
20180307,"PAYMENT RECEIVED",1256528802,0,b273fd3b7e5eb6da8a9745ebb1c21470ff3b79752e55de34f327165bee978008,160645945019
20180307,"PAYMENT RECEIVED",1280834804,0,aa56749e0c755bec954d566d86824c315866e513dd277bca9d5694897808a3de,159389416217
20180307,"PAYMENT RECEIVED",1270533251,0,0ac6b6ff8e4ab318e3a67c7c978bfab222b9d29484a5fa8a3259284e854b1a75,158108581413
20180307,"PAYMENT RECEIVED",1284567513,0,11254622af23022aeeea4b8d9f6e8e8ddffc390149c75c4b6944ea32ad4a4d42,156838048162
20180307,"PAYMENT RECEIVED",1262407808,0,8b9e08d6dc63816ab33e03ad22bbb4e8c5829696eb795f0623e7c790ca01f40a,155553480649
20180307,"PAYMENT RECEIVED",1276721454,0,ba56b1c4eaae2a96c74f4e8db463f5ce2e575a579c69765a54b3b28121c422b2,154291072841
20180307,"PAYMENT RECEIVED",1269433137,0,95531947c48164272a63e592226bb33ffb60e5e77206a6a16d34fc3b195832b7,153014351387
20180307,"PAYMENT RECEIVED",1280169431,0,9b4afbfb1910461f793cfee91fbc9cfdfefdcd9287b1a229940e94aac72fb6bf,151744918250
20180307,"PAYMENT RECEIVED",1260993056,0,0a5d242cca5269302169ddf8e7ca20dd16d35d4deed6cbc8d01b4ce88ff6318e,150464748819
20180307,"PAYMENT RECEIVED",1345979936,0,3e97471a0f82b3e4cc3dc6e19a6464fd1f89e4854d8697c74bb8125aabe6a68a,149203755763
20180307,"PAYMENT RECEIVED",1270564731,0,ad3309dbb009397efb16dc088711cdd5939e210aaa99591f40144457aa5cfdcc,147857775827
20180307,"PAYMENT RECEIVED",1275927148,0,7656f262d0417cf5f778c324cbff73d576a0e3c08b87c3fb5e26fcc74894c1ff,146587211096
20180307,"PAYMENT RECEIVED",1267423213,0,4a4c349be67d105261430340d47c706aec3eacbce194e7d51573df6b9ece3132,145311283948
20180307,"PAYMENT RECEIVED",1252491446,0,12d84e963e866749ff700b0dbd044275fa1268a3f663f5aa783a4fe9b05698e9,144043860735
20180307,"PAYMENT RECEIVED",1250561319,0,727a4a87216c94408eba665b9e050fc447e9c7e5db60f8870c4aed075ff53745,142791369289
20180307,"PAYMENT RECEIVED",1276381322,0,e48958172d866b30371cdf3b4cdda04b95f11ed3e1518add3f3781f2b075ad0a,141540807970
20180306,"PAYMENT RECEIVED",1259189590,0,06e6dddea17d4c3377264c7b0714a1707e7c07a64def20c1e065c574162e18fe,140264426648
20180306,"PAYMENT RECEIVED",1257185719,0,6bc8bdd4d93598c8d0f091d265a7b4d2fc23023deb72783e5047c3df47029351,139005237058
20180306,"PAYMENT RECEIVED",1268647357,0,28b8217f604d53bd639c7415f0efe515fd232054fd3c56d09f079861d95571b0,137748051339
20180306,"PAYMENT RECEIVED",1270796815,0,d37ba090137890866e6337e954137db0ff0bd216afaf3dcdbf60046e6b983764,136479403982
20180306,"PAYMENT RECEIVED",1261777671,0,68bc05a9db1a920a7c3ef327df304ba8e1d112c8a9c4bf76bdd0c6c0a1d13b5e,135208607167
20180306,"PAYMENT RECEIVED",1296038692,0,0f069058176b272e44bbe9a8a5e432f7518e8dfaf7e3615e25546c055ebc430b,133946829496
20180306,"PAYMENT RECEIVED",1296546097,0,71e9f8cc7672ce7191de5fd78f1dd12b410361635523e98220f6cc59ce737ba6,132650790804
20180306,"PAYMENT RECEIVED",1277528616,0,8cec4210a2fc7345ca9263671083ad2044cbf98e1e72399df2b6ccaf5a28b3cd,131354244707
20180306,"PAYMENT RECEIVED",1254575583,0,7802069cf431217123c2568153bcb17574fcfb681a0b6eba121c0ceddee17f7f,130076716091
20180306,"PAYMENT RECEIVED",1303991131,0,0ea915be86c2d195c4c258f06a6ffafa564efe0aba944ee561398e262cca18c2,128822140508
20180306,"PAYMENT RECEIVED",1256654960,0,64bb0387b48337e472b28001e982e56c7afcdb3ad10c837ac20525f229098ff4,127518149377
20180306,"PAYMENT RECEIVED",1272248193,0,bc1a0d225d9ebb3362dc9b4db02aa52bf192e8a78fb971c996ca21c92f756958,126261494417
20180306,"PAYMENT RECEIVED",1329633456,0,837b0f69ee3afb51abdfd339a7784432348a2191475a52c3f2f6e237ebdddb66,124989246224
20180306,"PAYMENT RECEIVED",1321154914,0,99c0530b70f117d0e61a512d5ed63481c200c3021be740e0ad226ea2daf25733,123659612768
20180306,"PAYMENT RECEIVED",1293681839,0,b7310cbddcef29352bd3dbb935cbd4f50d75793568ea429630cce4b250ab3d85,122338457854
20180306,"PAYMENT RECEIVED",1275857142,0,42acf5ee549269049e95b37e7d2c8f743157d0c16db1e983c4f6893fcd41a3da,121044776015
20180306,"PAYMENT RECEIVED",1254778851,0,ba924c980b3b702e0c09397ac97fa28071a52e8b96be3c9022bdb90a645fc6bb,119768918873
20180306,"PAYMENT RECEIVED",1258896873,0,ca7ee5243e1aac1d3d433a5ca708abeec7b9ef463648eed84782bb68a0b3c42d,118514140022
20180306,"PAYMENT RECEIVED",1265014597,0,5a898a8e9a3f6a6976578817b1798b3a993caaf2ac6732ac05c29aa19b887145,117255243149
20180306,"PAYMENT RECEIVED",1266038701,0,54eb68a904da7a6f4fe3024714483d8873fbe9d83fb1c471b9ee05e2a0b903d4,115990228552
20180306,"PAYMENT RECEIVED",1268903633,0,b1f8a0ca3e49236b0c24e5dd1a5707553aa76df74a0c757745547d8cd39663ee,114724189851
20180306,"PAYMENT RECEIVED",1287577768,0,4360e6528731614886f5d815c0040eb85cb5bbbd0b89cfc947bdb61423f427e7,113455286218
20180306,"PAYMENT RECEIVED",1255647050,0,1c040010cd1db5ff31dc47cf31567c97951e6eb95444cc0402b6c16483902d67,112167708450
20180306,"PAYMENT RECEIVED",1265894415,0,5d26408b18f7e36b758fc037deae00318b5bb905a1cfb0feae1d6c82d84d7572,110912061400
20180306,"PAYMENT RECEIVED",1258369663,0,b4faf662d76458e73a22c6e188839f819a49ecd1df71f5d3ad1d3a41cbe63847,109646166985
20180306,"PAYMENT RECEIVED",1261293722,0,ce2aec5c3b60d6ac99ff48c1c20b3dcf03a73e10ec5f08c1dcde2b052bb46153,108387797322
20180306,"PAYMENT RECEIVED",1260528946,0,fd6d3761dbd02d115c3bdf8c7a0d54b74becfe02be86f8fcc408ebe3c88cface,107126503600
20180306,"PAYMENT RECEIVED",1262044801,0,8b96511e4a9140048a7955caddc569902bc2d2f94ea8886b63cc5b612bf52c7f,105865974654
20180306,"PAYMENT RECEIVED",1272699972,0,8aa538f339703f01cf0b0d1e12b7ee720bb813e48df35edfc85d6bc8e48c20d2,104603929853
20180305,"PAYMENT RECEIVED",1265122213,0,32cf7a9e7a8b38bc1ab80279980619dbbd3584758bf3910b6e7def8eedfe35b5,103331229881
20180305,"PAYMENT RECEIVED",1263140429,0,462774c2c2412b9b8253f6e02a38782a720195b2a980e2f881d704bc32460516,102066107668
20180305,"PAYMENT RECEIVED",1288229663,0,fbc9517f6166555e5032c921d35c0c86d647f97bb28159491c4e45e093b68db1,100802967239
20180305,"PAYMENT RECEIVED",1276194603,0,203327cc83eacf626c957fff2552795ebf5b78f7d4215d7bfe19950750299db4,99514737576
20180305,"PAYMENT RECEIVED",1728662598,0,ca84e55d7e4b416ab142d84ab737b350bc30e9df314a16f11a7f4aea081e85aa,98238542973
20180305,"PAYMENT RECEIVED",1259868614,0,9259d2c9ebcdf869b44696ca92f8d15a08525ce2a7b5fcee41d966b4b3ea90ce,96509880375
20180305,"PAYMENT RECEIVED",1287527984,0,d195d0da02ba0b7a5c5ef1b81147b0c877551d60012d5e7df2a7456e1ba63b9e,95250011761
20180305,"PAYMENT RECEIVED",1254213878,0,810c022a916c13c2d4a3c8c8e7187e1525291668ec128009aab8d90060185511,93962483777
20180305,"PAYMENT RECEIVED",1260887396,0,c5b245cbfce25e852b6fb30db56485caa970ec2511291ec835f4111f8dd0c0a6,92708269899
20180305,"PAYMENT RECEIVED",1283592350,0,4259e8efd85f96b59cf67d8142d67d000e7e039642043a4a34a9bc0a7ba2e6e0,91447382503
20180305,"PAYMENT RECEIVED",1271079242,0,f27cdd9e81ce17a500b69f4364136746fb9e1612501795ba703a9db91e7738d7,90163790153
20180305,"PAYMENT RECEIVED",1252840388,0,913c412b3a1230f14867c00ea5ed5e76cc7edaa1b5c74f77294ff294fcbb93b3,88892710911
20180305,"PAYMENT RECEIVED",1294295555,0,dfabc7060982b90bf2879ee6123ee9b9cb807ea11707fc6b43df62076e5d3ba7,87639870523
20180305,"PAYMENT RECEIVED",1254500666,0,b50472d99a8e78590985d7aceb21ab76bf672b7aee664560d250b8f110529da5,86345574968
20180305,"PAYMENT RECEIVED",1258147413,0,0909740c08bfbb355e5ce0a6e19e5b62821760af01339ab77d68e1bf7e3bbb26,85091074302
20180305,"PAYMENT RECEIVED",1262388435,0,7a3489683d6877dedfc69ffa2150519d91866b0eed057c4897ee68aad2078a71,83832926889
20180305,"PAYMENT RECEIVED",1256258549,0,baa2e237f7d03c0cb6589f3664cda57bc203a53ef9c1dbedaf20cfdad0924e26,82570538454
20180304,"PAYMENT RECEIVED",1267310925,0,aaaebccce7397dd3c81c7855ee6dc45dfb3864883fc72070fa01544446c3d7bf,81314279905
20180304,"PAYMENT RECEIVED",1255486262,0,653fdb40ef688b9420bb02b47586dc08a3645d06da27de7fc5d7bdb9b38b90b6,80046968980
20180304,"PAYMENT RECEIVED",1259123791,0,e34f001ffcf819cdd7e79cb78f5f9e6017aaf65660cd3fa23dfbf2add381d9d4,78791482718
20180304,"PAYMENT RECEIVED",1254228021,0,3e666a7b365eea0af4e52d2fe894f52dd77e86608c86845840351417808bbb0e,77532358927
20180304,"PAYMENT RECEIVED",1253697803,0,2a8ea480c2c9d25cc4318ef188e6c832970a2ff4296f52fb47a0ccb09f0f4d47,76278130906
20180304,"PAYMENT RECEIVED",1264848750,0,9f2e465d750621fc3e51070eb4e29d99112aaa57b05df2f40dc1a0f0b9d37e4e,75024433103
20180304,"PAYMENT RECEIVED",1277770042,0,89b2794c824f29f44dcf198e4f9898ec8b53df46a7cd62ee0f88065192c6232f,73759584353
20180304,"PAYMENT RECEIVED",1259202754,0,c4cf6acbeb8f6dd0391bd00d2beb6338ed911d48e0a203730b251a970ea41556,72481814311
20180304,"PAYMENT RECEIVED",1271040267,0,fac0f64edef5fb6aacec1b61bd33ac630990b9c6e1ac1e9a18596867821e3b81,71222611557
20180304,"PAYMENT RECEIVED",1272169402,0,8c2da820d7d1633dee8d31d9da6380ac0a1be935661cb661875714119197aeba,69951571290
20180304,"PAYMENT RECEIVED",1264041609,0,f7a6c781e59e07c1fac12ac89ed70ad7cead1f7b1395c21cdc9c8e3c977cb354,68679401888
20180304,"PAYMENT RECEIVED",1284086532,0,02bba607bfdc37675eb1fb667d5b60773bc0d26464e4e71e317f6fcc8c5de3ce,67415360279
20180304,"PAYMENT RECEIVED",1257113973,0,b7c78abdbb8824c24eff4deb2e1414e773ea2dc0247862c18526b2ad7bd3829d,66131273747
20180304,"PAYMENT RECEIVED",1302501651,0,ff54c20b9e1cef5d1d92547d97a111f9f5833b0c8a7693e4518c9693847afed7,64874159774
20180304,"PAYMENT RECEIVED",1266475029,0,f0ceac1750d6901d469770f335f246923381cd50c669e8834a774dd297df72b2,63571658123
20180304,"PAYMENT RECEIVED",1276988998,0,facbf6d13964e5a830014d030ca6dad889a5d75080f45138300bd6f1eaa7c863,62305183094
20180304,"PAYMENT RECEIVED",1253533097,0,eae789dd7f89283671899bd41d9762e4696f2ec4ca6c628b8b0a791742b9bd1b,61028194096
20180304,"PAYMENT RECEIVED",1270186530,0,80f426bddb48e1ff06b30e0d0d7b68aa0ba1be838db274bf8d4e8eb49fbc6abb,59774660999
20180304,"PAYMENT RECEIVED",1277125769,0,d9c04d5ffaf7f6dfd8fe92dddf9925573971fb0e0e46525c616aa933f6f76492,58504474469
20180304,"PAYMENT RECEIVED",1271517567,0,b3ea2b81c1d7acf1fbab57e22f89b36c0f8f89711416019d535e4c55d4c66b7e,57227348700
20180304,"PAYMENT RECEIVED",1272815445,0,de6d3722bfd3432c0879a905a2c83771296ff1da09098183dd05dc7bb3e56f01,55955831133
20180304,"PAYMENT RECEIVED",1268039863,0,432ab5d7917ea4a1c610107804b60dfd042e65e8b9b0df4a1929545147b49e66,54683015688
20180304,"PAYMENT RECEIVED",1304739834,0,b6c6791b1c0f8dc56660421fb222f4c9cc60bcf90f4739401bbbb12788264d85,53414975825
20180304,"PAYMENT RECEIVED",1261415775,0,8d05c15241ab611abc55f5e460e27554118828ae31294ddef5094bd4f4638099,52110235991
20180304,"PAYMENT RECEIVED",1260662267,0,c0d34eac8a9e3af29b435c0d5946921e58b6ceb60cf7cce861638ad65131c198,50848820216
20180304,"PAYMENT RECEIVED",1275566447,0,a71511c160cc3bf6ee9cae8957bf9bb1723f3248512fe2b9cbb30cba6bbd9f17,146686185616
20180304,"PAYMENT SENT",0,-97098027667,be93fa9538dc0995940436bc6d9160fe34bcc7574efc6ac736d00273657326d8,49588157949
20180304,"PAYMENT RECEIVED",1292114998,0,ee4e39be25e44083133317b812663ded352355822e02c8f75d224a9d3dc39ba6,145410619169
20180304,"PAYMENT RECEIVED",1263520790,0,4f38a1a246a20291b964fa04c3e8968b763cec2a7a4b1ce589a79b66e8290b15,144118504171
20180304,"PAYMENT RECEIVED",1267224587,0,8ebed3f8da3d3f1ab0370fac660f3d680733ccf1731137b24efabc329c370655,142854983381
20180303,"PAYMENT RECEIVED",1280659636,0,26da66d05f47a3151c56bdf7d65b42c4bd28bba6fffc940044c95910917224ff,141587758794
20180303,"PAYMENT RECEIVED",1270700861,0,9788fed537bff38fbbd6201d6993c9d13ad0397634ff2f3ce5505b2bd12b6264,140307099158
20180303,"PAYMENT RECEIVED",1275755132,0,1238eee0826047301e8303de2bec233fe5744af64b69b848f967c27c340cbee1,139036398297
20180303,"PAYMENT RECEIVED",1280387623,0,ee476cd95b5630708c51dcd36226c47740f84da946725d344518912242dde04f,137760643165
20180303,"PAYMENT RECEIVED",1283282883,0,a1bbc67404cb229280777f2691e5d6ec05d99b83eabe3d4595648988dd08d0ba,136480255542
20180303,"PAYMENT RECEIVED",1295934704,0,1317573cf198a9e3b2bed0995395fa6e8c02acde990ab6348d7a236f277cc99d,135196972659
20180303,"PAYMENT RECEIVED",1279298649,0,456bc5790719fdd6c229ae1e887807ea0e999bcedbcc597e23ca685d516911e4,133901037955
20180303,"PAYMENT RECEIVED",1336793832,0,ac0373e8a86c0a0bb6cba86b141cf332e343f24da2aef29396ebece76d39b3a4,132621739306
20180303,"PAYMENT RECEIVED",1265595468,0,5953c7718cd346116486ff089ba9b36a09a064507d472c98e7e1791776bf9994,131284945474
20180303,"PAYMENT RECEIVED",1266034181,0,81153787db91a4f9d9578efa1d205a13a42f8da4545aac9a9947dd14ea86af81,130019350006
20180303,"PAYMENT RECEIVED",1252838145,0,2eb5cc16be9389d869f678f00dd3d5fecdcafa0d27eff3613b95d5deef7a7036,128753315825
20180303,"PAYMENT RECEIVED",1258134492,0,088963b81c880ed36374b6065d179e777b8145b155c54372875765cb07694691,127500477680
20180303,"PAYMENT RECEIVED",1260126907,0,0f2ab614ea453728e62cf15d5bed941f93309961bc7ad9fc3970d3cda05ed6b0,126242343188
20180303,"PAYMENT RECEIVED",1265799052,0,6c8ebe9debcec1214d038ad5ea3103046621753b98ca41e7cef7cc82555419ab,124982216281
20180303,"PAYMENT RECEIVED",1257874690,0,10461cd683b82d0cf2991d84c595bc6ca8251d45f57be20fd84dade1fe27ec38,123716417229
20180303,"PAYMENT RECEIVED",1256480846,0,60a58822fd900d785f633cc90a8ea6d576d320c160c5da80dbdd6aaed5ece9e7,122458542539
20180303,"PAYMENT RECEIVED",1278810763,0,a5efd54afbccef7a613d4343b957911e656481291c830e448b1cf04166a6ff8c,121202061693
20180303,"PAYMENT RECEIVED",1274800298,0,77f1629d9927b51db359ab43a27488e68eb7acebcd38485fe247082772666b23,119923250930
20180303,"PAYMENT RECEIVED",1301221294,0,ca8e3a3d3a130b3b7205994604837099b3310591996fdd6ad7c625f56f0ce1e0,118648450632
20180303,"PAYMENT RECEIVED",1289972833,0,8c6030b2c5405604fe00e52818d83921dfa63bd365ad74af2792b24197d0bcff,117347229338
20180303,"PAYMENT RECEIVED",1270712485,0,6236df7b84f33613bdab216aa9dca8394a46eab9680fc3b1c83957d297375401,116057256505
20180302,"PAYMENT RECEIVED",1277016850,0,33b0b293e7c7758799b55803189e07639173a56b396f46193f317767139a2aaa,114786544020
20180302,"PAYMENT RECEIVED",1261787809,0,760d0cb6b20428d62eed0fd76a6e51b6c2c170668d07e81e57a76073044308d9,113509527170
20180302,"PAYMENT RECEIVED",1300873067,0,56dbe062fb64c0331f3f3ab764ae18ef3bb850f6315cc162b9f9cde70133fce9,112247739361
20180302,"PAYMENT RECEIVED",1264023260,0,08a9d07dfc3ad812bff0e2d2c8410e5a2511f52fb8b384cbd670e99189d8ffd3,110946866294
20180302,"PAYMENT RECEIVED",1304520190,0,3aa68e34e1f682d80363e10bfaa88067c7f2586208ccc0eace45cad4b3245c25,109682843034
20180302,"PAYMENT RECEIVED",1301331208,0,c220e81008fb81ab73f373645aaaab7a47a13644ac4a5f513e69575e120cb913,108378322844
20180302,"PAYMENT RECEIVED",1309204540,0,8a222fc37a44f55f567b09847a4d10afff324a8ae8b79d00879be2a144bb8936,107076991636
20180302,"PAYMENT RECEIVED",1310126003,0,b536641c3f061ad6f9bbf2e41787c5343c9d937ed31392dcd6553b26cc55b571,105767787096
20180302,"PAYMENT RECEIVED",1274434362,0,6b3172f453f834d4f087702b97722efc738c1e369602c81fb39c70eee4ce929a,104457661093
20180302,"PAYMENT RECEIVED",1250018375,0,94711e620731b757ff4739f9a8838f5c2ff6421bcfc26a0768731298e8865949,103183226731
20180302,"PAYMENT RECEIVED",1252783436,0,e28f93e6adf409f18796cce514b6790c5e9e7825676fecea8c5c109b0c202f0f,101933208356
20180302,"PAYMENT RECEIVED",1263100982,0,02c8afa056ffa138b7849015c59ff2faf9f8969507d1e5df6fafe927e62dca91,100680424920
20180302,"PAYMENT RECEIVED",1268173919,0,5c3928e0748d8509b22a0151b8995f9506d8a037c8e1beaa803ad078f59b27aa,99417323938
20180302,"PAYMENT RECEIVED",1279952510,0,431827aeec65093c7401d3d576e13a04a64aef945aa3fac5d32c4205b5166463,98149150019
20180302,"PAYMENT RECEIVED",1267996907,0,ff464ddd88670972f7ac698c48ff09cee015907fcedff5fc0c08d8281f9ae84b,96869197509
20180302,"PAYMENT RECEIVED",1250000000,0,92af0ac95b9b80523f16196c175d5458d63890e52c536e2152c2e4e3d14b6230,95601200602
20180302,"PAYMENT RECEIVED",1306833212,0,4de2aa8a8a9e186053821764a093e44f4fbfe2a7e053fc8aff37132962a5cd43,94351200602
20180302,"PAYMENT RECEIVED",1250652477,0,9cd836ec18cfcb8d153ed9c805fed8a45cc172c85dca9783cabb176f439a52b3,93044367390
20180302,"PAYMENT RECEIVED",1329320173,0,6330ae968c652b161196d279b6b81cd2cc0ca598204e6abe34e719f9c019c7dd,91793714913
20180302,"PAYMENT RECEIVED",1268669858,0,ceada1588491f3e8db8b52f004a64cbe98102678d8ba3116f1513b64ce774365,90464394740
20180302,"PAYMENT RECEIVED",1262999845,0,f029ca3f0261d8f3cb11c89663193bf94ed06c255d0b1ca295e6963764145b8b,89195724882
20180302,"PAYMENT RECEIVED",1324993568,0,bd66fe633f473f4cc6c4badc525440e7352250b917da15c6dd9b4d1bbeabd110,87932725037
20180302,"PAYMENT RECEIVED",1250939624,0,5154a5dcb494e0bfb3e95320185bbb6c72f2e67a42b2a544664ec3a5dd7cc92f,86607731469
20180302,"PAYMENT RECEIVED",1289607229,0,430cad67d5be6b1ad4fb84d5c4c00645a846bf12758fbe80f8e1b7c16b2de1f3,85356791845
20180301,"PAYMENT RECEIVED",1253193039,0,dfa7538b76f45b4fe2c0a1718d30a4031cbfbcfe0d919204381a886e5cb3bad0,84067184616
20180301,"PAYMENT RECEIVED",1252204376,0,46281cdabd5c8c237541226a069c959ba5c93b51f0a2a3b13ae015216a6905a0,82813991577
20180301,"PAYMENT RECEIVED",1302901036,0,52797fd7376db365090e51e7cfee1edf6f6a6551dee8dbaed28e35e652fea9ec,81561787201
20180301,"PAYMENT RECEIVED",1279418310,0,205a33d8cc530c70fcc7f8abc41401f8a8d372d4251cde8678cfe6d30c3b1e71,80258886165
20180301,"PAYMENT RECEIVED",1320698415,0,caa1a3213acc9e4f43af981e63d093507dcbf02079766514690e2ee25a5e4ed6,78979467855
20180301,"PAYMENT RECEIVED",1281847877,0,5bddd0f5f607a9dcbfb0d11e8c579b9f2fea69c0d86853ee9de659efb3258171,77658769440
20180301,"PAYMENT RECEIVED",1251652883,0,0cf4ed841a49bcca1d7c08c375f294a68bfd04d36906ee8bdff6f5587105812d,76376921563
20180301,"PAYMENT RECEIVED",1269974907,0,03de287fb27822410b35e3e4d373da8d952474049a8486c1b89e758946c8ae8b,75125268680
20180301,"PAYMENT RECEIVED",1314746358,0,9fe89d85e5c54b5c96a56d54d8d3da5a3ad0af006ccefb0ceedb604e5753688c,73855293773
20180301,"PAYMENT RECEIVED",1256450190,0,1eb8a7fbd2b1769fe36d22af38e44253cbf3be34405fdb5ffd4b425582f48321,72540547415
20180301,"PAYMENT RECEIVED",1259501792,0,a4ea9125541d4af5689bf580612e28f9b3e7a8ac962660cb6131db330a041131,71284097225
20180301,"PAYMENT RECEIVED",1270155778,0,a8c31d1d889995efd2d96c2cd2e430749b7dd1e43bc5b589f7c99a0075f1c037,70024595433
20180301,"PAYMENT RECEIVED",1290899106,0,dc88801b4755c5701f4ff153fbfbb2f2cf0e9cd0fde6e6825b26c2f6d2034cda,68754439655
20180301,"PAYMENT RECEIVED",1264531544,0,57597a881aea1778161167449703e24f54510996a1833566072fcc5a1179ac35,67463540549
20180301,"PAYMENT RECEIVED",1315022126,0,4c247a6942c515855eb9497e19e00d86b5f5acd6438d57a7141954cec43b6f5f,66199009005
20180301,"PAYMENT RECEIVED",1264963747,0,cfdde7fe3301f8f21377eb74fc3d6e36a51bea0463dba1dd1cf41ab5398b9e24,64883986879
20180301,"PAYMENT RECEIVED",1270176171,0,ec22493f1da7ab638b62b5e905f758887e5854819fd7cd654b31abcaf4f26613,63619023132
20180301,"PAYMENT RECEIVED",1267955325,0,ddcd33443b34128c01e2ae0784751899bb970f053d202dd2410fcabff66ce238,62348846961
20180301,"PAYMENT RECEIVED",1274371691,0,c0d03976568efcc9e723c51934d68087478ff9806fb9484566f2dc7088153099,61080891636
20180301,"PAYMENT RECEIVED",1260008153,0,b13f576f5d59b91d326f254333b1aa074e9727363bab7265f682834a5b01d01c,59806519945
20180301,"PAYMENT RECEIVED",1280700351,0,16c354bb853333cabbf4b809961e7b894c6f2b6e41dc2ea4a369f1c6f9b1992e,58546511792
20180301,"PAYMENT RECEIVED",1270955496,0,48946b51fdbb91a9defc778846004b006496fb5da9929caa4b3ba8d5dd6ce942,57265811441
20180301,"PAYMENT RECEIVED",1291812728,0,fb851c74e3581cadcd8a8154ababd1346e7908f6737259020164cf1d0f0a743c,55994855945
20180301,"PAYMENT RECEIVED",1272132248,0,2dc14fbf844cb4c9cf618e98c3cd4515725251737e1bd49221b6642ff701ed1a,149104357512
20180301,"PAYMENT SENT",0,-94401314295,7ee879ff2c0232d3b8fa65b2fd1fad81bb739af3c2ab4e42a5d096db0a57f737,54703043217
20180301,"PAYMENT RECEIVED",1270634672,0,b5fe42ae64247b3af1dc540dab0cd6cc6068660f3caf4cd2bda0d5689d5a71a9,147832225264
20180301,"PAYMENT RECEIVED",1270240618,0,243cf4fa6884e02d2c7df3c0847c61d5526e633c9db27178440ebbeffb98ea6d,146561590592
20180301,"PAYMENT RECEIVED",1280337624,0,0846d672eaa1ee91361bc78633799ab7d45e7884bb47c3df3cf6c8df64dadf19,145291349974
20180301,"PAYMENT RECEIVED",1277027270,0,0347f3de3d72d2d3d43c070eaf24ea8b0858b3982394a78f4e938b189ecded6d,144011012350
20180301,"PAYMENT RECEIVED",1275844709,0,82884279aa201d3e9c53acd9f1024edb258e52476514b23e6a34fdbbe709f0c0,142733985080
20180301,"PAYMENT RECEIVED",1302492675,0,251cf0bbed14bf33a12a59cf003b67ccd14ec2c6714885edc97f32fca6ce96de,141458140371
20180301,"PAYMENT RECEIVED",1298086982,0,1092957e9f46fe63247fceb7d9151ed91a101b26e4092c0a9469882fe1b442d3,140155647696
20180228,"PAYMENT RECEIVED",1280739557,0,35790d74ead88728dd288fdc0db56ae8b9b95d5f85322047b7b66f6d42eea58e,138857560714
20180228,"PAYMENT RECEIVED",1277192071,0,b5ad28035ddd2e588e9954f14aeafc888c14c0bbba598c74db3e360701e53268,137576821157
20180228,"PAYMENT RECEIVED",1281575872,0,ca932d62dd7b819b6ea6fa3b0149f1234f780c037fdd6679e10163212479be94,136299629086
20180228,"PAYMENT RECEIVED",1294167493,0,f43a2abd5b3bc9b1c3419f28d812daa1b5c8c7f0437a3b528190c6a016313c21,135018053214
20180228,"PAYMENT RECEIVED",1270409157,0,c86e9b7a6ce345369f2c01de47ad8a152b1a838df1311ea7c2190e747370fca7,133723885721
20180228,"PAYMENT RECEIVED",1282706492,0,cbc50fcaab5cc775b1d16f0a4afc402becad5535c4613a67f89223a0404238cc,132453476564
20180228,"PAYMENT RECEIVED",1306976018,0,b7579a39090f8a217f16a3e883c0fe309054be50bf4e7f7cca1c49a7c3611613,131170770072
20180228,"PAYMENT RECEIVED",1263034032,0,067e6c7ba494f86e48d95d77098741f508f787d1be7e34c2c8c3740b9b0baf30,129863794054
20180228,"PAYMENT RECEIVED",1310667639,0,a6b118020a28cdc20fdd213a52cf57958d5f9d0e5ef87d966e827823cdd41e84,128600760022
20180228,"PAYMENT RECEIVED",1279791878,0,aa0d4ca236d70de5b33b368ab18df34046fa53bf155e383fee9d5e703d147207,127290092383
20180228,"PAYMENT RECEIVED",1262316880,0,7e460ab586971195ae0d92a0cfebd6ba1ee9a850dda40186449c4996165ed784,126010300505
20180228,"PAYMENT RECEIVED",1277401803,0,4624ef0a9fd63c40ca6f789ad34eee5f1ac92a23490596192f7a7286c51a2cd7,124747983625
20180228,"PAYMENT RECEIVED",1295840018,0,0e281946364be053bee0d82fb49e94f0353d25c9106896cb8ccfa0308e76bf6c,123470581822
20180228,"PAYMENT RECEIVED",1269199701,0,61236be3d00f1b832206870685f575eb688992a599af0edabe1fb49c69119a4c,122174741804
20180228,"PAYMENT RECEIVED",1265822483,0,ec6642941e3fb47c6ce28c45577f27e66ea75844f4bcb1488cc15a6e7ab70e53,120905542103
20180227,"PAYMENT RECEIVED",1282056305,0,2733101b95fa1942947d0177e68afce9175209b15b93c2d9a2753d976fa6eef9,119639719620
20180227,"PAYMENT RECEIVED",1274720340,0,e1bcc3635609937e3dc040c0e6b4048b6e3f68b2ed30a73436996cfb5ef02109,118357663315
20180227,"PAYMENT RECEIVED",1264214628,0,73d655146f4e9902fe5d988fbc69eb7161f3eb4e1dff59ecb9bae4dd344cd68c,117082942975
20180227,"PAYMENT RECEIVED",1261078984,0,56b4c67347e56dc630bbedeceb9fd1ef7cbf58f4c2f2ab77f74308c69165342d,115818728347
20180227,"PAYMENT RECEIVED",1275129410,0,9d4104038b3722f436cce34f618979a2c5ce879ac98d81d5b0dab6cd85532fd3,114557649363
20180227,"PAYMENT RECEIVED",1298664933,0,34e7987628f8eb2e7e0c8e7af3480488265dac62cb8cb8cd395c96a0df1b43e9,113282519953
20180227,"PAYMENT RECEIVED",1362148994,0,296109beee5624e8261d5e1ce42670549e19b9cdb8fb9caa8918b3d87318cda9,111983855020
20180227,"PAYMENT RECEIVED",1314721081,0,8e88d6a6b6abe9bc7d25134cdc3e8190d1742ffe2293eb641cec3c4b75927599,110621706026
20180227,"PAYMENT RECEIVED",1297593631,0,ebde5546ea3f5a9bbc7fef2c8bc71676f5cabd070030777cdc417b3677853211,109306984945
20180227,"PAYMENT RECEIVED",1260026714,0,838547f494f3a1b0c40be077af53772f432d8a4bc385dbf95430fee482081f53,108009391314
20180227,"PAYMENT RECEIVED",1278358756,0,d33d7e2b67aee817b132f8f82366a209d8599fd4b9ef4a799a0c5a80535159c7,106749364600
20180227,"PAYMENT RECEIVED",1312290151,0,f429fdb1bb766e05124f666e4f5389b837d685c60fe5195a05ec4969675ee299,105471005844
20180227,"PAYMENT RECEIVED",1266444720,0,3f10be0baa02adbbb8fe571c6f66ce70dcbcefca0e6bdcdff83bea676a16778e,104158715693
20180227,"PAYMENT RECEIVED",1263268035,0,73adff3c335ef4a71c3ff8cac85b10eadd6ba57cb381f353671530e1913263bb,102892270973
20180227,"PAYMENT RECEIVED",1293511313,0,2b727508df6227efc3dfdb2d566c97ceb7dbf2c132622e7a76fc945ca1022e82,101629002938
20180227,"PAYMENT RECEIVED",1252298764,0,38f560e378ea161438fffd513c95e14c630d1d1f2b97fecd2667e96090657e23,100335491625
20180227,"PAYMENT RECEIVED",1269197444,0,a4cfdbb441e514cc242c0052bb5d47f6989a5ac201afb326495bcca6363fb3bd,99083192861
20180227,"PAYMENT RECEIVED",1258852798,0,863b821577b6fcdb56fa4d4cc5b388908a3588ab23b82c68f1ce74534e0d62c2,97813995417
20180226,"PAYMENT RECEIVED",1263283901,0,d2015edb5933181b79b5defb9e5465a30918a5f1423415af01593e2bc5899a02,96555142619
20180226,"PAYMENT RECEIVED",1290645235,0,0df33734a36487efb129615de2b7ae2248db0022fe22c94101ab7fa0b548ec3b,95291858718
20180226,"PAYMENT RECEIVED",1275625768,0,70843cc4cd676f5191f2e8314b6dadac046c71fbfaa853893effa13ad13bf48b,94001213483
20180226,"PAYMENT RECEIVED",1308139545,0,8dcdfebeea2557f8e213d4122b06b62dcf7a8cefb288af918a3ca8e5dbffa00d,92725587715
20180226,"PAYMENT RECEIVED",1281059500,0,6ac2a61ea98601fa09209652923e51def931153e8eb13845779a6533fd64f21e,91417448170
20180226,"PAYMENT RECEIVED",1252983580,0,11095699a8a6a17b84a2df0d729e83dffc7c5a50513c63cbe4f33cac60cfe2bd,90136388670
20180226,"PAYMENT RECEIVED",1275849823,0,46579e5f0bdd32dd84001fe08dbf04eada5fd121d609e3f56846822fc5ec7b03,88883405090
20180226,"PAYMENT RECEIVED",1282499744,0,0c7838bb6023438572671a1869f3f09763a90a0d50e6746f04bf667177680ad0,87607555267
20180226,"PAYMENT RECEIVED",1257107365,0,c54a36bf0526a71aa9b707797310fc31da4fa1ade1c239684568b17bf5a684a0,86325055523
20180226,"PAYMENT RECEIVED",1265088104,0,3d1a331193b2565c119a7ec674f9939c583418c5b99b3f3bd291e6a1ae1312d1,85067948158
20180226,"PAYMENT RECEIVED",1273285473,0,d8a35259145076285052654f75c6285c652fdb346000ae2d9e349cf91654069f,83802860054
20180226,"PAYMENT RECEIVED",1253197234,0,f3e5db3ea435c0dcdee42f0297aaa7f6f4121089520014ea95c5f13495bf5369,82529574581
20180226,"PAYMENT RECEIVED",1288392971,0,a004f2b90c5a03784e1e664c8b3722a41a9c3adb174bcc1e2e1567df5101d74f,81276377347
20180226,"PAYMENT RECEIVED",1285818142,0,7104f330cc107122eadeb34875c039cdaff8a08c1565a64ee7a3bd76423aec48,79987984376
20180226,"PAYMENT RECEIVED",1253446871,0,f72ee970cd1e08b5db5c4febdfdce59971ae6a6c35ee6a9007fe097e870877a0,78702166234
20180225,"PAYMENT RECEIVED",1251601434,0,a9c65e966f1ef895dec3e85a1451d340f0da381c9de78d0f6f0df7bc3fb3678a,77448719363
20180225,"PAYMENT RECEIVED",1263672524,0,ac8ef0aa637098cb18ecd4aee7238348d90139c46fa7ff5092fe7ee9058902d2,76197117929
20180225,"PAYMENT RECEIVED",1292638087,0,0df34bc3170c79f42feb2b2c64b7cc53953b2a609bba68d428987d5e0c7899be,74933445405
20180225,"PAYMENT RECEIVED",1250766727,0,e0ced16a6c275c0de1c4b66e2b9c9bdbbf2cf2c46def846d6c9001ad522b1ffe,73640807318
20180225,"PAYMENT RECEIVED",1255074622,0,33c746a349832bdac4ca0cf1be7ea2b9a6c0d44c093f263c28683856cf520306,72390040591
20180225,"PAYMENT RECEIVED",1340359152,0,0cee9e84a4aefc3a00e6409533b53724f8246b720aae87e1c47d0e4ebe3edab9,71134965969
20180225,"PAYMENT RECEIVED",1267776300,0,686029e29044be2edae8866123b06aa8125bf861d974c364898b876726b7446f,69794606817
20180225,"PAYMENT RECEIVED",1267634334,0,ae5b4722c5a1bba415f200dc04976dc9eeff14d70cbed1d470d89422477c7916,68526830517
20180225,"PAYMENT RECEIVED",1263071716,0,06896e4d27e9c9029f26b274a0b077eba1518a952b2e247a6f63466e73ee3257,67259196183
20180225,"PAYMENT RECEIVED",1260976345,0,20cfc74e92e2ef17f4e2aad904bb048c763590ff735063706b211ae49c90d457,65996124467
20180225,"PAYMENT RECEIVED",1278663312,0,385612724c5b8f7567de79382ead25f8c2ccd6fe9593f89428c8305ad9bf7da6,64735148122
20180225,"PAYMENT RECEIVED",1288518907,0,cfb33467d4cb2c90ffd5f876006adcf6ec0d2052f013ceb68b8b6c0752d226e1,63456484810
20180225,"PAYMENT RECEIVED",1275422452,0,8759d40bf7d036ada7171b8aa38a65e82bdc4fb085bb3dee31ab93fba9e94654,62167965903
20180225,"PAYMENT RECEIVED",1259535271,0,9b0dec51461e84d0bab310d910e43c2bcc40e24960477e597b7ae698f3b33283,60892543451
20180225,"PAYMENT RECEIVED",1266526408,0,b2f84392a5223f4ac1f95129cff09b38d61a211e10bc75203cde9b41f56bc7e1,59633008180
20180225,"PAYMENT RECEIVED",1258179128,0,abf67f468eb2b808df50a7c31aca461ffc4f7df94fb3385ad540769908cc18f1,58366481772
20180225,"PAYMENT RECEIVED",1268884550,0,179c3548e115a3ad89d306beff3965072972d5e07a760a681d77883444640838,57108302644
20180225,"PAYMENT RECEIVED",1284626370,0,5e1bc0dcaa76618a1238439cc1c47c70a260a28fe150c74e6cd370d85ce092cd,55839418094
20180224,"PAYMENT RECEIVED",1266319403,0,3ab01b50143621f3ad2a0973df3b25b6c8f969704cd277145d4b6756b752639e,54554791724
20180224,"PAYMENT RECEIVED",1329675934,0,324471ca4de85b9d22a08caf6fa380ed26517ec9b365ab68e6d363472b818d44,53288472321
20180224,"PAYMENT RECEIVED",1266788641,0,c3356ad1e10cedf843713dc8322bbf820532363eb8350f9735f559b4f4cd08e7,51958796387
20180224,"PAYMENT RECEIVED",1262029964,0,4ff4505e502eed585b217eb7b0e33106a425e4fce8f43fb260c870fcc9fc5129,50692007746
20180224,"PAYMENT RECEIVED",1277737617,0,3b0935dde97f32f9461af745d3f168e98a3abe937cf93b4ab7403966bb208c50,49429977782
20180224,"PAYMENT RECEIVED",1261412155,0,7390012bc4b7f0d06c9557b76940a740bf04acc5f38409a1c41793dc4b2c63a1,48152240165
20180224,"PAYMENT RECEIVED",1311790889,0,3cc2cb8208ba069136954cdb278219faedc3e7af46ef574402d7b3e8dee221ca,46890828010
20180224,"PAYMENT RECEIVED",1259391149,0,0f6787cc0e508a694b3a78f61bc1618f8797a13cca2cc525e8b7a8a9ed0e8111,45579037121
20180224,"PAYMENT RECEIVED",1335733205,0,752161fe4bd1533dcaa4b051ed24525a21f6148df1aced63202e534d9b097e36,44319645972
20180224,"PAYMENT RECEIVED",1260671148,0,64f8cc79f0c6d63db3b0aebc2f9f5d999d5a3f7dfc35d3e7daaebbfc69f562c3,42983912767
20180224,"PAYMENT RECEIVED",1378563991,0,0b39b74e3c2b01fc1c270c208e0683227ba6553f5028d1809ff12f626c68f82c,41723241619
20180224,"PAYMENT RECEIVED",1312314302,0,c080ca76cbcc941bbcd027628dcb8a4c0c9799109700575143b59e249b82de78,40344677628
20180224,"PAYMENT RECEIVED",1417759359,0,50906e62ed2a3c004f4dc95516ea69848546dab385d45983d12071f6750d0a62,39032363326
20180224,"PAYMENT RECEIVED",1270485578,0,437d6bf02ca771f32e1fb949b3f2af7966e35bc59eaa56148a0c499d8ec84a32,37614603967
20180224,"PAYMENT RECEIVED",1320331849,0,3f53ea819c68b9c5c5027176408756dc06984f7674f6e36e1335d25a84b79171,36344118389
20180224,"PAYMENT RECEIVED",1351838765,0,6264b640744ac2b99d3e5edd48d49586f70e14ad2020b1da641c8cf2df17d3ef,35023786540
20180224,"PAYMENT RECEIVED",1280136189,0,134a0b0e060dd1cf5b27b6f059569624888c9f665dac94706acadd24b3b96fe7,33671947775
20180224,"PAYMENT RECEIVED",1331874209,0,29fef4f0b2d3782dedd9bac04c1c50949326c5f519c5f2f1ccef81336b5403a2,32391811586
20180224,"PAYMENT RECEIVED",1265553386,0,85963d08791afb603fa3debdc88e4e8d7a9f14bd9d58eb318561012af138e42d,31059937377
20180224,"PAYMENT RECEIVED",1307019333,0,ee3f18f3fa434503b64e5c19711b20d7b98f299a65d133422831043a14c8a2ec,29794383991
20180224,"PAYMENT RECEIVED",1350311614,0,ec42343705a48bd0b224e717e16d66ab3ea8207fe6d61f9ad0162ab6ec1ca037,28487364658
20180224,"PAYMENT RECEIVED",1339093994,0,c300fde5a0f62ee48cee51ae228ccc816ebcbddfd1d9c71502eef3a5f9e795c6,27137053044
20180224,"PAYMENT SENT",0,-37556590522,61ce789be685a64b52a2e95c2fa706284d2b9459b815cce14eb775b44baec027,25797959050
20180223,"PAYMENT RECEIVED",1270282397,0,f528b1ef6b6ba75994f2986749903cf202687f2c78caff4a5ce76256da09294d,63354549572
20180223,"PAYMENT RECEIVED",1253510354,0,f7564a91500de0eb73334ec38e59d3f4d584fd3500f2027f5835a47a876bf4fa,62084267175
20180223,"PAYMENT RECEIVED",1253062083,0,c95668eab59c031707505ef9d5b93d467a897f88d5039cfa9eedb32458ead137,60830756821
20180223,"PAYMENT RECEIVED",1262385185,0,7d1753233637e827b47eaf9239af0fdbd3cc5065d0ea14b650cd7d756c38cbbc,59577694738
20180223,"PAYMENT RECEIVED",1288169751,0,59e3adca32b44bfa767291479a15d682bb4495eac882ceeefde01c467fa4e827,58315309553
20180223,"PAYMENT RECEIVED",1281646461,0,f823c09ef3794758d8057d525c9eae0275092c78a3eae9eb9a7b774f7c02e188,57027139802
20180223,"PAYMENT RECEIVED",1304878345,0,fe20e8be510e126b816a7ac91d8bd009750d9120f33227c02b239aadcc2f84f1,55745493341
20180223,"PAYMENT RECEIVED",1272523426,0,4462d214cdbf16a3cd4d120df2977b532a7862444acac71b580e4634f75a8533,54440614996
20180223,"PAYMENT RECEIVED",1290115125,0,4c69ff7da8b93b3276269724174373c43ea796dd6e333861594e4f011b998cb7,53168091570
20180223,"PAYMENT RECEIVED",1334195688,0,9285f0ced42b6b7320697b09f51c166e08a85503ec4cb456fb9eaca8e686bd83,51877976445
20180223,"PAYMENT RECEIVED",1346965245,0,0e10549bd0921d7837c021d72de5b1108e0a54acf9d6eea789524740709d215a,50543780757
20180223,"PAYMENT RECEIVED",1320434416,0,e34e3dae202f521b9a8c4ee89c38911efdafd81c59ac7c1ad2f8e66e740f4c7c,49196815512
20180223,"PAYMENT RECEIVED",1270223672,0,eeda56e4e116abe34037aa0bf302836115e1a352bb99b7c4ab709e467443916f,47876381096
20180223,"PAYMENT RECEIVED",1280182377,0,c76a8c0f9a0a75c2a6fbfd7d32404400126b45b02c606ba2005f851515467604,46606157424
20180223,"PAYMENT RECEIVED",1315124585,0,7f44937b6d9900bc3af8da0323b3104acae52131be51afd8fac1e915f706ba71,45325975047
20180223,"PAYMENT RECEIVED",1371315506,0,51f92112480e2c3540d72d32ede0c009dfbc128656e459611a33c64089bd0d59,44010850462
20180223,"PAYMENT RECEIVED",1376172802,0,de3db379d335918709c1a24edca28027c53968aa1582ed920a93451b2efd48e9,42639534956
20180223,"PAYMENT RECEIVED",1371287189,0,498dcc513a7e8b9e45bd8e33ca6d50dd56e9f43bd0f988a1d339228553970eaa,41263362154
20180223,"PAYMENT RECEIVED",1366442416,0,c55c8c0a238bdcfb90af954d313555add640a95b3f8ba2141eed2cd852e482ad,39892074965
20180223,"PAYMENT RECEIVED",1361506022,0,e6b6d0686da76a96b03140a686f3e60c831ab315bdb30f55413569c0c6d3cd58,38525632549
20180223,"PAYMENT RECEIVED",1361179686,0,ee1ca769bffcfcbbd071d9507fa9d43e37cfa991eb2babcb9514e9a7374a36ec,37164126527
20180223,"PAYMENT RECEIVED",1351994313,0,f79775e4332e71aad1c17bd50984b75150cc4725cedaf316c0b6fa8f41449848,35802946841
20180223,"PAYMENT RECEIVED",1361764150,0,9d4c4191bc155c0d39363b32d36f631bd25c310aa83abcd73d8d0f158ad22f43,34450952528
20180223,"PAYMENT RECEIVED",1255614333,0,7207937feb1c929d78b5886de1952a23f8d58ba7dbe9bf602c382759878f05a0,33089188378
20180223,"PAYMENT RECEIVED",1307529075,0,e7869267a4dbbf7468964d79040591c36c9ac90e8f0470689326474e44e8d600,31833574045
20180222,"PAYMENT RECEIVED",1274347537,0,c7c00ed585cf6c267ca6ea23f682557bd035d45d990c42146689afe831f226b3,30526044970
20180222,"PAYMENT RECEIVED",1285266702,0,c89e4d07710a71f905ab6faa082f917c14859d7cc5e0905aa8058e81fd92e1b5,29251697433
20180222,"PAYMENT RECEIVED",1280632809,0,866fee33c7fc260ee3755aafca2a28d5c44285ada9477d58e797aaa30c39f3cf,27966430731
20180222,"PAYMENT RECEIVED",1264300917,0,6690237cfbc9f1ead53c3e95523d1e2569fe03a1402f5d34d41770803ff768aa,26685797922
20180222,"PAYMENT RECEIVED",1326788772,0,92b7882d4b7f7d8a1b90f2ff916132454f3aa624f866b7751739e04c44ab0227,25421497005
20180222,"PAYMENT RECEIVED",1271000253,0,ff8c574088b04df0169c05194a9c1bf4fdf2d554343fa1f9f5caa34bc1c85a22,24094708233
20180222,"PAYMENT RECEIVED",1262008426,0,5422854ef6a81e53e0f3d16ea7982b1e66a8cfebc449b3e1e991090c3556b500,22823707980
20180222,"PAYMENT RECEIVED",1305664809,0,8431b8767200afef90a44a890936661718d62c8b50ec34e47f44ecf2eae18d61,21561699554
20180222,"PAYMENT RECEIVED",1251592628,0,c882d89042194b71a04bba5bd40a7449408c795d9105f239ec6c10dd45c6a534,20256034745
20180222,"PAYMENT RECEIVED",1255396995,0,8ec11c5d7113ff0e7e09415210f69ab21e113c4ad04970e3052b0c5b3f1b0b72,19004442117
20180222,"PAYMENT RECEIVED",1255633829,0,6052d28789897e4bdb09ba7377f726ed7b5d0af04c339ecadae095ebce01e170,17749045122
20180222,"PAYMENT SENT",0,-85433063663,45bd1ebda953dfdff705e41488ebbeaeff0ee1884b91e275b29d0f95e4ca3dc1,24243549626
20180222,"PAYMENT SENT",0,-7750138333,ae3fcc7d4492711a118b7c04bcf74c54c462992fbcbf6c6e665e5e09052f2112,16493411293
20180222,"PAYMENT RECEIVED",1257204376,0,359943f1111b8ae3ed5da2af86659cd410db86bef838ddc28be9ce2a9dfd515d,109676613289
20180222,"PAYMENT RECEIVED",1259636066,0,fb36630e11e562f3b3de9afc569e39f8e9b451d36938e08b5a043fc4ca6b150e,108419408913
20180222,"PAYMENT RECEIVED",1254272982,0,fc0b490abcec6b0f50ba0c29549531e1b07826f8f785596cbfc0c8c9a88e4c17,107159772847
20180222,"PAYMENT RECEIVED",1276199935,0,2fe8423fb978c9924dd6eaccfbd05e2d8f046e258886b1fae35223898a503d5f,105905499865
20180222,"PAYMENT RECEIVED",1283552932,0,fc9de46bc6d1bab67b3c435704408844a9bf39e87b7f42544293b7b01f25ab4e,104629299930
20180222,"PAYMENT RECEIVED",1277833566,0,2558df9961005e56fdd9f3e96ebca2057f9f749f60646b947e3b764127fb8a96,103345746998
20180221,"PAYMENT RECEIVED",1275125492,0,ca3bbd66335b8debcb53e05ffcbb05a36336d531c226faef96c9b4c76976810c,102067913432
20180221,"PAYMENT RECEIVED",1250000000,0,8f36afe41bb466896e77c5374a66f307af11d848ae81bf31c1c03191a41da55d,99535403104
20180221,"PAYMENT RECEIVED",1257384836,0,5d7f21ff3924ba5dfe2709de34104fcd723050d064ab4f2e303b7107979bfb7e,100792787940
20180221,"PAYMENT RECEIVED",1303036712,0,33fc255423690ab634af366bfecaad310c4252966b138e762cbebc470e76f977,98285403104
20180221,"PAYMENT RECEIVED",1275588218,0,0142c3ef5dddb5a71556764ca02c7a7e055740a096c5c0f8f7298874e40c6282,96982366392
20180221,"PAYMENT RECEIVED",1268121608,0,e722f438abdc4f33f37bfa979141793f615dc04f8baf635fecd4006902d2cb25,95706778174
20180221,"PAYMENT RECEIVED",1255454570,0,a7c0ac8301c781570fa5045588a843c6b98d0e2d6fab44037bbea38d2b42f3e0,94438656566
20180221,"PAYMENT RECEIVED",1263799901,0,8efab3454d233f6327d0e88a6b6df53af90dde0b071f583a302cecdb44f44625,93183201996
20180221,"PAYMENT RECEIVED",1259202955,0,1a7c4ff88cb1b56a3c40850ee1a81fe08a3b5b36e3db0b0cab2af15ceddfc2d8,91919402095
20180221,"PAYMENT RECEIVED",1270670864,0,d240522a5a513a4828b051dcb7e77692e1620521cefe046fa6bd1c35a60b223d,90660199140
20180221,"PAYMENT RECEIVED",1268585492,0,951cfcf378c16bd7949d6c915dc003373108745e3296158a4eb30e13806b48b5,89389528276
20180221,"PAYMENT RECEIVED",1289495971,0,e9a51f2b8a613375a9290d3d3991eede6239280b54f3bb09385a9523e4746d6b,88120942784
20180221,"PAYMENT RECEIVED",1255494010,0,5c2af3dea014596f66abeb091aaebc4708dffd1043bec3bf2a127ff3b7dcd8fb,86831446813
20180221,"PAYMENT RECEIVED",1304790934,0,115bb2f1c776c56e04950ee46e4c493b01f4d235a0c193509fb9c30cbe744985,85575952803
20180221,"PAYMENT RECEIVED",1319093126,0,cad71ff912be23c826f01aacfc971f700d163c23a678618de1b5897f0a989412,84271161869
20180221,"PAYMENT RECEIVED",1254379350,0,ce6ece3242a64270accf4d41c44b7f7149e29427467b0e81cefab806f8f07551,82952068743
20180221,"PAYMENT RECEIVED",1250967616,0,edbc0c601c157f6ad27237299c6aff8cf8fd49b94024ff430de1b90c8fec0094,81697689393
20180221,"PAYMENT RECEIVED",1263660305,0,a99ed21f4fe3283d5b4711a046d1fef1f54ba7dbbb59e9070dbdd00acfbf8aaf,80446721777
20180221,"PAYMENT RECEIVED",1305904783,0,0917356626da00ed8c7bd4cbe23a58e554653e43871996f1c508e00f33140a1d,79183061472
20180221,"PAYMENT RECEIVED",1264143283,0,1216c7d98b5b372a9e35771eb0624e6a52b2904adb8659bb05860877c2386ac2,77877156689
20180220,"PAYMENT RECEIVED",1252118241,0,a8bd4cd9a2a64de217c7132f1914a4d9692e1b578bd890fa16826b13e05e8370,76613013406
20180220,"PAYMENT RECEIVED",1286364586,0,29788bf007fd4277564f0f7414f9af1f3f028375224e3c8dfdf77fe9297b83e2,75360895165
20180220,"PAYMENT SENT",0,-94917393430,d0ed3b0a782d7d53251eb1990458d3f3ca88affd306c237d73e05967a6dbfe5e,74074530579
20180220,"PAYMENT RECEIVED",1250637479,0,3ca3a83b782d80196793d13f5bad18964f6678c36281bc3af4f3c66fb2f4adef,168991924009
20180220,"PAYMENT RECEIVED",1280737407,0,71dc2a28a486974505fa0ca2b52a15b4943408d44d48965712a52ab73c0663a7,167741286530
20180220,"PAYMENT RECEIVED",1285974702,0,588412fb793954d41a5bd96e0de398e7b1c6c9f315f96dba1f968b013adba779,166460549123
20180220,"PAYMENT RECEIVED",1265461461,0,6878ff43197b7bbf05d0bfa87d5b38cb7bbc8857f5555e208d3e46414b58c3ff,165174574421
20180220,"PAYMENT RECEIVED",1267856447,0,4a4bfd587bf4354500cffd160fe7571d25b482ad5b265cb43e194cd4db1f9b6f,163909112960
20180220,"PAYMENT RECEIVED",1254742607,0,b3dc985683ef7815dfabad1c50272d366c37fc5cc944a8946716034edf63451f,162641256513
20180220,"PAYMENT RECEIVED",1281963556,0,9864a7691e40fa57ebfa131d8d101e079e24edad5b6b2712707505814e99f925,161386513906
20180220,"PAYMENT RECEIVED",1285460895,0,ab2f7c1fa2beeb523743f3684dd2be5ccf1bc29baa8a34998ab88aa414175c3d,160104550350
20180220,"PAYMENT RECEIVED",1305183479,0,18a16cb9d99185f6673d8e5642749920c533e793168966741be95bb0095b0599,158819089455
20180220,"PAYMENT RECEIVED",1289402447,0,4feaa3f562c6792857f16998aed176566c8e813baa57bbea6e1852a0bd816a8e,157513905976
20180220,"PAYMENT RECEIVED",1296790884,0,32c22a0c8f1533615761c9ad52129a0ba4cb8b34dc0e81e1f9ce4fca8f8c1025,156224503529
20180220,"PAYMENT RECEIVED",1287806358,0,d8e277cb59eecec34286e08e30583dd8ac7c62e6434434a091992b4c58d43057,154927712645
20180220,"PAYMENT RECEIVED",1267008916,0,9df23318b4b1cb44c80a0cb6a993116264fb70a34cee566b3be85a8334523645,153639906287
20180220,"PAYMENT RECEIVED",1295512938,0,a5f719c8b21d60fd973dd36a37d962b829f9c0ada177738c91674583a2ef3971,152372897371
20180220,"PAYMENT RECEIVED",1269236970,0,f4e8fcbcb3751490368d31f75987b51e8720b77024e7ecf3f551548e017615e4,151077384433
20180220,"PAYMENT RECEIVED",1309610789,0,ad6aad6d9519274f46df8786da3d3539830168af60b55135e93216ea5cf5d4e2,149808147463
20180220,"PAYMENT RECEIVED",1311141436,0,b8b4698ada963df638ce5c09ca2dbcb19b297f02535569eb6c807cd934248d5c,148498536674
20180220,"PAYMENT RECEIVED",1306851925,0,f6bb9c80342fe10473bd527bbe7695ef70929ab58f48fbe14e4d8dc4d901af0c,147187395238
20180219,"PAYMENT RECEIVED",1264811000,0,9bdb86488f306a6b015972a60280156aa39d890572b50e22f4d5742fdb3223a9,145880543313
20180219,"PAYMENT RECEIVED",1258520397,0,52179533bb74263d0cc7404f3b5f5b05e173d4572376afb363e3a4665a9d5676,144615732313
20180219,"PAYMENT RECEIVED",1253873140,0,6c98edeb1dd652a8e2c84ff444a2b2cc773a0b7060490793ea0e8e694a91c4a3,143357211916
20180219,"PAYMENT RECEIVED",1307295186,0,218d50d1882a500f68b94df90005290169df52809ed6a8f3d66c6fad1a80fea8,142103338776
20180219,"PAYMENT RECEIVED",1264739228,0,0947dbcce0628ab737a1129f6c5f7670e3a893d157c032a38634b0225bd6e50f,140796043590
20180219,"PAYMENT RECEIVED",1279431466,0,fff81da3a4ceb05826cf1bdafa53a5cbb7f881b2e519894ee7ec1d1b7a72ecc8,139531304362
20180219,"PAYMENT RECEIVED",1353705062,0,0382b599cb63266c8ff7a69e9e1911f1dcc28a3735f55724d5fb51471ae203f4,138251872896
20180219,"PAYMENT RECEIVED",1348383601,0,e1c90eb7085c462639302bf3140690439b4de0585801c84e8dd2b42ca5dbf1a1,136898167834
20180219,"PAYMENT RECEIVED",1276123768,0,de49d3467195d5b9c9363b13db15c8c597ce339e659cb95d40e1a6f8d3d9c231,135549784233
20180219,"PAYMENT RECEIVED",1379984830,0,11003613d60510d84fd8e7773d7eacc769051fe72b06ae22cff713c27bf2ea23,134273660465
20180219,"PAYMENT RECEIVED",1265630959,0,d889b346fdf0f2f9aaeb90586f355f7d92a1ec5947efe02ce51869cde6d2e857,132893675635
20180219,"PAYMENT RECEIVED",1259560234,0,160c1eec30b4a3785cab6dfec727f3f03a7f5fff3cf4993eaf1a3517f0212260,131628044676
20180219,"PAYMENT RECEIVED",1263964025,0,dd2265cd6f9562f7c7632eab4025828609630931201fce4d896a80f5db021c2f,130368484442
20180219,"PAYMENT RECEIVED",1264501123,0,d285da7fc1c9cebac28b4c8c91bfc4ca7cc95641f1013ec118cf84917eef0291,129104520417
20180219,"PAYMENT RECEIVED",1266028687,0,437b4df52905399f2ea9db2de842d1cca0ebe439f99df7ab833e41146ea2beb1,127840019294
20180219,"PAYMENT RECEIVED",1272285316,0,cfc8b2c56ec017b6c8f9fc6a70a0d6e30b0f251b6e58c399396c8279e8353845,126573990607
20180219,"PAYMENT RECEIVED",1280448197,0,789323416afcb888a124d243b55b22011fad888e51f501dbd51e45b939fb5729,125301705291
20180219,"PAYMENT RECEIVED",1254611884,0,63039a5d61e54d6555379855bf0739ef841561143471b1a353485b84b59eff87,124021257094
20180219,"PAYMENT RECEIVED",1265971229,0,d46dde3a10d4efa4d0ba83ddac4cc943a5e3b54467e1902587bbc3d9b9758cc5,122766645210
20180219,"PAYMENT RECEIVED",1284199210,0,16b878fe0b523968848229d3d8f90fd66b88906bf75aba7afab84e2048396ab3,121500673981
20180219,"PAYMENT RECEIVED",1303998005,0,6590cd5412ee130b365faf73462832e204faaa06eebd372aa5a983ddf3caa978,120216474771
20180219,"PAYMENT RECEIVED",1290278903,0,16c502ae51167981312f0956e13d23923cc20995a7d1819fc668d1777181b4c8,118912476766
20180219,"PAYMENT RECEIVED",1288799070,0,2e98fab4fec3f1524aeea3885c4fb63ce0b19afcd3424ab3dc4b6142d5bf79bb,117622197863
20180219,"PAYMENT RECEIVED",1256163606,0,c1244a58c3974682fd80644479edf4fdf5c34724e28ae8f6fbff6b14643a5bbf,116333398793
20180219,"PAYMENT RECEIVED",1328368950,0,8fcd904eef683960cd10b98bc6d747bf18719b711c1fb78ca33a49c112084351,115077235187
20180218,"PAYMENT RECEIVED",1261342570,0,901b6530c2710fadf86e9d4a600331dcd46f404f799695b5c98b028572bcaafb,113748866237
20180218,"PAYMENT RECEIVED",1278630478,0,b0164995ad1f68bf7fae8d38616248a833f31e4f0417cfa52dff687b08a5d6c7,112487523667
20180218,"PAYMENT RECEIVED",1257098602,0,837240e196553f4d7de01b8ce46fc47ba18ba208dbbecbbef759c61bbdc79f69,111208893189
20180218,"PAYMENT RECEIVED",1298519826,0,60d8902c510eaf54091f48ea8e1a850224574743385ca5eb950adb9d177db272,109951794587
20180218,"PAYMENT RECEIVED",1288549395,0,8334428e55103a7ea836570df4d7a643d33da4807261b7ccfc41bdfd3f4d63db,108653274761
20180218,"PAYMENT RECEIVED",1335060237,0,a95d069b0a0c891195e9aa3578380eaa3266225f423a9b075f3fcf72cdf6d8e1,107364725366
20180218,"PAYMENT RECEIVED",1287978029,0,80368295fe494a4b570a303e39a4628b54c16b473244e5d68c85c7c225f3d484,106029665129
20180218,"PAYMENT RECEIVED",1268357261,0,aee6d56e1c2a5fde92487c1312cb2a3b92422e5b30ba24b3ac7896e9c85b0d1c,104741687100
20180218,"PAYMENT RECEIVED",1291524511,0,51d7afd81085aa7646887093c15ab65ccec9158a0bdfbbf9caa6cdff7313fd42,103473329839
20180218,"PAYMENT RECEIVED",1261920575,0,a5c51fc554be80f18261b9b913ac3d8f35ec5e2dc91de2e6a7709a1dd8c116c4,102181805328
20180218,"PAYMENT RECEIVED",1279774823,0,7895cae110904460941790cb244234b15ffb097792a6486ea705e95f5ffcf418,100919884753
20180218,"PAYMENT RECEIVED",1295525334,0,823bfa572cddb1a9bd297f74b5f0a3992a074a46e7545f87bd0cd2440f5c877e,99640109930
20180218,"PAYMENT RECEIVED",1323659978,0,f640622dcb1214c6a8c81cfafa78869fce5ada718f976d17e00145b9bd2ad072,98344584596
20180218,"PAYMENT RECEIVED",1264062818,0,4ad01982792b7ca7f335a54ce92d572020c10cde447ed2ad1814fdfd7eb9aa29,97020924618
20180218,"PAYMENT RECEIVED",1303680877,0,35928e38cdfb3432edaf51a2e2c53b6790f3905bcd775fb385e184908023fa47,95756861800
20180218,"PAYMENT RECEIVED",1271444142,0,a92fcc0dbabe5647e18de15e7fcaac9a3a16ff10e5b6df25912fc9289a1a1319,94453180923
20180218,"PAYMENT RECEIVED",1263359173,0,533fe433537225adb465b17aafcb6b402f8d9919cf4d50b7b045de5efc7e42ca,93181736781
20180218,"PAYMENT RECEIVED",1263721756,0,9add8b37fbe0e5f04aee06444c87b410735694bdbe473c35bf9e1f6ea89c1581,91918377608
20180218,"PAYMENT RECEIVED",1271550775,0,ec6e99d6095f3163aa74f190be5a52785e811c1d662c0f58590e4bff402f1962,90654655852
20180218,"PAYMENT RECEIVED",1293700279,0,094609ba775b85ce0be6cce105075b020ba350774b033fb4ec731f730f53daa7,89383105077
20180218,"PAYMENT RECEIVED",1256821708,0,e3a18d0ea9b595e01a3171162c1205eb5758bef3dde7515227f340f85a15a16d,88089404798
20180218,"PAYMENT RECEIVED",1311577434,0,7a3d5bdd12cb01b497de029e207466aea9fc4af7cbc723cf2185c29a657ec3ed,86832583090
20180218,"PAYMENT RECEIVED",1267884878,0,2f339d0a715b8d234494c231bcb388e4dd6844a963d78e66877e10ece8457094,85521005656
20180217,"PAYMENT RECEIVED",1283600536,0,f892241f050f38d376c9631cb0b84533556b882f53324570aa6a2c1a05f12494,84253120778
20180217,"PAYMENT RECEIVED",1284459469,0,8940b560c0a13df950fdac347f1ea769d683cdf4b319126a1c369e13cb649e95,82969520242
20180217,"PAYMENT RECEIVED",1273339533,0,1bfded55888399f5bd07107586ed09ae1507d129275db7c9a06199e277c23cb6,81685060773
20180217,"PAYMENT RECEIVED",1283695022,0,1e83361cfb7555e06472056ef9bc758d3d9402fc530b10320b5b6ad01344a0a3,80411721240
20180217,"PAYMENT RECEIVED",1261818100,0,90a4fe2451ddd61fe22c5accad612d1ca0c83833e836b1e8cfe73bba78556bbd,79128026218
20180217,"PAYMENT RECEIVED",1260363127,0,4a43941aa35430e2b254f0550e5d9d32127283380540095c5f887f9350afbb59,77866208118
20180217,"PAYMENT RECEIVED",1255745914,0,76e4487981f56c41080b63572670625db2a7ff019694f1e556ae6216eae60f05,76605844991
20180217,"PAYMENT RECEIVED",1252062214,0,192f9e68f4597ef2c122b59f0753559391eefd949064b4737521d0df459d922c,75350099077
20180217,"PAYMENT RECEIVED",1257872918,0,ec9aedd16967efefbdab6d199bfaf9844ff439e1871928cc23940053fb571f3c,74098036863
20180217,"PAYMENT RECEIVED",1333042462,0,fac4199012aa1fb8bb13a5276fac54b72184a37233a02706d3e0501b1d967bf4,72840163945
20180217,"PAYMENT RECEIVED",1258836591,0,f54e9648e02adaf19186119a1926d3e5c9ba072a430fcbb54cf1124948a87049,71507121483
20180217,"PAYMENT RECEIVED",1255464981,0,09670e261ab82e95ddb000717a835cf009a1517f7a582e7a7442b9f85853d23e,70248284892
20180217,"PAYMENT RECEIVED",1255950452,0,3a7cb1027943f413560637af3c1f00f9d9c592b915ac04086c4589cb28d9596d,68992819911
20180217,"PAYMENT RECEIVED",1262295921,0,7b99c314dec74b33103775ac6ae0d97aa5325c6341e43945c93fffabdc973f21,67736869459
20180217,"PAYMENT RECEIVED",1268823659,0,af3c81ab644e212ac0d477d500197700fa40cf14cbc3bfe374be1cffb0921fb7,66474573538
20180217,"PAYMENT RECEIVED",1325956499,0,7142b646b9f77566483801d2a1288ab8a6bd4caa6ffdcbdd6fe3cad97bbbea28,65205749879
20180217,"PAYMENT RECEIVED",1303259566,0,9e01dfc463d7bf1020d3c7d37a8c0240471ff6f050869fcc1c29d45304af6b18,63879793380
20180217,"PAYMENT RECEIVED",1252268120,0,907fb2f8445780ac5fceed21b13f13eaa1323f2df9026ffa269b394f314c1008,62576533814
20180217,"PAYMENT RECEIVED",1260861006,0,6790c19d23490ffd292e8f6ef2f318aba2e6fb6234de6181889a339b6f0b452c,61324265694
20180217,"PAYMENT RECEIVED",1253143805,0,fde4554f3bba8d6c2fbd20ba6e03a56ac680a4bf1ffd553768705fc1efd7c9cd,60063404688
20180217,"PAYMENT RECEIVED",1265403508,0,849dc01cbd80bcfe5daa847a8e77ee0368bf00e8af4f4c0b5b656017aa5976c8,58810260883
20180217,"PAYMENT RECEIVED",1302222497,0,c6d939dcf4386c3f48a7804417a86a0183fc06d689a1a44167f824ffdf393774,57544857375
20180217,"PAYMENT RECEIVED",1259639142,0,c9cdb6b1fa6fc061faa63a12e987534d069bc6ed6affd2a7c1af38654245d07b,56242634878
20180217,"PAYMENT SENT",0,-97388575288,02fdd9055f5035f1bf2b100abc1195593ab3030d92eec0a64bc7e0a34619c3cb,54982995736
20180217,"PAYMENT RECEIVED",1296245521,0,00d29fc92075eb4dab7e292ac332b6461b089974e8ed1fa7e570bfeb3eb7cced,152371571024
20180216,"PAYMENT RECEIVED",1282136321,0,23d65f656cb62aa5b04921b1c50ce5172e1ee2c29a70337a7341a3b64eb479ed,151075325503
20180216,"PAYMENT RECEIVED",1287064617,0,aef49d25cad37877532a5d4db35cf22d2eddd99c58fec5a8792ea81d948506c4,149793189182
20180216,"PAYMENT RECEIVED",1262842460,0,626983719133fe2da01a341a4e5ea7d49834287e9d1dbd52d517a3bc3198c2df,148506124565
20180216,"PAYMENT RECEIVED",1258076296,0,38594b8c1388212d95fe5aaf0a26fb1f8b58016f783e2ad6d75fab423ba1d000,147243282105
20180216,"PAYMENT RECEIVED",1297139556,0,01b6fc4207ad971dc29a78632d2f0a70aded1c2cca021b32016934f622c58280,145985205809
20180216,"PAYMENT RECEIVED",1293515489,0,09c5be639409cefcc0d9bc85141a98ac5797f6fccc9f42c87232f9ac1fbcab7c,144688066253
20180216,"PAYMENT RECEIVED",1261213126,0,ce6a065f5051ca508daa1346f127520c600906edb880d5449bd8df19d5ca8878,143394550764
20180216,"PAYMENT RECEIVED",1260865876,0,cf0305f139ade239e10af541b08fe31c4a7df795466d6ef915fa9485a1c2c83f,142133337638
20180216,"PAYMENT RECEIVED",1269072358,0,331e98c37d336c8628f5d685a1e627c24c224b4bc490636fe4f72018ea958d81,140872471762
20180216,"PAYMENT RECEIVED",1275366171,0,fde279186ef42bf4c9c30ecddca4d0b2b39c87c9a2da28ade2a70ee11f9553fd,139603399404
20180216,"PAYMENT RECEIVED",1298331475,0,7bcc204470ca29c205c47d7cd13e7a8fa587090f365bd9730714ffa5d0e850fa,138328033233
20180216,"PAYMENT RECEIVED",1308756999,0,6cf15e1a32256196d4c496478454f70e7ccc00d11dcd572841fe143f08111c32,137029701758
20180216,"PAYMENT RECEIVED",1305967440,0,a4e2eb111cd6ce3699cb98093ed308227f70250c00b23aeb4cfd1b3be8762d02,135720944759
20180216,"PAYMENT RECEIVED",1254110265,0,1a8043af7be20456c34191a025d26c0836726fcc7f271f879898023e3d2b1db3,134414977319
20180216,"PAYMENT RECEIVED",1271654747,0,d4866356561af573b4948ca6bb44fa035718de06796df13e04c896bd629eda82,133160867054
20180216,"PAYMENT RECEIVED",1296346938,0,1914f312d708eebb2854a0107cbf8a4c0a1279dbb6716ea3b2d678f33f0b06f6,131889212307
20180216,"PAYMENT RECEIVED",1255791112,0,703a886137775d6ab9930c26395820eb1778a5cd76377e49d35daa6475bf0ee7,130592865369
20180216,"PAYMENT RECEIVED",1306376219,0,2d2830a79c3729a0f276855ae5afd2e5dcc05af71ef05160218d2d66e847a314,129337074257
20180216,"PAYMENT RECEIVED",1271504982,0,e083a3164f2c8ef734921e4de070ea9dd94e00924f9fffad7fcf5988e779df53,128030698038
20180216,"PAYMENT RECEIVED",1279795284,0,1630264b511de2c3ceba8bc75638ecf2a622e8c23bedf2581e888d0d49be1d34,126759193056
20180216,"PAYMENT RECEIVED",1333639828,0,16a92f6528ec04c622c5911cf85ec7728c194eb99186ad97cb2d2149c0cc5f0d,125479397772
20180216,"PAYMENT RECEIVED",1316867236,0,f4f404455fedf7fa438999c888e8c26a9c3b9a9ebd2a649163d0a162638b5d44,124145757944
20180216,"PAYMENT RECEIVED",1298945560,0,9ded1ff15360f1f441d4ad2f4683a39d8bf5ffbb8f1ec10b7985b7472205c980,122828890708
20180216,"PAYMENT RECEIVED",1328188659,0,8549b98c35fb7e8c4ab18454be948703976e6c2365c10fcad3e984739f8b4a75,121529945148
20180216,"PAYMENT RECEIVED",1279418396,0,7f958e649191aaa37b360bbac2008306bfa94a79267c36382c0e2bb4db56913c,120201756489
20180215,"PAYMENT RECEIVED",1322416133,0,fa096ee7a89f2ede38363298677551889d64cddaa6357226e9b1b2e5bb66515a,118922338093
20180215,"PAYMENT RECEIVED",1372428308,0,d391f35b2e1d3f7f8fc6733798fbe37d53c3fe9a123ce41b9a6d252586224f1d,117599921960
20180215,"PAYMENT RECEIVED",1375533956,0,9ba8be33bbac262d5f877c654387572b78f341347760b047c2d66ecc1a26ce22,116227493652
20180215,"PAYMENT RECEIVED",1284379397,0,30841721f87f0a18639e7d3b5bfa8dfb4da12478c5b8e8f4baa242c6581a710d,114851959696
20180215,"PAYMENT RECEIVED",1301359273,0,60137e0b3a0758e8cacb21eff254bd034019186926c0dadc53ac48ee8ebbfed1,113567580299
20180215,"PAYMENT RECEIVED",1272964983,0,67c30a70f11b4c57d33015bcc13368ca2125ae6e079c733f103e7199c967eb67,112266221026
20180215,"PAYMENT RECEIVED",1272610235,0,ad25e30b6b244956362c573995be8360335681fc294dce384efddb048ba7b8eb,110993256043
20180215,"PAYMENT RECEIVED",1371568642,0,b17e15043d1cb9f0f6e54ec6a265b018bf9d9cd74206cf38e4f0e7312dac7aaa,109720645808
20180215,"PAYMENT RECEIVED",1294678284,0,4fe15fb794d90d77503afc38309d28544d2ea9049a5dfcce4b5aa253dd83d9ed,108349077166
20180215,"PAYMENT RECEIVED",1271560333,0,97a7d2e4ed61b567c28b5a2ce34a1bcc9ed3089bc2b80c883d0abc5402143077,107054398882
20180215,"PAYMENT RECEIVED",1300276024,0,386e18fdf2e077a2258b4f6627145553305f13b851637ac90bcbb87bbe4ec6dc,105782838549
20180215,"PAYMENT RECEIVED",1337894008,0,c6436457c344f9d6738e7a429d72124e69865afa3ede044f1a4bdd51613a7702,104482562525
20180215,"PAYMENT RECEIVED",1272122864,0,defe30129466ab559906b91147a378a10f650b45b0de14248d8460945dc6d638,103144668517
20180215,"PAYMENT RECEIVED",1300874556,0,0501bb4da6c1d3642bfe05ec96ccd68c656763b06b34296f43572d7f78653e25,101872545653
20180215,"PAYMENT RECEIVED",1272462441,0,a8687d6fad3d225244ba80dbada1a5c7158d3b7bccc14bd797995d73bf229fc3,100571671097
20180214,"PAYMENT RECEIVED",1265468950,0,060374230cb1bc942df7867ce26bb924cbf03412210e80a8cf61003a7ba34f87,99299208656
20180214,"PAYMENT RECEIVED",1274177309,0,ebc85881c9d6e0c844664609102605a6f9044fb26a573a7b37ee3d9bf61d4afe,98033739706
20180214,"PAYMENT RECEIVED",1295506587,0,e23a8dd25b5c6fe5d9bb91e90f5f39612d38cfb23593bfd73a627da90293610a,96759562397
20180214,"PAYMENT RECEIVED",1289594789,0,46b060086a76cd87887bc3aa2cd2162d9a0e7ae507084569e0d17fa7c3c9b16e,95464055810
20180214,"PAYMENT RECEIVED",1273869302,0,1655c817904a8dd1aed8f2dc07ce8b3e38e072dc3f50cc15a42ec8efad8e5f63,94174461021
20180214,"PAYMENT RECEIVED",1268791153,0,8aefe14f11bf3a68a4e7eaa20fab6b52d3367b45e9009890a48b64e6a62bb3a3,92900591719
20180214,"PAYMENT RECEIVED",1309990326,0,47bcc919d431a6a4e0566848e8d23522fc36865bdaa93d5f512cf2eb692c7066,91631800566
20180214,"PAYMENT RECEIVED",1257953470,0,c0b9a2ca0183032c69bc8dc29888bf971d9984d144af079d406c344195818a2b,90321810240
20180214,"PAYMENT RECEIVED",1351209713,0,541dc7fa129487fb7b5f4e2519419f2eebe2fff88291f63fd1dcbd277034031b,89063856770
20180214,"PAYMENT RECEIVED",1283616933,0,d37b34b20275089243f222e5fd3b34a50c835818aa44aaca2621080167ee8537,87712647057
20180214,"PAYMENT RECEIVED",1319410279,0,86a749e2d6e18588ea24c6d3f25adfaae37a2c8bb9953c88723390ec80f4564d,86429030124
20180214,"PAYMENT RECEIVED",1294364479,0,cce9be82e909c870164a1f35f1ea221b95d492a8efcdb1e8b5466297b44b8547,85109619845
20180214,"PAYMENT RECEIVED",1285580950,0,fbc5188b5d1f0fa8e105857236415f0a6d92ad8227cf0549100a4948c1009095,83815255366
20180214,"PAYMENT RECEIVED",1347341507,0,ec77c6820084345d630006035126442bbdf1e599a87a44f8e6ba0ca5b6a8dc6a,82529674416
20180214,"PAYMENT RECEIVED",1276237860,0,f7c8181268717af49e36c447512889afd721d9200ca68a4572f7705b9b6a3c87,81182332909
20180214,"PAYMENT RECEIVED",1263848218,0,6759ece163fa5439ba52877f9613578c0821fedddff0506afe8f694a85ec0896,79906095049
20180214,"PAYMENT RECEIVED",1316405517,0,76c98bd1d99940037a1963394858dcebdbacbcd77d8ac4167e3aaefdcf686fac,78642246831
20180214,"PAYMENT RECEIVED",1292134417,0,2a0f620fab7348a86b98c8aac8def462be6de5fbe26be16a33c3f507fead4e88,77325841314
20180214,"PAYMENT RECEIVED",1297492389,0,7fbdcd5467e748014e3d08442c6b203af4c7dd2f020cdf19d21b217345643e6e,76033706897
20180214,"PAYMENT RECEIVED",1341358596,0,ae5bc683c0c810005f6e75c43d2c0b106e60731579a0cfd491cdb2430929d9ab,74736214508
20180214,"PAYMENT RECEIVED",1311825041,0,b831d821807256949f2e389c5f8714d1980b6e515f500d3b35a5049b7d996f5c,73394855912
20180214,"PAYMENT RECEIVED",1294463602,0,4d4965a0b66c11ca4415ece86267ed9c69986da01847bcaa58fb7f223829f990,72083030871
20180214,"PAYMENT RECEIVED",1331577066,0,83977eb5597c51c83aa2161d1ad1a4d8532a676ab0980b6c90c211e6882b5db8,70788567269
20180214,"PAYMENT RECEIVED",1282515147,0,88ea79a5c36800fd099d29e1984a405984aea35e6e24cddd0016afa052e5c6a7,69456990203
20180214,"PAYMENT SENT",0,-47191042655,75c37122192249c42868db9288fcbd52d26ccef158b57b7c904853ed95133396,68174475056
20180214,"PAYMENT RECEIVED",1303457558,0,fdea982bd92a9caf149b9e7076f732e720faf5f9692fd63ce5dc38184371bee9,115365517711
20180214,"PAYMENT RECEIVED",1264862257,0,069a38d2a8591a182f15a9e553a45d15e25a51569c38bc74be04f62a8dfcfbf5,114062060153
20180214,"PAYMENT RECEIVED",1252686081,0,3fde04a82ee9b1013ef6dacede16016b60fa0b13d2dbc20486e374f5c8ac45a6,112797197896
20180214,"PAYMENT RECEIVED",1311348110,0,2af5d4b8dcc1265efe40f7db57ea7180ea73f5c5780f58af569a227da38904b6,111544511815
20180214,"PAYMENT RECEIVED",1260878901,0,f1e5f56e356e92bcd92b882da26a73418eb495bc70ab94b4f55991e95f61ba51,110233163705
20180214,"PAYMENT RECEIVED",1324250284,0,596048630f7bb50a17e5266dba8f19ceff2916d3c5a9bc902be819808a8d2a6f,108972284804
20180214,"PAYMENT RECEIVED",1300540072,0,aef3d2d887a699c413946f8f70da3b923064e6f2333a510eb91f5bb5b02f3d6a,107648034520
20180214,"PAYMENT RECEIVED",1329236739,0,4c8078b60a2152ee622627510712af307db25fdebe35ce20d52de9ca2d54991f,106347494448
20180213,"PAYMENT RECEIVED",1294754860,0,c0df021458b8b07f6b9bfa1c6c8c420b4162aff244223da6adbab73d002d5740,105018257709
20180213,"PAYMENT RECEIVED",1267505572,0,208489138b0563bbdfd7941f252fc0a1b73f168f48c1db764d3d46dab505f55f,103723502849
20180213,"PAYMENT RECEIVED",1313950385,0,89784aaab35e5acbdb2c3ccf56918f2a91749081f0fe439da940f5d3562a2264,102455997277
20180213,"PAYMENT RECEIVED",1265041403,0,0e2c8d50f6122780f358a83f59512ca310628c63d11d06ce3d69b0a0d6d312cd,101142046892
20180213,"PAYMENT RECEIVED",1280052681,0,1715012d2528c3b1988c6bff9258015359cfe843631970c1606b590ccef7d456,99877005489
20180213,"PAYMENT RECEIVED",1297473709,0,6375028761667881a436a0e45b956cd517a64ff99754c47b545fa23138c9a93e,98596952808
20180213,"PAYMENT RECEIVED",1323219407,0,ca7051482ac533775e7cd4ca839d4476332f7480ba40da5f178d92f0bd731fe8,97299479099
20180213,"PAYMENT RECEIVED",1277788640,0,3748ea6dc11de511673c83e8702c6939468d0e0878b572591de43eb7d6c0e089,95976259692
20180213,"PAYMENT RECEIVED",1254912037,0,2547eaae9e2ae32ac8720f3c368ce7208f67bb5d1f10561df2d1a9593d8f6386,94698471052
20180213,"PAYMENT RECEIVED",1273245818,0,41673d686ac4ffc6f1d12f0718261d63ba924aa112e3a2035317dc9721508b80,93443559015
20180213,"PAYMENT RECEIVED",1301644445,0,3e24ac98b2c29927aeb0c52eb64cd723cfc9acb2c6fef2eae5674b2d84be7d4a,92170313197
20180213,"PAYMENT RECEIVED",1417724024,0,b58a633c382786a155c6ea94b086f884d5ff520ab184164fd25dd2f04faa5ae6,90868668752
20180213,"PAYMENT RECEIVED",1299104229,0,333ef062486bf41e1c362b659dceb9a09196f09ad15002fa9c95169e4933a4ab,89450944728
20180213,"PAYMENT RECEIVED",1283734739,0,270cf962c208edcfe8c4c643a72ad244a556943043b24e8be42d962e495a3458,88151840499
20180213,"PAYMENT RECEIVED",1262348403,0,94ed08405cfd8ee2b16bf88f48ec86032069c0890377ee6774849f3c053acd5b,86868105760
20180213,"PAYMENT RECEIVED",1259547492,0,e6a72b2f5b2f6bb795fcd8513ddb1f97cc2f934f4c9b1ca103bed1344b5382af,85605757357
20180213,"PAYMENT RECEIVED",1258939641,0,d12e8ec8ca66baa3580aee59c116b966fb047720725961c7953bbc202a30d9be,84346209865
20180213,"PAYMENT RECEIVED",1290742456,0,fa5fa335b032da75dbae183eb31642d239c7d8f1bf584eb90c7b66317bc3a633,83087270224
20180213,"PAYMENT RECEIVED",1279374377,0,4eeca6f4d1a897bb34732157f3aa0946916e30238c1eef9d54b9cbcbe756679c,81796527768
20180213,"PAYMENT RECEIVED",1390117227,0,b1f1f35f4da49492cfc7b8a99c2969f1ba05598bb291549a14c910f8a77a36e5,80517153391
20180213,"PAYMENT RECEIVED",1360850358,0,c5d254d5b279bd5ed5d13ab815d272272c38b6ce2c56eaf1daa65982fcdef24e,79127036164
20180213,"PAYMENT RECEIVED",1254494760,0,303bc2da606a175b9a4d07b977c6a073a4754b430fd7fbf0fbb2447e45901639,77766185806
20180213,"PAYMENT RECEIVED",1262797893,0,832009b3a1a60014b6f4e96d129cfdb8c6a394999618a7bacdcbf0d06843e087,76511691046
20180213,"PAYMENT RECEIVED",1259842533,0,13dc0cee300c3124fab1cf6a3aadbcdf1c94a678466b821320bfae977e848b66,75248893153
20180212,"PAYMENT RECEIVED",1296580500,0,162d2bcfb326e26fd8e2c9c03296ac664dc22f9fa0a8901aafe0f4f83f420d80,73989050620
20180212,"PAYMENT RECEIVED",1293946951,0,2e844ec2ed72f56f8f49b8130f8a955bbb876608bfa1f67c6a4f800154e162c0,72692470120
20180212,"PAYMENT RECEIVED",1314461348,0,144f871ee9deec87f2d988aa8d1dfc69bd6f5d2baab02028ed224bc3a60ec3e5,71398523169
20180212,"PAYMENT RECEIVED",1261199015,0,917ffde4cefe60a47be01144ce7c8ab35e0a998c0ec1bc4f096ace3655fb0db8,70084061821
20180212,"PAYMENT RECEIVED",1305713806,0,d163c7ec2c99825f5e52e926c407a2c0b56c3b6831bed920dc7f6ca33393ad08,68822862806
20180212,"PAYMENT RECEIVED",1297937474,0,2f53d80e95e2a19ca6040dfccb4f5db64e08091e4fa90a12b8dcd4acdd64bfac,67517149000
20180212,"PAYMENT RECEIVED",1378472833,0,20ae6166b4c2c0ba48f49a06ad33e69a176fa91528dc6919e5ae52d27b14ded2,66219211526
20180212,"PAYMENT RECEIVED",1311127468,0,0ddc91fd0d521ec9b7fca9a168a713559cb26463c1a4aa6057f1608f88803e60,64840738693
20180212,"PAYMENT RECEIVED",1298979924,0,a7c959126735cc551e3ffb7a9a1cbbb0b1b8d86c97e4c592c32a18daf4c13aa5,63529611225
20180212,"PAYMENT RECEIVED",1311524869,0,fe40e2924738978004ec5657f8195a5d3762533dd2f56b6e3250a271142b9698,62230631301
20180212,"PAYMENT RECEIVED",1324826683,0,9ab26db35c55f801d50d0b2ceaea9cb46c87303dbf7ae606486679755514a45b,60919106432
20180212,"PAYMENT RECEIVED",1274918832,0,81bfb3e16f4859a4d91b46530834d58f6530fca62ab62a11ab468ddd65379ab7,59594279749
20180212,"PAYMENT RECEIVED",1257375403,0,9e0178d6d9e33d937dbf4c471611ef0bd74113e6af4a79d3bcecaf35518c0141,58319360917
20180212,"PAYMENT RECEIVED",1292862326,0,46d6b94b92b10836915164d8709f00f616f530d95c387204058569ad6fbe837c,57061985514
20180212,"PAYMENT RECEIVED",1270465620,0,582cde49c0ac16b836d13bc5d598e92cb5bdac0116f611e3439d4f31633ab98e,55769123188
20180212,"PAYMENT RECEIVED",1326557973,0,f5a3b0192153719f763ee0e569a099a21007b74f6ea5eba70befbb4c2a6023f8,54498657568
20180212,"PAYMENT RECEIVED",1296239942,0,f6f2701d94509c731a2525792c162b5f0f19944c1f8a9ef122c50c95696c41b2,53172099595
20180212,"PAYMENT RECEIVED",1303073105,0,9f5e0fbd40013349eeb10b9e2fc9f14d74976bebf85a527b9476db6838ed847c,51875859653
20180212,"PAYMENT RECEIVED",1314419322,0,3ad518d103f5cd526b83f0584a79c61de4e8876da09fad509b6a23645fa864fd,50572786548
20180212,"PAYMENT RECEIVED",1301142284,0,ac08afb92f588f8504ab45dbce581a796ade156265b8382f87c6d72c65a9c856,49258367226
20180212,"PAYMENT RECEIVED",1290025246,0,ac1dbf2c3d975a9040448875c4924f0c585ad6fc4c0de8d98bc7b6ab230a110f,47957224942
20180212,"PAYMENT RECEIVED",1259511191,0,50dd3737e0e93b638e79848645f638465779fdde70a914172acd7c0ef9970d55,46667199696
20180212,"PAYMENT RECEIVED",1287875910,0,c2a6ec209d6339a614c8c2dc644b585facd52d437d0fc3bb6ed9ee87c953b56a,45407688505
20180212,"PAYMENT RECEIVED",1260203872,0,a9db59ecb72e02fdce9f291b2663237115b3eedec5a20fca5c9cb19c20572eca,44119812595
20180212,"PAYMENT SENT",0,-93733011750,332d3402c9b6b0be18f12e7117c517937d1e20e709db31f8995b6738273fc664,42859608723
20180211,"PAYMENT RECEIVED",1257726304,0,60d51a18d831a064606c2035350e50cfce22cd3962bd414a543c39bcebb2aac8,136592620473
20180211,"PAYMENT RECEIVED",1322351382,0,0861da886751642efaa9a9fd325c97fa66336b8165ea771e1702e0420be3659c,135334894169
20180211,"PAYMENT RECEIVED",1278462497,0,9a96b6cc9588fa25d6dd7028d548492f26cdef5dc4a0a25740fd1c5cbeb150cf,134012542787
20180211,"PAYMENT RECEIVED",1263279668,0,c1a7a6a6af62eb3ca07f283d1e75004d06729525c3a2ada87687e7be36ba6852,132734080290
20180211,"PAYMENT RECEIVED",1296359825,0,9a1251922c0f0efb795d4b70a3b1f272d1296b051882e408806fd177843a1150,131470800622
20180211,"PAYMENT RECEIVED",1262071289,0,4734ce7350376d3324e6facc7753d668e923501581b15ff080e102f9ceb69e09,130174440797
20180211,"PAYMENT RECEIVED",1287177020,0,475e71746759b7c73ab5724542416c97cc41c78a959a53b572635a560cc28549,128912369508
20180211,"PAYMENT RECEIVED",1261530981,0,0861dcc0e3baedf9d44d10ad9fd7629c72d5c3ef3b320b4df6b86c21ae727fcb,127625192488
20180211,"PAYMENT RECEIVED",1348612246,0,d406b8536d7680f7ba5d31b15990f92c939a29935e14492dfca456dd45b824ac,126363661507
20180211,"PAYMENT RECEIVED",1264227356,0,f0db41767222a9eb6da78d4fc3902e278a290cf8d1f7db2ebdb801cd1f473632,125015049261
20180211,"PAYMENT RECEIVED",1356498147,0,dc4f04579b53988f7a81a52c2d551593c35f51bb507bab79b82585401e33fedb,123750821905
20180211,"PAYMENT RECEIVED",1282302524,0,e4b494f2a31e221070e2a01b1fe6aa717bf0dcf8bc169e6a7b7e4a288e2ad13f,122394323758
20180211,"PAYMENT RECEIVED",1399814447,0,7af944de35843f6252225a180b8c08dad2649f9b2c26a1fae4c718059cf2cb42,121112021234
20180211,"PAYMENT RECEIVED",1323437289,0,3ec5ef5085d6272bedb8b596e4af47feff4852254848b18199a0b417451c1dff,119712206787
20180211,"PAYMENT RECEIVED",1279292253,0,b534e8d9fb0152099886287cd96a51ea76c0c049593d982c050ef110e999408d,118388769498
20180211,"PAYMENT RECEIVED",1255159769,0,ab404758233545fd784c9a27b6e27e5706bf03e5c0787325c859a794412c23e4,117109477245
20180211,"PAYMENT RECEIVED",1259923635,0,26af677e18b4ec8051498e3db786cc34ba9406e90866bbeaa4b206b47f184028,115854317476
20180211,"PAYMENT RECEIVED",1341794200,0,c2c369c103fc83a63e7d2b3565333f3c3d529b0e774041be522a0ed18e8614ea,114594393841
20180211,"PAYMENT RECEIVED",1271945928,0,3d0a06dad6775f6bebed4c394711c7fa67b58e71b33dcf96d2178bcc97f926e2,113252599641
20180211,"PAYMENT RECEIVED",1311015388,0,4b85c45f0cd1350a42d6c6d534a1a6778f4c02ee91452a2f7f2409fcb8e1688c,111980653713
20180211,"PAYMENT RECEIVED",1275494030,0,c1c1601ace120f6a8fc3ed38a36d30e42001fe953185f44bb95e2bfedade79a7,110669638325
20180210,"PAYMENT RECEIVED",1267201461,0,3e6bf81e251ae9514139ae5b53dc09d87a0d2ff34e443b2e27a950d8e0b48bc6,109394144295
20180210,"PAYMENT RECEIVED",1257249710,0,a4944aa3fbdde544f308f375bf5931934e39ca7b9851aaee1342d81f00b71f44,108126942834
20180210,"PAYMENT RECEIVED",1293348203,0,840946bc68ac52ed53fab076d7d9fa0318bdac6c136c009c80873613a4fc68c4,106869693124
20180210,"PAYMENT RECEIVED",1266987845,0,44570cccdc3ea7557e6141ee9d6928268a11660b370d79aa897a309276cffa19,105576344921
20180210,"PAYMENT RECEIVED",1305216037,0,8867c61df9a5d87faf6c0c9b3f80c89e62cc80a49fef2e36a81d2b130e677917,104309357076
20180210,"PAYMENT RECEIVED",1269727461,0,1374ddcaf28d890c4390d5135517a4efeadd2aa75e2ec815200b2867d3a83a58,103004141039
20180210,"PAYMENT RECEIVED",1363668670,0,3985b9af982bb4b6a9107965046d9adf7e65a345ca20d3c72b93cd8c444b2ed0,101734413578
20180210,"PAYMENT RECEIVED",1256047736,0,7c03893bc8cd13847337f00905aca0d5637d75cd13fbb593524d30161162544c,100370744908
20180210,"PAYMENT RECEIVED",1396526386,0,d60c1ff77a4dffbe58573132c86ea752c62efe981220c882bf0802c77eba0ca4,99114697172
20180210,"PAYMENT RECEIVED",1311536398,0,bcd1a9f3967bb32c985c69dd9eb2cff4fceab8de51b6aa929e6183e82e5d4f22,97718170786
20180210,"PAYMENT RECEIVED",1268066520,0,76274f4b7b4a4fa5c7d55f2ab1a1c4aa469dbf31875ae1c6ba78eef58815c2ee,96406634388
20180210,"PAYMENT RECEIVED",1308804438,0,405f6c93c16b8a3ed6f43b7150b6ad58f0cb2eb9d2e275d3a90fdad995897601,95138567868
20180210,"PAYMENT RECEIVED",1369422792,0,beb7f8e76e2a5c533108dfa9e0c8a746479a5869adf905ecfc1a613a0fc737a7,93829763430
20180210,"PAYMENT RECEIVED",1299524903,0,49b3c6a318792373e53978c60f7fbf1c663ed197cf3a7025c59d36b1f850b918,92460340638
20180210,"PAYMENT RECEIVED",1422098485,0,faacd31185e60b36ffdfba1cf018048df8715e343cbf76e8a97a368b0535bf92,91160815735
20180210,"PAYMENT RECEIVED",1396915906,0,e208eaf462482eb035cc7fc61d3c8635cf8a1863b7e9565cbe9ebcec2199fa1f,89738717250
20180209,"PAYMENT RECEIVED",1261863728,0,55ed3a832610678c0a4737a7fd5fc1618f257ef837d38855052f06bb6a55924a,88341801344
20180209,"PAYMENT RECEIVED",1336056490,0,8a7bbb562583172b6be3afa7c0faa145f86e643f968a42381fe9125ad90c9c44,87079937616
20180209,"PAYMENT RECEIVED",1403130678,0,faf2f54df897b988529aac79fb321df61d5f061c33cbcd6d165fa3c8d90e0d00,85743881126
20180209,"PAYMENT RECEIVED",1320659690,0,85aedfcd0c8296d4c3e544b6fe2ee4c7926ae334ffea8d227ba1450497c70418,84340750448
20180209,"PAYMENT RECEIVED",1298181821,0,632cbbecedc0a291024c06a5b1ce05d26b9f74f234afc44e28f365204cb6fc00,83020090758
20180209,"PAYMENT RECEIVED",1406141271,0,1d7cc3501450fdf329d7942ba1f26a17d1001d89bb5b3d2e44aa3a496c6d5713,81721908937
20180209,"PAYMENT RECEIVED",1312899041,0,5b49b84b9dcddfda1648bdbe0da5c250768bec9f9fb5051116fc0cb63d366586,80315767666
20180209,"PAYMENT SENT",0,-48692140609,9174719a88eeb9830f6bf98a67b74f99d7907e2aba1d11763e18b11a67611af9,79002868625
20180209,"PAYMENT RECEIVED",1314319272,0,953aea1693b74c8a6040f93ffd4384d401f43e0b24aaf72890712a37b91d77c7,127695009234
20180209,"PAYMENT RECEIVED",1326233518,0,e273b52eae2d45d57827606a6eef7fe4a3775f86f3f743b5cb2c896a6ed35328,126380689962
20180209,"PAYMENT RECEIVED",1294193630,0,e38d5026e8f1230a70f510e9559a17e3145ffde12c55fe871e8f27c3bd2c838d,125054456444
20180209,"PAYMENT RECEIVED",1371942040,0,434df349e47889cb58c3cfbc3614776a5176543815978f149172b4d20e40055c,123760262814
20180209,"PAYMENT RECEIVED",1306370340,0,c4074696fd4d589aeab94b380b1c0c84e422269a58a9ecd675d6622a689c945e,122388320774
20180209,"PAYMENT RECEIVED",1321454311,0,72688723ac8a0d2d7b8f03db38ced047ca73d1d30fd88d48124f18ce3a6f8cc2,121081950434
20180209,"PAYMENT RECEIVED",1329991761,0,c89a57a60dc64cfde4fe0e7c2cd6060f8656d58f54da13fbfd3f881f013c608f,119760496123
20180209,"PAYMENT RECEIVED",1308522439,0,c69a1bae91bcb0490ab6da4521d77ec02c2bc4990e1aab122479994753cf5cf1,118430504362
20180209,"PAYMENT RECEIVED",1354121816,0,e4011150e3eb7248d8949aa88676ae9b72227766038856dd219eae80e3d97c26,117121981923
20180209,"PAYMENT RECEIVED",1285949206,0,30ca752240aa9d8250cee5a6b168d31e96a89615a17c5e809abdf0e91d7879d1,115767860107
20180208,"PAYMENT RECEIVED",1275190274,0,baeba4163e9e176842096e9eec37cea7121e7a7fd0240cd225f3e46d70791465,114481910901
20180208,"PAYMENT RECEIVED",1278508968,0,bad85f803ca3e3f4b3d603cf6a42b170a04cd9614c17a8bfd668ad175c01ead7,113206720627
20180208,"PAYMENT RECEIVED",1379604163,0,a311a069a9c3e72b4975e191531d32b0b8fbe18df263721231cc38357ca6cf68,111928211659
20180208,"PAYMENT RECEIVED",1298681551,0,865756db9162b85b4f82d51b552e8e257f27ffd70815e399eac1504f9c7c7dca,110548607496
20180208,"PAYMENT RECEIVED",1306321324,0,2b97fda328a8552756158a545b6c3b24dd900adb3c31ad4177d9c270cf4af789,109249925945
20180208,"PAYMENT RECEIVED",1384147704,0,d36512fec08977564c95b9b919c8a97695568c64314467886be3d683fe40783f,107943604621
20180208,"PAYMENT RECEIVED",1460966613,0,eeaa2284e07e295e41be4677ee37b5e4e46bd4e9aaf2814ff67b0b7649d27cbe,106559456917
20180208,"PAYMENT RECEIVED",1294289972,0,398d4f163d0793593d544d0689979664b887d4c47b13d9ce483d8e3228e0f7b6,105098490304
20180208,"PAYMENT RECEIVED",1301438635,0,77c2bbeaa79fde660c7d5d6fd64a10e38139533b8a96dee32f405e3f71192de8,103804200332
20180208,"PAYMENT RECEIVED",1278036247,0,30a6bd23847bafac7a481731ab819ecac275e156b127462a380cf7baf27cef39,102502761697
20180208,"PAYMENT RECEIVED",1362676780,0,320246049bcd016e2167fc0933e16f6d05974d7b5b53489782017a8196b74a06,101224725450
20180208,"PAYMENT RECEIVED",1341916902,0,f3aa727e808304303c5544553d287806357f4c1dd53bc8dc351851cc54f8bf35,99862048670
20180208,"PAYMENT RECEIVED",1334537461,0,a1ac07484481674b9ea54184fbf67784c7584ee5481c785070cf027b6848ec0c,98520131768
20180208,"PAYMENT RECEIVED",1281687933,0,a1a445a13dfacd04d9f453976c20b2bcb8c5ad7f6ad3b69ba01531fc733d04cd,97185594307
20180208,"PAYMENT RECEIVED",1412244910,0,eea07924841d00a404f65afc2b404e8765d342c1d415900711459cee8939fdbc,95903906374
20180208,"PAYMENT RECEIVED",1271371393,0,85288d90686fafce1101e1339d9e03cf557ae8b717105365d12a1043f517f65a,94491661464
20180208,"PAYMENT RECEIVED",1260878242,0,199858102e6d938a3297689e48ec2b2bd8b1c8de53e62ef658f922c03f09a769,93220290071
20180208,"PAYMENT RECEIVED",1369650079,0,18a22dc660ba4b60cee9371b73d6fa80717ba765b9f749fb6f8772a096369d65,91959411829
20180208,"PAYMENT RECEIVED",1267193635,0,1ed4a5d35693d4bc6403f49a5a8af71df80cf50a8126ebd092028dc8e3d0b430,90589761750
20180208,"PAYMENT RECEIVED",1257172367,0,572524da4c9f0b621207231a07c3b4db0fd40ca54a5931115e05548f5ec42d88,89322568115
20180208,"PAYMENT SENT",0,-87807822431,4f9d31e7cc3a718f5ec25a10b2eceb4242ceca9d34c84dcf6f8cd9ccabc8f4f2,88065395748
20180208,"PAYMENT RECEIVED",1252524607,0,94566cddde70b2be4ec991f0b5a541bc5f1d4b48531929a452f05640f882b4d2,175873218179
20180208,"PAYMENT RECEIVED",1326241904,0,4c4c052a031f51a51268c252a0e8ccb6ce5e25f38983c1add6ff227c4e208c2c,174620693572
20180208,"PAYMENT RECEIVED",1302058178,0,bfa30c8b06665c7aa6d8ec24b62f20ad03ef77b176046e6f082e21ae48c72396,173294451668
20180208,"PAYMENT RECEIVED",1316955910,0,6ea0e64d509590fcb1d28906bbecc00373723d1987fc62a2afdc31006a790f55,171992393490
20180207,"PAYMENT RECEIVED",1271576605,0,3131e149fc6e05cddb6d511de50fb57e2d5f7e8dbd31d4f3a42127a6d35d8a4b,170675437580
20180207,"PAYMENT RECEIVED",1388653911,0,fb5c6e373b03ec2226574780f340b881088355bc02a9a98f9d9a65afd5670054,169403860975
20180207,"PAYMENT RECEIVED",1302014096,0,8a73b6b14ebdcf8762c6f5085f286ec4ab586423b13ca223e4f7827529c4e4c7,168015207064
20180207,"PAYMENT RECEIVED",1288888603,0,be0cd3d8d8cf4d489cd937c08ec4deef451ee4d28db5fd9a67c28ce3a4d7ec3e,166713192968
20180207,"PAYMENT RECEIVED",1267099262,0,a5b6c3adeab9659dae5428c3ffe9aa3f5754bbe092c1c119a8f6f09e538b7a8a,165424304365
20180207,"PAYMENT RECEIVED",1257828065,0,6dd6834c46b17adce25ba7d3784a1719fadebb8b7fae1d2010c099b18000c2db,164157205103
20180207,"PAYMENT RECEIVED",1326182183,0,a2fcfb6535b39b4942d64b9d506021247c3f8bfaf366abbb396ef1a26a17ecf5,162899377038
20180207,"PAYMENT RECEIVED",1327352350,0,9eafbf402ef1c583614ab6dfbd90ae231b0373cfbb4b213443dde75144fe2a66,161573194855
20180207,"PAYMENT RECEIVED",1290222747,0,ec8f36f65030bcda1b5f0f39df186a96cba032f957ab39dae1f145c80cfd4f25,160245842505
20180207,"PAYMENT RECEIVED",1334832514,0,aa29b6197d0b20e5fac6f0949a5dc6266a141f3cdd4dce1fd1b1a175e7be74cd,158955619758
20180207,"PAYMENT RECEIVED",1267154431,0,2e52fe57728297d670189f47ed1a4aec9fac30e618c4259fb4e93331c478919a,157620787244
20180207,"PAYMENT RECEIVED",1268888675,0,0770c1298a966b373330ab620213adab9b0e598244b832fda6ae56393929af5d,156353632813
20180207,"PAYMENT RECEIVED",1304020202,0,a2ae011a0a726dea50e32ea47697922ab04d14978aea4da99bef710d6ff3882c,155084744138
20180207,"PAYMENT RECEIVED",1315335210,0,890c323343cd6264cf6b7d21b6d532e50defcaa87fcca53bab0158632df010d1,153780723936
20180207,"PAYMENT RECEIVED",1442351277,0,8f6d2778d5c2ac4fac56699f450f77b0b46a899bf507ee4209bec987abd91138,152465388726
20180207,"PAYMENT RECEIVED",1425378122,0,a5b96b6f9d83b20cf21c92765a51a67ceb08cd2753f003cbef4608a506cf2675,151023037449
20180207,"PAYMENT RECEIVED",1286670052,0,7b4e692f69c1bf68cb49b70f8018d245b8b0b129a906a5a8e8844fbb7307c081,149597659327
20180207,"PAYMENT RECEIVED",1323315706,0,8afef6be3cc4d0a246602704433e5caed660b22fceae8b46f8336d5afc1ace44,148310989275
20180207,"PAYMENT RECEIVED",1367980836,0,3a781606198e729d68aaf9fac0c9196a6a0a1dbbfe214db7ba3e88f90f039893,146987673569
20180207,"PAYMENT RECEIVED",1371493002,0,59a683a62b2ee20b8da7c616ffbbf788349d104085ca416cfb496eef04369eae,145619692733
20180207,"PAYMENT RECEIVED",1389444305,0,e763afb98ebfd3c4e5334f36fa642fad7fc10f74bab38099db54dea4dba627ff,144248199731
20180207,"PAYMENT RECEIVED",1397763300,0,94f26893cc333ec787af2d8eb7cbba61e69ad50079e308ac30fb7c08092dc963,142858755426
20180207,"PAYMENT RECEIVED",1340244346,0,beb5b5b1c7231a7d6a287724fc19af8e946af76ef0b7fa61963395bff2f20af3,141460992126
20180207,"PAYMENT RECEIVED",1349135682,0,ff726a30cb124690c55039d3ebba43187222ae2eb05b6a71b53b68e2d2d8950e,140120747780
20180207,"PAYMENT RECEIVED",1322383278,0,70d69b8479a554f23b5948b6ed69845e3966b0c673f68f189756353b4c96efdf,138771612098
20180206,"PAYMENT RECEIVED",1405120881,0,c470006370384a99369e5a9a4a285b5b4443ab852fb7e5e212901cef77bc8b7a,137449228820
20180206,"PAYMENT RECEIVED",1350014979,0,a8fa34cebd91788e49adf2d2a3eb4800320a535070f0bbf23a8541748831f4e6,136044107939
20180206,"PAYMENT RECEIVED",1279608624,0,fa5a273d244f5c8753d6f3098674370fd8de11a9ab50e8c21744b37681faf353,134694092960
20180206,"PAYMENT RECEIVED",1282374684,0,6763bec421311e673ff835d837ce77fd2e418b64609182285fba7df0d5ae6e8d,133414484336
20180206,"PAYMENT RECEIVED",1383626846,0,28bdca7136eb56b462d6abe1c031cf77eb9d83e5a45358da063b2087b278d104,132132109652
20180206,"PAYMENT RECEIVED",1371167164,0,9ee9e90e65be3239f4b2e658f4a75f0ebfd511790a3102fbe2ebb29b2854e760,130748482806
20180206,"PAYMENT RECEIVED",1450990337,0,01b1825fb6f0bd8a2cce65927fcd01fa20e61537447e3c49530ebd3d3ab1c754,129377315642
20180206,"PAYMENT RECEIVED",1289556959,0,c83cc45c92c49c8d19ba786c62b4a676c3c671e5d589753f6ac25d13f8ef7839,127926325305
20180206,"PAYMENT RECEIVED",1314781853,0,02ec6bb52c5c38b836e445a2410ecf1a25fc699bff362b79308d0d13f399249e,126636768346
20180206,"PAYMENT RECEIVED",1447102037,0,ee58db8a6a69769e0ad23405fb4abc7a54a835b2dcbffd106eedb8cd413d073f,125321986493
20180206,"PAYMENT RECEIVED",1333367078,0,9b6ff8b04569ce0c3f22bcc68ced3373405857e67b18601b1c273d67873c1168,123874884456
20180206,"PAYMENT RECEIVED",1405708684,0,58bd655e1ec3533696883f0ab9039f0cc4324bb4fd8ff25684fc91a7d6eb1d4f,122541517378
20180206,"PAYMENT RECEIVED",1286267956,0,8a89abb0db4d54b4dad67f49ba00233a6e0a4ca50ab0a7da9bca0235a78bfee8,121135808694
20180206,"PAYMENT RECEIVED",1274054206,0,5963f6356b126694272434d8d7fe75ff06ea88993bfcc6fa83309c304110b53a,119849540738
20180206,"PAYMENT RECEIVED",1260687742,0,291f0178c2a3c559c8156001e27163316c46d134333430f95d6b667409e12b0c,118575486532
20180206,"PAYMENT RECEIVED",1330397524,0,0f0019063dcd994d3cd1e9cf97296ccf179db71fb9cb8dece4dee6a96e480966,117314798790
20180206,"PAYMENT RECEIVED",1363655794,0,320f261dee1fff4962aa8397ab7af2a86c6d1546da802b5216d6368e4bac1b3d,115984401266
20180206,"PAYMENT RECEIVED",1384236918,0,a476fc71455f63afd4f4d3190ab3d82b5d5e17d2e74f6fd69b2cc310a6e0f0c7,114620745472
20180206,"PAYMENT RECEIVED",1439574625,0,eb3dfc694ec42406a96c5f3c49ee7dc0b4c400b31b563ff36aecd90c781eff38,113236508554
20180206,"PAYMENT RECEIVED",1250000000,0,d86dd7bc7d818197b722b7e0cb3e564b3f9c770c09940cf49b143706383ed955,111796933929
20180206,"PAYMENT RECEIVED",1425028065,0,ef3d713d8df026afd5a85b0f1aa525ba6e27199a2d9c5b15b2b001b9ef244c59,110546933929
20180206,"PAYMENT RECEIVED",1419050885,0,8fe363d8d6ca4d312e3bd641b470c510ed5f32e401f4d92da2af75f9cd3b2b79,109121905864
20180206,"PAYMENT RECEIVED",1263027069,0,3c9377e44c295c22c16238433f71abe635f9f706a809762a519b67d137856d23,107702854979
20180206,"PAYMENT RECEIVED",1269925043,0,e9e4ffb3e70268cf69a9f4112c1b107b54531b6782b673b23485061ad14e6ed3,106439827910
20180206,"PAYMENT RECEIVED",1266835213,0,5085f962ecf4c1ba03c12b6a7ecd0e75f602b31e4a0ec78da265ecaf65a6c034,105169902867
20180206,"PAYMENT RECEIVED",1343749735,0,135d8a3c539e42a98e88de09368fe8690da0ce3b55f998a87dba3040dbb3a78f,103903067654
20180206,"PAYMENT RECEIVED",1462058051,0,312c139c394c76791c603a305905c771bb05216c6bef32e40a820cd58ba91448,102559317919
20180205,"PAYMENT RECEIVED",1326999523,0,0a65ac2923728cb5f2b244af4f60c102f39fe1c880c61d474ef3a10ba840a8b8,101097259868
20180205,"PAYMENT RECEIVED",1291225702,0,f365a23b104a0c62cb8b441c5022ae401b868cd40a3ecf5cd7333fd18745dc03,99770260345
20180205,"PAYMENT RECEIVED",1367521168,0,497ed7fc481307f4d4ebfd421aa3ccd6fa520a5c85ad50d830ef6141408ac64b,98479034643
20180205,"PAYMENT RECEIVED",1374951824,0,57cfc36ee8c37dde4796857b85f59f561082bfbd6d294092a5dd23707bc48393,97111513475
20180205,"PAYMENT RECEIVED",1342877729,0,8afbfcbc50d3151b1f52420a839f833f3c1aea867115c17df4eeb86b7cfd71c6,95736561651
20180205,"PAYMENT RECEIVED",1317770790,0,92fca714011f363c9a187dda67c7b3c3571ee2f356cd2d23a83abc3ea97a347a,94393683922
20180205,"PAYMENT RECEIVED",1297330699,0,7f6b956c0091df4ff3e7e546bb0b4f7b4775b0400a5c86bc8a1edf2cff4520b8,93075913132
20180205,"PAYMENT RECEIVED",1427201795,0,bd4c90f4671ce8f9a21beed17685b7b41df5c2d064daa6019d0aa41ee9509f7c,91778582433
20180205,"PAYMENT RECEIVED",1305224259,0,0978258f0eb126c7c1d5bd9d6a799e690546c74811567a697e480ca772725177,90351380638
20180205,"PAYMENT RECEIVED",1409122052,0,ea142bf21a9af41755d19f4dae8259197078947021ed4db217a7cdea4ae238cf,89046156379
20180205,"PAYMENT RECEIVED",1300205360,0,0020539061a728351906a769a2ff9fe2c4c4bd7bd2b3de31dbcd0adf716f8501,87637034327
20180205,"PAYMENT RECEIVED",1350658959,0,cd08d9fe61e39c1c05eaff958296cd7ee7e05296ecb372eca35dc726c240902c,86336828967
20180205,"PAYMENT RECEIVED",1491083978,0,f7c9a0af4369b21d201c1e0ad5dc83628e1a98313fe1f9431e145133cb2b1e71,84986170008
20180205,"PAYMENT RECEIVED",1381596423,0,4ece2c5b08934e9b7953b661b16e008c48d4ce90e9a28751ab19caf8345397c1,83495086030
20180205,"PAYMENT RECEIVED",1376514545,0,6a851ec7e40a27fcd910efd59a67aafac0fa689a2f999603393be1b18e5dd188,82113489607
20180205,"PAYMENT RECEIVED",1449210222,0,5e9d2e1eb915070311cc23defc7d55f3defe106dddbc08b76646f78dd9f1d162,80736975062
20180205,"PAYMENT RECEIVED",1302651914,0,58d40a18ebdbfc7336ac0d49b8b57141fcaa42991bd97bb22d7241d27b42314e,79287764840
20180205,"PAYMENT RECEIVED",1307158580,0,c2b4cb1f83d82dee0b6633846362bd12978a548910257d7e25cdb6d2b7c42a6a,77985112926
20180205,"PAYMENT RECEIVED",1360476201,0,5b082b8173f44978279afde746a5316256cfddb58dd04a1c80ed9abe535da2cc,76677954346
20180205,"PAYMENT RECEIVED",1288251549,0,2cf83bb4ceae976ecbb72915de040ee87521954c72481127c0eb717e0cd28d4d,75317478145
20180205,"PAYMENT RECEIVED",1345548162,0,362187fc915c7cc35ec916b921e726750aba12a22e900579093550bd79b09ade,74029226596
20180205,"PAYMENT RECEIVED",1426510998,0,7e885c67b68eb8c07fd46b6a8dc4f0dfd113275198535952f151f62a5d9bd81e,72683678434
20180205,"PAYMENT RECEIVED",1276579154,0,520b279f9903462bc0453b67749e6a794c8f2b505a07d70658b57bdee54490a1,71257167436
20180205,"PAYMENT RECEIVED",1253276057,0,36ce9e797c907cc0ec0a6146e600c0273c6039349ad2b6e8d0b92fb3854adf6c,69980588282
20180205,"PAYMENT SENT",0,-35998223397,25fd8be8ce7c83bc99f8fe9204dbf16a14b40b969c82baa46da816521b914976,68727312225
20180205,"PAYMENT RECEIVED",1446436970,0,ef501a71d04c8f6f4a1678f4d6243e2f8075037bd89886f574011e8c4393bf30,104725535622
20180205,"PAYMENT RECEIVED",1357628458,0,9cb632ba2d1da6ddf17fe0173ac8399ccd3df49576a804552637a17c71d64bed,103279098652
20180205,"PAYMENT RECEIVED",1335934820,0,d466eaf11abfc9d683159d31cc74f410a487420635f2d7769cb62fb4acba1879,101921470194
20180205,"PAYMENT RECEIVED",1253183166,0,03fe6e04e9cf5f6cd6ea524e1abe37e753ec86c321bb8cb91163893d94db0ddb,100585535374
20180205,"PAYMENT RECEIVED",1313437606,0,e3f820d1052fd6f1a1834e3f51732bfae91faf4e248a245a34e4d77c7478cb4f,99332352208
20180204,"PAYMENT RECEIVED",1256771824,0,097f32bdceab39b710d047250522b55314ea69b90eaca1432fad90e0a199daac,98018914602
20180204,"PAYMENT RECEIVED",1332375743,0,5aabd1f0db033277ab21783012695ad0f9c1f481ae4ba524f11a5f51d153df3c,96762142778
20180204,"PAYMENT RECEIVED",1300152615,0,12f49f3bf583146e62043ed474f879c85a3bb0caeb556f0e91e1d6dd4516362b,95429767035
20180204,"PAYMENT RECEIVED",1302523375,0,fbc5071c025ab22f6a9cef420d75fff08519d4f9889b2a19dc48a7677f04b0c2,94129614420
20180204,"PAYMENT RECEIVED",1337099562,0,0e83a2d31314825580a923a2f3028e75edc7c870abbfbf222d8f7da99fed0973,92827091045
20180204,"PAYMENT RECEIVED",1289221923,0,8fd9f359af67ab8f9a2b60340100c035b927d4869e24c01e63b772e74331c38a,91489991483
20180204,"PAYMENT RECEIVED",1279859204,0,13a39a0a7529b72a59d8cb12cc56532a8dd7e2f92ae4a81ed7e7756a51c82503,90200769560
20180204,"PAYMENT RECEIVED",1258846719,0,2905adc6776920cc0365334a2c84b23a7ee6ce74d70c7aff05817fbf29518040,88920910356
20180204,"PAYMENT RECEIVED",1356946127,0,87924d7ed214262b4c609453b96d84350ae00680c50a3f550694dd381b095b6b,87662063637
20180204,"PAYMENT RECEIVED",1330878220,0,28429819040a7ca7ff7bffae30084b2e118b2c9007c91055ff9c95fec7026870,86305117510
20180204,"PAYMENT RECEIVED",1324933085,0,4a4bdc2a1bcd90eb63af1f2da95313e9fab8489dd0d4ddd765faf8a91b23a3f4,84974239290
20180204,"PAYMENT RECEIVED",1269276343,0,62c9fa12d6948e900178e1445ba67be2a3defe07c76716a47a0b9e8000a5e003,83649306205
20180204,"PAYMENT RECEIVED",1254292026,0,d0b138d39573bbac796cea75db5bc4c20a51a29691f81b464c27e2730645b1dc,82380029862
20180204,"PAYMENT RECEIVED",1278664791,0,c9986b7d25be822469f29e30a8a4dc9a35962de3465140e56811a5334c8fe5e3,81125737836
20180204,"PAYMENT RECEIVED",1273130707,0,9071de8565b5e8c60a13d85b6c13b6539eedf1710919d484d8e635d307a351e7,79847073045
20180204,"PAYMENT RECEIVED",1386364092,0,eba155ea473556c261387718963447d1cabbcb5e8904d1ba164724c02e5d1753,78573942338
20180204,"PAYMENT RECEIVED",1311845478,0,312d169e7f0297d4f09a9113c10ffb11ce557bab979cde941174b3af341ac4e9,77187578246
20180204,"PAYMENT RECEIVED",1445066608,0,cfec1ed3bdd5cf354c04b5d1e66cad0c25b80568dabbb5e8fea7c939d98ca034,75875732768
20180204,"PAYMENT RECEIVED",1308730131,0,537175c009fabacd2b91ad8389bb522289f215fbecec2947143c91d35960b234,74430666160
20180204,"PAYMENT RECEIVED",1317435227,0,69888f7f5d8b64b04c2684b917cd039067687050a145b15fb4625572399a411e,73121936029
20180204,"PAYMENT RECEIVED",1417619069,0,106daa612d618f5208fd0b0347002ffefcb9c90fce7007bcc15c390db499a69d,71804500802
20180204,"PAYMENT RECEIVED",1265559396,0,7a900af59d160cee66537ab253ed4b1e445d613412a7f8a387827d7a3470c503,70386881733
20180204,"PAYMENT RECEIVED",1263691877,0,a40b5bbaa863f9299077d39f450a0652e1d83df52e92cea0a596fcb7a231a967,69121322337
20180204,"PAYMENT RECEIVED",1290680177,0,4d2c37581aef389a089b063b67a2503a56198a56732428773b94c1b2bca70bb1,67857630460
20180204,"PAYMENT RECEIVED",1255520100,0,8f25b03acc61c0c5e3ef9225cc98dd3cb52a6663ae5b9b6ef8c312f1ba394822,66566950283
20180204,"PAYMENT RECEIVED",1296826976,0,3dbe7b63b81e26676b032b02cf7949afe3bc2368922c0a1162728ef83792c3ad,65311430183
20180204,"PAYMENT RECEIVED",1325458919,0,db3479c84e5ad4dce4c0e6141da4e45df077eb4d0d94af1abed32bca28e6fbe3,64014603207
20180204,"PAYMENT RECEIVED",1282056270,0,7c5b867e47df56c57bb0acfe5e662bc14be4bcbd0e92e3845d1bf5a79e9f40f2,62689144288
20180204,"PAYMENT RECEIVED",1374442329,0,22a866d6eea59941d8b17d3245b72598f985245f44940fbe8f10728b4340568c,61407088018
20180204,"PAYMENT RECEIVED",1273611844,0,294a9f1ccb1cac190054ccf354c91009fcd381a5c5154bd5257905365162beb9,60032645689
20180204,"PAYMENT SENT",0,-79587939930,889e6070a83929e0083c3895995dc7ee26e0eafd1b990b5f97611cf6dfcb832c,58759033845
20180204,"PAYMENT RECEIVED",1265981067,0,f1bdc1c5d525e6538145ab30a9ca61372f0f09b7d8329afd4ea7f938a7ae5151,138346973775
20180203,"PAYMENT RECEIVED",1382586585,0,96003527057a8c55bcd66337748a1430c525ad3081fbe04ed6e8fc3ddfe9f588,137080992708
20180203,"PAYMENT RECEIVED",1347046447,0,80b8aaed3a9910d791d615cbd54bb35d72cf2ad4ab4f04fd5074c12359443d2a,135698406123
20180203,"PAYMENT RECEIVED",1311452925,0,7257a8760b57e875b74c168814dee376e28fd156a58d62749ee83d5af7fee56d,134351359676
20180203,"PAYMENT RECEIVED",1310261163,0,180a2b627b3a3bf83e10a8f03e69898891af020144e1bb00f7448646492dfc5f,133039906751
20180203,"PAYMENT RECEIVED",1334341558,0,0d67b5c163d59953bedcf03f17a99e51f73f3edaa2fbf1556cb3230bfa7cc033,131729645588
20180203,"PAYMENT RECEIVED",1254044188,0,5979af37cf8806e7b07a69501926341f942d78a1df45330746dbd771beb4af6f,130395304030
20180203,"PAYMENT RECEIVED",1262128625,0,f91b37aa7bd6c7fd6cdaecdb6e30a56f1ed04ac739bd8a7ddcc35e4b24cab239,129141259842
20180203,"PAYMENT RECEIVED",1335458675,0,439bee013323db8e3fcaf7edf82f18c2a278c52dd972148b2e6a06d8f8c4ce5a,127879131217
20180203,"PAYMENT RECEIVED",1312958272,0,bc36acbfd4596731660326dbcccf26a76a4c90e686a69bcdf2fb3bab1e54b2e0,126543672542
20180203,"PAYMENT RECEIVED",1417238880,0,8284dc935cc55b1f47ff7a9d392a0256fe8bdab26af3ee30fa27f7eff4aca761,125230714270
20180203,"PAYMENT RECEIVED",1330224677,0,94fc66c052a4617b0b23bc0d792a548a801b8b977ba9fe66541c42c204aa0c8f,123813475390
20180203,"PAYMENT RECEIVED",1280418562,0,5786e9a6711d73d55a5c754ed91206e921e11288866207354580ea200ba1e8bb,122483250713
20180203,"PAYMENT RECEIVED",1274221761,0,12fda36ab4adf984f8db6acf1d399436508d0e36c0155549dc83ccc6bc41fadc,121202832151
20180203,"PAYMENT RECEIVED",1459095972,0,b1e5b2b89b85c2e6db60905ba86d7343279d8d76b1c70d112c30eafef5d0da50,119928610390
20180203,"PAYMENT RECEIVED",1415839217,0,2a33613d0d8cc37950ab49cc8bec1ebfa5977b4fab85d9857643577cd676c798,118469514418
20180203,"PAYMENT RECEIVED",1337566483,0,3573a010ce3dd6b6742a57b74e49699ad75fa6e6a246e59665873577909f08e9,117053675201
20180203,"PAYMENT RECEIVED",1347794988,0,2f9c4d3be6ec8aaa9c474149b19ee26f863921a9fddca9be48b22cf514e040d0,115716108718
20180203,"PAYMENT RECEIVED",1278863225,0,b210a56d0871de2e87fa2b0756e1c543d7411abf8c628d4f935cbaf774efdea5,114368313730
20180203,"PAYMENT RECEIVED",1318699295,0,7b9af2a892d18d6d97e4039ca397c3b6760f2f5bcb3171d16d935ed7ce9844e0,113089450505
20180203,"PAYMENT RECEIVED",1428541310,0,d4ba595bc499827197519c8a8a017aa7c30579dd35a4029dd65ca64335425037,111770751210
20180203,"PAYMENT RECEIVED",1353867465,0,315fcfd95fa893bbedc26bba2c4734b49bfcc478b11f2b14406fcfa1e427ee87,110342209900
20180203,"PAYMENT RECEIVED",1352233403,0,899db24c7bbe02516b01a5368426b865924577a495d1e362edf8cc4e29eafdcf,108988342435
20180203,"PAYMENT RECEIVED",1335273570,0,f8951e733d971b5226b8371f29b52033bfdea7373fb433f7b183ea85d8585705,107636109032
20180203,"PAYMENT RECEIVED",1346679000,0,58c73fa2a8ae7a51ee6c4869352b0a896a1d1ce2619be85e6ea86213582173e6,106300835462
20180203,"PAYMENT RECEIVED",1383896818,0,ddc9ccba9fa58018366fa04c19db05fb6292280b3aab9da60e7f591074b2170c,104954156462
20180202,"PAYMENT RECEIVED",1406130843,0,13afa22d6de1d16940a5697ab961bf8aa96108a772d4596598599b09842c1b8b,103570259644
20180202,"PAYMENT RECEIVED",1418359085,0,8a04845ee68e86bfdae37cca2bad01fc69e088f851bda510b888514ba1f200ac,102164128801
20180202,"PAYMENT RECEIVED",1401175839,0,dc3248a89a3bc132ea5b050e3207a023beff2ab14cccdd002cfba70d6210cb59,100745769716
20180202,"PAYMENT RECEIVED",1373896454,0,7230670259a1ed8c161270987924196e5d5841ce0f6c81bf063c5a54690a35a5,99344593877
20180202,"PAYMENT RECEIVED",1449036835,0,482137400208a8cdf3813d6bbc12590ef634a6eff1a0e0fa481537928f05b5b4,97970697423
20180202,"PAYMENT RECEIVED",1410106248,0,7b7050ed79e4d535ade8aec0585c27ebc7b811ce0fa1ea4c62f63ffc13bc4eaf,96521660588
20180202,"PAYMENT RECEIVED",1413223211,0,1e44e54f3c1f5bd6ca0e05f3dae9eb6c89c5b5ecbe62e48769685856b55757c8,95111554340
20180202,"PAYMENT RECEIVED",1435661938,0,2380927d2715ec5c6a8c35cf56bad71c08c1623a40cc25abae2667769392cdc9,93698331129
20180202,"PAYMENT RECEIVED",1430359980,0,d34b8fa6a784ca458e32646bcb6a7467c74a679ee3edfcd44aa119ac143a3975,92262669191
20180202,"PAYMENT RECEIVED",1456164803,0,5f48d9bc9197bc94300a91b2c1c4128a71fdf4da11627d3fbbabe6f5012c3077,90832309211
20180202,"PAYMENT RECEIVED",1430212194,0,4cbc0995fa8afd47a7b96691d7d141e3699af64cfacd1c595f060d895d8595b6,89376144408
20180202,"PAYMENT RECEIVED",1457483270,0,0820c71fc9b1208fb685faa642b5004be6dd7b51844071998f7a82d0c02ec6e1,87945932214
20180202,"PAYMENT RECEIVED",1477176948,0,73ced386de65ce8766194e9a500b9879ed482bcd35b6a44147106295f186b8aa,86488448944
20180202,"PAYMENT RECEIVED",1431903290,0,b64bbd050865d50cd4a2b4a8e5eb41951d4b56b77bd505c526ca42774bf5a727,85011271996
20180202,"PAYMENT RECEIVED",1480328381,0,c78cce378057cbdd709fcc05495edfac52914b2ebe9698bcbc6ad984eb00faa2,83579368706
20180202,"PAYMENT RECEIVED",1437268206,0,dd19f26fc16a8f87b3783859aff859e77a87975a56f5bebadc2680a91de56983,82099040325
20180202,"PAYMENT RECEIVED",1440294948,0,2f7c1811c97cda24e27777ea088a2f1c9ce6dfcc1c1c36c96fcd2435040b2590,80661772119
20180202,"PAYMENT RECEIVED",1433773014,0,37cc7c54b74812e3412cb3c9e51fdf5a9394417169c9fa986ec64d80d48dc5cf,79221477171
20180202,"PAYMENT RECEIVED",1443893691,0,72bcc7f18e37efbc6d9d267004e8e212fb82b19ee07ccfb6c49565d871aa2631,77787704157
20180202,"PAYMENT RECEIVED",1250000000,0,80a9f3fc2ec6fab130c65f4e6aa65e72934d636cb517048575277a3a1e41b442,76343810466
20180202,"PAYMENT RECEIVED",1250000000,0,3dea744b46d1ca84831f8d387e6e078f263fc5976d349fa1e781319e2693ecf7,75093810466
20180202,"PAYMENT RECEIVED",1442732143,0,0e15786342a4ccd3ff57256870349564658dba10e12ea4f03ae27f781f8eaf4e,73843810466
20180202,"PAYMENT RECEIVED",1444918912,0,0f6da7ccaed21aa5e1cf007c563d75c6760581e1ea213b2886923828ee4df29a,72401078323
20180202,"PAYMENT RECEIVED",1474621057,0,0d260023f7f7e73b914a04e7d8a773f619544b3011856351d5b0f5609e721b67,70956159411
20180202,"PAYMENT RECEIVED",1437458085,0,01e319a90b028e48742e72e86e30b30deb1d0cca10c71ceefcbdbad18330b5e2,69481538354
20180202,"PAYMENT RECEIVED",1453586716,0,07fd78f1f58723756da4bac906199ece9d1d29946a53cd7fcfc2a5b45b041485,68044080269
20180202,"PAYMENT RECEIVED",1379064835,0,163baddf61663fd5bc445042290b851ba85c9c0612e89a76c16f7e58260ac03e,66590493553
20180202,"PAYMENT RECEIVED",1391237261,0,9c54012e7e4af8866b528bc097e6d3be7ff3dcb1be2ba882fb4d4bfb85ce721e,65211428718
20180202,"PAYMENT RECEIVED",1250000000,0,8781657b086fb41037cdcdc448f0c2cdedd1bbc31cf770d8c6e3d32585f82d90,63820191457
20180202,"PAYMENT RECEIVED",1377169970,0,ba5e0b103ba077879a49614633fe6bd1a685e0b8c1a17882b984553c0f195544,62570191457
20180202,"PAYMENT RECEIVED",1250000000,0,f34bb6fcd7fff90f474955c6e937be3b8e5a0f766ed88ff27712cc02e8ceca36,61193021487
20180202,"PAYMENT RECEIVED",1268605968,0,dc734b7ddbc87a97bb4ff0140fe6e494d5da2fd3fb167c01b89c831364b1c6c2,59943021487
20180202,"PAYMENT RECEIVED",1361385746,0,3ba39bfe2ada61e317dcaedfbf4a9e930d919ec673d2bc160dae60319473daca,58674415519
20180202,"PAYMENT RECEIVED",1382439171,0,f65f770b9ddb8953ed17a6d8b49f65766e974b188a27f28045a7cedf41a23545,57313029773
20180202,"PAYMENT RECEIVED",1257658552,0,fcff6f1b184fc2f7065ef2029ff16bda5490b243a2433695f39aa56896543ffa,55930590602
20180202,"PAYMENT SENT",0,-18623472282,2e292c0c17d7a48fbcaea01bea239617d0d1dc572a07fff1e446bfeb4fbe8791,54672932050
20180202,"PAYMENT RECEIVED",1425655077,0,ae331d7b02082d5f5dc9cad12b5b9422d99af95409ad8e47f413fc7662d120b3,73296404332
20180202,"PAYMENT RECEIVED",1405411606,0,6e98e96774d9b89df56c6c3b0000ca08d1a29b5630a712c50f5d0b6f350b660c,71870749255
20180202,"PAYMENT RECEIVED",1426465107,0,1c35b440cf73644a343b185253bf7ab845b5e719666a3779b90bd388dd99b3a9,70465337649
20180201,"PAYMENT RECEIVED",1290748716,0,756fc7aa8d621a40e48c324f9b66ec7714e7c8316210e8d367510a4fc6fff6dc,69038872542
20180201,"PAYMENT RECEIVED",1260454136,0,9452f12596161632fe3ee8aaa621912784d6fe23d0f7721b4aab4e77fc5b8a19,67748123826
20180201,"PAYMENT RECEIVED",1352547427,0,3140543df95dbafe6381850093df8c6d28fee23374c1c2e3b7a2399dc6ead9ca,66487669690
20180201,"PAYMENT RECEIVED",1452672198,0,2d5500246f8e7eb1708543aa1bbc7e8f136f880a7cad96786e31e9e7a097fafe,65135122263
20180201,"PAYMENT RECEIVED",1375742459,0,f181086309e27cd2da2824eeffb683841f81bbeeb94e57cf5def7e48befebf99,63682450065
20180201,"PAYMENT RECEIVED",1395808614,0,ca12469274b215429a411d6bdb8eda04cc2827cc8950d6f6626448f923710fad,62306707606
20180201,"PAYMENT RECEIVED",1417111185,0,bc58d66515fff325df7cb2bfcd73a6b13db8f2059ff1381764a7205e2a9a5726,60910898992
20180201,"PAYMENT RECEIVED",1497328748,0,88862b877c4305bd977b15e7801395172fa052307a14526dc6524888cfa9d2ea,59493787807
20180201,"PAYMENT RECEIVED",1365197683,0,33af6f807b5cc03ae7dc89f13516236d5d44e8a648f46d9d6a7f5aba0a3caf79,57996459059
20180201,"PAYMENT RECEIVED",1364722287,0,e27c82ff42d5838484e306defd6943edf803a000c33a234abb29345f55e0f71b,56631261376
20180201,"PAYMENT RECEIVED",1322970967,0,d7b8a3a6453aea086a3bdd2a66cff23020524bced739030e223d188d768010ab,55266539089
20180201,"PAYMENT RECEIVED",1414973985,0,636798441d39743fb77d6b41bc27fb8880772eab9a132fe28e61018421bc685e,53943568122
20180201,"PAYMENT RECEIVED",1453889387,0,2b7ed2be8c1b1b324b93a39081d1391bb7ec1a40f4f607e37a54532db90c5344,52528594137
20180201,"PAYMENT RECEIVED",1465572461,0,92656aa5c1913e5f3fbbf6f802db94b4fd40ad4efdd989cb463a15670d850a68,51074704750
20180201,"PAYMENT RECEIVED",1432688439,0,5d5819eabd93ac7b13fdc8769712e5d0b41b539a1f4720172430a413f6461750,49609132289
20180201,"PAYMENT SENT",0,-44373301948,37c6f05a37a87eeaae2f34399169456f15e42711d36700bd7342dc225a7908c7,48176443850
20180201,"PAYMENT RECEIVED",1472414568,0,bf1c547849926585fff5fbd6692c2e2b86146c323be4cfa61a812a7cb4e19d73,92549745798
20180201,"PAYMENT RECEIVED",1358455891,0,661acfc99856fd745bfd3f9dbf4fcb77af499d03ca8a10c189672dcd557010f0,91077331230
20180201,"PAYMENT RECEIVED",1364548177,0,998c65ee1384ac5c87a09c1a4d77479c26e608bb1f3a11a49db49dd3bfd7d9c2,89718875339
20180131,"PAYMENT RECEIVED",1427900676,0,6be23d974a617acf29bfd48ed9138777b55f1d634b7e9442c7e3935759afd1d5,88354327162
20180131,"PAYMENT RECEIVED",1442083084,0,e1b19e8284b16a6dedca6370280eebc58252b0c173bfb6553725fff8c635d847,86926426486
20180131,"PAYMENT RECEIVED",1418255990,0,68ae983f3907bba54a0b296e879b5b4a8ef1574d5a1a45861ebb191594cec7c0,85484343402
20180131,"PAYMENT RECEIVED",1312506807,0,80a0a02117e22731008003b50efeed5533bfdc0c2aa7172a28b03109da58a0a2,84066087412
20180131,"PAYMENT RECEIVED",1354036321,0,c0faaa72ca58ad96af6f3c2bb47c09c4b1a6be43c4ed16949321c6c8b1e3a5d9,82753580605
20180131,"PAYMENT RECEIVED",1390019075,0,07717c7833a795e307e8b2655a9c2d872990b013caa5af07af0286b4ad9f6606,81399544284
20180131,"PAYMENT RECEIVED",1426339542,0,27d5cb18a4564bc5aa682529c4ab01eda8f44e27395404d76540db7117a3e983,80009525209
20180131,"PAYMENT RECEIVED",1387947283,0,498a5fd7cc40e24b675ba9aff2f3e102b568bd2452b7bba1b05742e1775e825e,78583185667
20180130,"PAYMENT RECEIVED",1287548194,0,b193d208ecd89bb8494e0a7f66b8332c930e59d6a7052657b4ab91467ff37a85,77195238384
20180130,"PAYMENT RECEIVED",1429308325,0,09b4d75c07e4751deabf774c1033ff9dd6b6c943f60f3adf5a4f4211c5d8853d,75907690190
20180130,"PAYMENT RECEIVED",1366392620,0,10697edb8780614bcd24a4f8e3cfc8de9fe8c2773214f18e5589e4516dc56fea,74478381865
20180130,"PAYMENT RECEIVED",1445322755,0,f4d17aa591bf69e367518b39b13e4ebe42831eb2f95c6c62802ef3895faa9375,73111989245
20180130,"PAYMENT RECEIVED",1250000000,0,b476b87fbbd56806909574c8eca05c6165c3915c12ab424fe00faff2484b5233,71666666490
20180130,"PAYMENT RECEIVED",1432985597,0,f3dfe1c77bfe2b7dfedd48454dec1cdda4d48697858239b85654308bab3b5878,70416666490
20180130,"PAYMENT RECEIVED",1340485238,0,37342405bc708a79e8ed1c467b4c7f04d3711ddd114d0485433bb0b9653ea5de,68983680893
20180130,"PAYMENT RECEIVED",1298249109,0,390918565e118ae3c6e44ad9a4719b4683095ffb9fb701aaf3609817c70a9073,67643195655
20180130,"PAYMENT RECEIVED",1269600096,0,7465b25d727c886b474b9247710a63f74f741e36c92489af77d28d8bac366cff,66344946546
20180130,"PAYMENT RECEIVED",1259965110,0,4e4c4fd0ae25cec1303cc730907501b3d04b0eb515fd4c48ce643963179e1319,65075346450
20180130,"PAYMENT RECEIVED",1318817579,0,525fc67accf7425e657dcd8485ead9e92afd01bf7d78119a3c67c8e8f4d1743d,63815381340
20180130,"PAYMENT RECEIVED",1295990076,0,5a4a5438fe74689af555897193339302a92443fccd2f8ab529765fbe6f0882dd,62496563761
20180130,"PAYMENT RECEIVED",1280973687,0,27662be517b88e6aebf78f2350d055444b1108b2d2303c9613492e7bb879e928,61200573685
20180130,"PAYMENT RECEIVED",1265594345,0,c229950adc31591a171de816e8fa6dbf1a148ed63d82d64ee75daf8c1cb1020f,59919599998
20180130,"PAYMENT RECEIVED",1285062196,0,b2c45b655543e47c7c6d0aef79cc868f6ee4a14c7f90f653255e17028ce37c44,58654005653
20180130,"PAYMENT RECEIVED",1299922956,0,f6e46584989b3501daa95e1cbd742f74822f393ea95e64c4324e7c44e089356c,57368943457
20180129,"PAYMENT RECEIVED",1263438797,0,e63d54da2b05c9978001b491b9500cb9e40eda005a147af9561624382972674e,56069020501
20180129,"PAYMENT RECEIVED",1339435879,0,be1afc90a6190d29dd5a929b043f3368237a79bb978cdd80931be524148a91c8,54805581704
20180129,"PAYMENT RECEIVED",1334626186,0,717f2306be1e17031134ad61753766c9046320bae8e9377ef8dcfa77a0773e2b,53466145825
20180129,"PAYMENT RECEIVED",1409639343,0,dd4058ff3c049d1ecb63b7f2091894b757647ba0f7fdb9bfa2ff7632031014f1,52131519639
20180129,"PAYMENT RECEIVED",1273200011,0,b1af0448220873bce5d721c6e31adf0f4338446f6554672ff127de78c9e4f711,50721880296
20180129,"PAYMENT RECEIVED",1285353900,0,cbb081ba90311ef9ca7038c0f25b0eec90a3ca2090dfb16942dd2138b54fa630,49448680285
20180129,"PAYMENT RECEIVED",1422589493,0,2c52704366478466f44fba267633252aa6292f2a09452a469f719bca33525314,48163326385
20180129,"PAYMENT RECEIVED",1341269754,0,b16bbabd92fe62be1f279bad7dd436f4d35883423cd3b5bab43e2095133fc0fe,46740736892
20180129,"PAYMENT RECEIVED",1372499495,0,90ee775d8d1a24457ae1175ed9fd5c0676c74cc69d01b800c286e0143b48c43b,45399467138
20180129,"PAYMENT RECEIVED",1344011761,0,cc61213a2a1b8531a1284b033ea7cf9943130e1b5cc8444cc907c6e2e2db845e,44026967643
20180129,"PAYMENT RECEIVED",1353564006,0,8656ab07c45a72813a27a4f67a30c4292a410779347afc96693c271b9f09dbf5,42682955882
20180129,"PAYMENT RECEIVED",1375742786,0,c61a2d1944d2463e7ed240ecdb1837be5b6d802f79cd6203090f8e0d9d1f0cfd,41329391876
20180129,"PAYMENT SENT",0,-22680765791,03e6f6b0af81823daba0bee51cbd5a9b270795d3f85c07acaee831538f6356a6,39953649090
20180129,"PAYMENT RECEIVED",1288604350,0,7a0436f1d6108c661119a69bfa05152842ebe1bd58e02bf88f35ca999b4ebe7d,62634414881
20180129,"PAYMENT RECEIVED",1407663632,0,eab47de7141ae32343afb1a5aa431917e9549ba192ee01f3d3744eafea8dde13,61345810531
20180128,"PAYMENT RECEIVED",1252230402,0,d5a5b4fbe1ad5274d59226623619f32ec0a0a65109fc1c49303765d95e7a9d0a,59938146899
20180128,"PAYMENT RECEIVED",1312647384,0,bb7520fc27ee75ad702d4485f1d1b9d4986b35ea83585ebe3fbdb39cdb2a1b15,58685916497
20180128,"PAYMENT RECEIVED",1311018066,0,ce74f2b668e2b8b84989c990aee7c007ce31cb3a230dad84e474b83e8245d1f7,57373269113
20180128,"PAYMENT RECEIVED",1263296848,0,960f81fcbe25aef594e634c14c383198768eec180da8ab5df3cc4544289b8510,56062251047
20180128,"PAYMENT RECEIVED",1410341611,0,49c91335adc237a7d2ef4ba6098806bc0fffff76c061afbd9fa0dbae5e35fcda,54798954199
20180128,"PAYMENT RECEIVED",1426737206,0,e20d296c49617936f474c25f597309e604733e170c49255f2144af8d453c64e3,53388612588
20180128,"PAYMENT RECEIVED",1409146201,0,f9116d643d5fa5718ab7626ad8c3e751929ee52e457cce1f2f095aed8a41ff41,51961875382
20180128,"PAYMENT RECEIVED",1303085531,0,e42dd54ff458c2eb803539451c9060a6c4904692db0921dee5ad348034c903ed,50552729181
20180128,"PAYMENT SENT",0,-55200828864,5013a54253735b799528c0f21439c2288df5b3b6ec1bf55508f99e261d2091e1,49249643650
20180128,"PAYMENT RECEIVED",1343462628,0,eeb930308f1db62019ba8ad279db8b58749cdf6d84e05eb8c13c2edd7d34497c,104450472514
20180127,"PAYMENT RECEIVED",1310618686,0,d9e09976e8efe76426c3d0f85d48adf93ece3f6be2d4a69fec08c6757bf4241d,103107009886
20180127,"PAYMENT RECEIVED",1411345485,0,d9e46fc64004660a5aa9a4409aafe98c33c9fe0a57964f3cd56bfed8bdd0bcba,101796391200
20180127,"PAYMENT RECEIVED",1388835773,0,75c493891b41be8c203820945778d6ade8d1ec146f0bd2caaabd3cd6b9e3b14c,100385045715
20180127,"PAYMENT RECEIVED",1250000000,0,ffe5bc653c592ba8ccc910f705ef665c5b4b06d1ae00f42ed3a1eddca93d8775,98996209942
20180127,"PAYMENT RECEIVED",1369525121,0,4d2f2319b2a42dd40e466b13f4838eefc6b24464c36e38f9516de8ad08b43ea8,97746209942
20180127,"PAYMENT RECEIVED",1439988174,0,674971845f9a84c1cb44b16e43a3f62a0f3ef65bf82b35e66898db02e43d3f1f,96376684821
20180127,"PAYMENT RECEIVED",1452550985,0,d6a6a2b829f913b6102db3cd335f66f0aa2bd4dc586698f09820de97773fb2c8,94936696647
20180127,"PAYMENT RECEIVED",1250000000,0,39da9a8cd095d2f25c95098b43c79f81fd79cd4f5da1f6d670677683dce9bbe8,93484145662
20180127,"PAYMENT RECEIVED",1357650647,0,539e38a873298f2d8beb3e49ca26f68b624de002fa50298081d38dd0f8f91d44,92234145662
20180127,"PAYMENT RECEIVED",1354664530,0,a1cf59ac00d22fd272a241f7e872b12b2d45dd996670fd1b5a50cca3974c00ec,90876495015
20180127,"PAYMENT RECEIVED",1473617075,0,e4ba351f430c7409a7ec83dfdb2bf867097d69e60c98df1a5538c9380735ff9f,89521830485
20180127,"PAYMENT RECEIVED",1356603943,0,85e8f4d46c566cbf21cbd73389a8aa43ee2679f2841450ca7648ecd0e7f1ef30,88048213410
20180127,"PAYMENT RECEIVED",1324639478,0,56f69cf1b6bf4746aa14c27ec93e0238931bd76961207037a1b85764bb15c283,86691609467
20180126,"PAYMENT RECEIVED",1289902540,0,90b969bb6181340737a3a162a86b1bdb11c2a20389f44b34d0f7f564152200a7,85366969989
20180126,"PAYMENT RECEIVED",1288095095,0,2bface0b47868d1de9858da9e184594f36e7bfc7178b35495dc6d7577080a38d,84077067449
20180126,"PAYMENT RECEIVED",1379000648,0,30969de10b63b14d3bbdb30e2ca32bbb2a2487fd1d2c17ab5e96d7302eaefb46,82788972354
20180126,"PAYMENT RECEIVED",1368587811,0,51a9ccb28e2db4f0f867215fc164c70c22dda67cc54b83090ed854f013e616df,81409971706
20180126,"PAYMENT RECEIVED",1353772493,0,aafc3577bcc50319f95ea3ea95c0df31e0a1fa1121e0d16f75fbd3d1891e10b8,80041383895
20180126,"PAYMENT RECEIVED",1289031535,0,0c470f138265e4e8c9ed66bd2851fcb20e320b09c1df542594fc0c88ea2b1e6f,78687611402
20180126,"PAYMENT RECEIVED",1439868203,0,3896dc1cd036cd7c47b3cc1ab13e96d25d3b2d03805c588d82f9600c07871504,77398579867
20180126,"PAYMENT RECEIVED",1388468298,0,7505b0a3fc9ebde0994dcac8d8d1e4c424c0adbda4a0ab4670abfb027fe2189f,75958711664
20180126,"PAYMENT RECEIVED",1391085015,0,16a89cc28e94f8334cda32155b43f48c462482972c5491763619fb08fcdf6f0a,74570243366
20180126,"PAYMENT RECEIVED",1503331609,0,e900cca551a09e60db382d4e5897b50dab82617886b646b14a93dfe5944968e0,73179158351
20180126,"PAYMENT RECEIVED",1368080601,0,e495b0e6003b993ac0c63eebf928b81a3383cfc00d319ae444a65a4bbc2c9dcd,71675826742
20180126,"PAYMENT RECEIVED",1266334807,0,43428c9cdd545186c9b2dd5e7b5795deee72089cae3e85122b9e4fbda26a8948,70307746141
20180126,"PAYMENT RECEIVED",1439263964,0,0fdbeb58cec3cfc202f4cb0818ab9d9caf217f2578f005795a9621cbd6ee7b35,69041411334
20180126,"PAYMENT RECEIVED",1476062927,0,c6d1c9274ac09f35515e889e55dc7466c16987995e7cb2225459d48150e3df42,67602147370
20180126,"PAYMENT RECEIVED",1375703521,0,5ce71cab120875a64f9b72244c6e7737a615c01dc499cb340ee195b3d32bc58b,66126084443
20180126,"PAYMENT RECEIVED",1432891037,0,d97a439e6573d28e45976d3e16f2c111b43e9f7f8d57251422bb77a7df6d568e,64750380922
20180126,"PAYMENT RECEIVED",1378571890,0,1b977cc7e86da35fc5f7eb2116fbbe875ac686fa2c5c21e17de8077c6e879b59,63317489885
20180126,"PAYMENT RECEIVED",1505946807,0,5d0ef73fcf6db9efd41010fcf09052bd5e59b73785ef1d5157136e2949268b01,61938917995
20180126,"PAYMENT RECEIVED",1514390519,0,71983d9a57579ab9074a8712e03da369728c794d96d2eae58c9b26b05d16c358,60432971188
20180126,"PAYMENT RECEIVED",1437828632,0,6b2db1aedbed310a78a8e95a8c841703e70d3ef9c7e14ac0ee81b2a9154c5fb8,58918580669
20180126,"PAYMENT RECEIVED",1349755412,0,1e0c406855dcd7628765cb43ffe20c29f27e4ef9e3362b5ad1860c53d7552d3a,57480752037
20180125,"PAYMENT RECEIVED",1532600527,0,54157132e206c817a18875136fb45e6b4eaf07a2f66b83a584755b5a33cd4084,56130996625
20180125,"PAYMENT RECEIVED",1359206082,0,cf80c13402f249c6bb27afff9760b1e7a92680836c798ed2a2c9f76499136cb0,54598396098
20180125,"PAYMENT RECEIVED",1383907305,0,b34405dd1946a91bbdf1556ba76aad8b04ae3dfce3d38fb5a70b6b0212a4c2e8,53239190016
20180125,"PAYMENT RECEIVED",1316207792,0,68cd3582dcd78bc369133ac89216dd4a6936de29a0adfa7d7873207e60d46832,51855282711
20180125,"PAYMENT RECEIVED",1425819015,0,e7e637060172bc3f255ff584bc0fa7155b3918c32a9a15168d5ae6282112c3e6,50539074919
20180125,"PAYMENT RECEIVED",1472032449,0,85e6e70fed853afb67b0184facf8dad1b043a3c559dc1b7f099cb4a0385b8a30,49113255904
20180125,"PAYMENT RECEIVED",1267351005,0,fb20a3464ea99d9073e86e8a2d9fa985d40a063a5de9ad87e8d728c49a3733b8,47641223455
20180125,"PAYMENT RECEIVED",1496732020,0,09a0640bca2b7e741339a255b19088e82d9b28bf962d99cafeac55ea7128bf4c,46373872450
20180125,"PAYMENT RECEIVED",1453906139,0,ce0fe360e4b406f22bcd349f2580a1560566bce15725a69badcef097a04eaab0,44877140430
20180125,"PAYMENT RECEIVED",1310349565,0,b341e462980a3d009f2fc17c2a3db2928828f5d4190965d3904b4f0b0963084a,43423234291
20180125,"PAYMENT SENT",0,-33545736081,e2abd9848babcfd7a2cd18514b9aef1aa1e55235a7000de78d6394b60e2374a9,42112884726
20180125,"PAYMENT RECEIVED",1296998349,0,906531172de7cb6d6907105bf86447519194f6d1154716c7768bc5d18d577803,75658620807
20180125,"PAYMENT RECEIVED",1531318169,0,1e8a9c4d886c830e9514fee9dca1c5370e92532b042e391c1f4c26b57a757b47,74361622458
20180124,"PAYMENT RECEIVED",1497340882,0,bf8020c7dbee5dd86b35f9a65468ed1ae0d5b5d03d81a2ffc1e9dac30ee1bedf,72830304289
20180124,"PAYMENT RECEIVED",1250000000,0,5bd6dcc604e47ff598c4c0d62243edcd9c8fa91c9dab7d6d09069df6ac1fd595,71332963407
20180124,"PAYMENT RECEIVED",1483264972,0,bbd46a0f8237d3174212b724d409a40402f88fe592ec04b22be92f700955f290,70082963407
20180124,"PAYMENT RECEIVED",1503858259,0,b1c615681b97308e5dcd7d0b335fb706b577552ac937922222b616942a89b4a1,68599698435
20180124,"PAYMENT RECEIVED",1284205656,0,7cc323826a6d997544b4a4479da94a2d41317723713980b46fa5630b06c503ed,67095840176
20180124,"PAYMENT RECEIVED",1552571695,0,a2e3dfdb6579b9c25658dd1b52ec0e21cb255b74b948f37715082d5ff01a7267,65811634520
20180124,"PAYMENT RECEIVED",1443980804,0,6cc455f168c76c7cbc63f45971e615b69fa3130bd99255a6e3b7cda8f42ea35a,64259062825
20180124,"PAYMENT RECEIVED",1286015072,0,b68935bd9cc34da5ca49b2ec0a39a47fce90ef85106007e9774958c923c9e446,62815082021
20180124,"PAYMENT RECEIVED",1429700808,0,904090c76763412e0ea627d756dfdc8879068610129ff379cb2d288cc00fcb69,61529066949
20180124,"PAYMENT RECEIVED",1461276917,0,681d71f6c5c88efd72f49b1cbf1f82801401c7de5b25a06acc0ebfb23c4fd094,60099366141
20180124,"PAYMENT RECEIVED",1281287964,0,758035b3f63681306c26aad49bf8ec92c963bf89e57f29e50e34c4ae5b083954,58638089224
20180124,"PAYMENT RECEIVED",1273746760,0,4f4d91639b524b13248455310b021776bf6ae9873e59370c6c85bba356f0e686,57356801260
20180124,"PAYMENT RECEIVED",1467319731,0,935d07aa77e9689dee6a38c5aa33f8a6418e1181a7b77907950dd9db307f29c4,56083054500
20180124,"PAYMENT RECEIVED",1378769472,0,6a203308bd985e4f15a3241ff6f6b2b8ff79fbbd31703c96050b295f427890a2,54615734769
20180124,"PAYMENT RECEIVED",1393197150,0,bd901799ca5e2b3abbdf5be7f34ef41585c7f3c7e3d91b1df485ad3d97bf353a,53236965297
20180124,"PAYMENT RECEIVED",1271219147,0,5ac66eeb9f6031c4e3c135a1d6ef9613cedbd1dd6ce169fbe92bb7698b781bf5,51843768147
20180124,"PAYMENT RECEIVED",1317175104,0,c1c204496d71e97a3883f58688d83f2cfb75501dd4367a35a85ecfdd24e6afb2,50572549000
20180124,"PAYMENT RECEIVED",1480947764,0,bf4c17276ee8ff1da289939f8b6ad6a1c6dd3b1556a3024fe832b38784c5f80c,49255373896
20180124,"PAYMENT RECEIVED",1524171974,0,d4fbf33290d3a5f8768c17709d2614489bfa5fd93cada735b11d2d03fff6e310,47774426132
20180123,"PAYMENT RECEIVED",1352744768,0,17f326e93470448adf7407d54c506213d063a3128cab4a0adbf222da06b95a1a,46250254158
20180123,"PAYMENT RECEIVED",1527509654,0,2cf2283b5d907b526d0a76451ec829bd9c212a9894c7364f024c81b8616e0ec8,44897509390
20180123,"PAYMENT RECEIVED",1415802029,0,73b76396bda04be42b6085a6c4694e8209c3d3e669dd8779d062cf1c202040e5,43369999736
20180123,"PAYMENT RECEIVED",1294737157,0,dda42168defe74a47dcef701b5589374e63d5061eef16ece9b35847a8c235eff,41954197707
20180123,"PAYMENT RECEIVED",1438880234,0,91e320288141959aee26f381801377954aaba86393103868d9539e26fba51f1c,40659460550
20180123,"PAYMENT RECEIVED",1414605260,0,61396a7f11da93594c2f093a2c56ad0e2de44e2bfdcb858f8da32cdc357f4d0c,39220580316
20180123,"PAYMENT RECEIVED",1356923586,0,99e2d1807d0dd0b610f0b83a972252b37a981b5ff814f40b19493590fac8d368,37805975056
20180123,"PAYMENT RECEIVED",1353230255,0,69bae9872bd13db0dcc1803c9a6843ac822ba579b39c3ec317bbe3938b79396a,36449051470
20180123,"PAYMENT RECEIVED",1303099574,0,7fd54f926f887245f46155881258b46c39c2758b85f1cb2b91b36ab016ebab98,35095821215
20180123,"PAYMENT RECEIVED",1381085154,0,e95f10357936ed53b101a2ee9c2da14eb465c49545da4d3253922fb250d58f50,33792721641
20180123,"PAYMENT RECEIVED",1359299214,0,63fc6f6bfb6a4a5b1e2340b4a2f7ddf8a71128bf6c7ee847ce415bea3cec874d,32411636487
20180123,"PAYMENT RECEIVED",1332283811,0,592bec94086d9f20894311413ea8e1e93196840395d3a2b5a8b16f04360a39e5,31052337273
20180123,"PAYMENT RECEIVED",1352071031,0,7ba5aae70dfdc4969145e80651db2db4ed76c17274f3a8e1e72344a1363928e0,29720053462
20180123,"PAYMENT RECEIVED",1304408838,0,34c240c31c7062242a9ab0c1bcd07c1ba464f02bde43ad420a14fea9cbff1971,28367982431
20180123,"PAYMENT SENT",0,-53001920739,0e87b25852095f2bd0b2239187d36f6c367609043d9d80ee97228551606cf613,27063573593
20180122,"PAYMENT RECEIVED",1426504558,0,14e6c0d5fae51e8260b4b76e76985ba3fcfbe56f967dcd17b6ce8a5a67c7af9a,80065494332
20180122,"PAYMENT RECEIVED",1457519363,0,3d0876ec0ba44aabc725441fd00d5132aff1a737ed51342346fd4e0565593e37,78638989774
20180122,"PAYMENT RECEIVED",1287226467,0,dcc7943a7d7095299a468b9102dc42fe75d76354f94b35296bade6ed1eff6adb,77181470411
20180122,"PAYMENT RECEIVED",1501621291,0,8348c3fbc2fefda87b56a999b4389915b384eeadb5b1726f70f7f21ee964f80e,75894243944
20180122,"PAYMENT RECEIVED",1494972349,0,5fc6ac3d2cfee53f045438492b352fdfa3ef5b2d2802f5b41b70eb1f736c78c9,74392622653
20180122,"PAYMENT RECEIVED",1345024606,0,b3b205e4cb3ef42ab64eb6e75af0cd8aff0eb9e1a999cf9b74daf10aa087b6af,72897650304
20180122,"PAYMENT RECEIVED",1354235653,0,ec8e8face367f4fc6de202b3e71dc3b5d9deeb2d7732cfc085ad3d6b5e34b739,71552625698
20180122,"PAYMENT RECEIVED",1396121449,0,5821836c7a5285753b6f4fb11b0024c3ce729b1d77cb31c47d473cbbf4b6c968,70198390045
20180122,"PAYMENT RECEIVED",1397276041,0,6a0995a8cf689ee1638ea103d80ebe9833726ca79157758e1a9478a6b43670f3,68802268596
20180122,"PAYMENT RECEIVED",1380640222,0,1ba7feb4c0805bedb3ac2496aaeea2acbfea42c2a900cac4bd28bf7efc7ee888,67404992555
20180122,"PAYMENT RECEIVED",1478235213,0,99a74d865dd9c2c0cd21f26ca2dc125dd1bcaabac7cf67e3792db49f7d98aebe,66024352333
20180122,"PAYMENT RECEIVED",1561188855,0,b38d085e54d7531c341df8c02502986c8654eb5c5945dae8bcdf991f7cb80afd,64546117120
20180122,"PAYMENT RECEIVED",1444083194,0,0e7bffeae9c1a535668eacd7935b7cdcfad909cbb4bd0b4cb018b0aae68f18ed,62984928265
20180122,"PAYMENT RECEIVED",1384285950,0,27773a6184a3dfca1a01fccffd1dfc87ae4c551a7a76d3faae09c709d2e6ce5b,61540845071
20180122,"PAYMENT RECEIVED",1294499786,0,c389c483a98609a920579cc1ac6bddfc6d04e76517abfb8f6c7eb2acf9cf2225,60156559121
20180122,"PAYMENT RECEIVED",1586724559,0,be86bb65f90d435f65681b7eaccbdade0d388046ceb577bef1acdce8f1152187,58862059335
20180122,"PAYMENT RECEIVED",1430918883,0,bd09a35feccea81323d89d44308384da5b8b823d00cf4c8c6bc80dc3961e2884,57275334776
20180121,"PAYMENT RECEIVED",1250000000,0,e8ad136b51e91d5fa98764a6cf96a45f7d62da23d7dde9db2cb35985725d385f,55844415893
20180121,"PAYMENT RECEIVED",1427406705,0,115fe31c69c65b001e6e80ba2ed3f4354875b41d6a825559b8a6674d5472b18e,54594415893
20180121,"PAYMENT RECEIVED",1602091366,0,22ff2f30d5e9ea336e7a79ff2be1fa5253fdb88d6e1c043f5ebc89b9224a68a2,53167009188
20180121,"PAYMENT RECEIVED",1250000000,0,05da0e7f3b0b0a5bbae3919ff6c3df76bec9c3bc5479a0948d63940339004e6b,51564917822
20180121,"PAYMENT RECEIVED",1250000000,0,99f56c9157deb0243797a3193d39faa411c7c6edc43836d201be58d8da6a570b,50314917822
20180121,"PAYMENT RECEIVED",1404981161,0,c4e244aa21c7776f0611db3ddab764ec3c404f09b1807b4c1a73ce5b87de2703,49064917822
20180121,"PAYMENT RECEIVED",1408654224,0,bec3435cd55f39d1043fa37f6f1f3ea4f6a1c227c3ede4576e009f07f0570a27,47659936661
20180121,"PAYMENT RECEIVED",1452417811,0,4179077230662e36e465bd1279fdb25a47ef16b59b853faef27cc712bce27005,46251282437
20180121,"PAYMENT RECEIVED",1479394755,0,0adf47e36514f93d2aca15bfda0ceec607f9b680d88bfb16ba8bd7c7cc89810a,44798864626
20180121,"PAYMENT RECEIVED",1642400845,0,458b2b75310bc293eb0167ef3d35bedc19db54a59d9e9f06946557b3c6d5cfa2,43319469871
20180121,"PAYMENT RECEIVED",1424173154,0,971c3a0df76580bbba6a8cb055472d9aa3f9ad2c064785ba98982d3f0eb75bcd,41677069026
20180121,"PAYMENT RECEIVED",1653389121,0,d0e938cfdbb98aa379e4f27878d41e972d122b8762b3ef22996b5b16b42a3d49,40252895872
20180121,"PAYMENT RECEIVED",1709631670,0,5b2eced015921f2612cc5bbf3ec19da6f0680f9c3902842c30fe9aa53840af2f,38599506751
20180121,"PAYMENT RECEIVED",1315286316,0,b7104e01da37edd3354afd0115c0bb74f6eefaaf4de5650b4593fee9794daf9b,36889875081
20180121,"PAYMENT SENT",0,-38404800015,d35845716f14f50fe6af359d0c4b1ca53b6e90af86904f4ca2379a44dc6c200d,35574588765
20180121,"PAYMENT RECEIVED",1342671018,0,dbedf80de23856677b30a1e2c06a79cbfda994a3517afd579c358f4d251b1201,73979388780
20180121,"PAYMENT RECEIVED",1312496275,0,6686f515fcb41e36a349f199c4cd3f544512dd6366324d8c6fcc98d933b868d9,72636717762
20180121,"PAYMENT RECEIVED",1364208354,0,c29a37c345a980440ac6fb50afaeee2b61370fc831341108cf0996aaf47b17d1,71324221487
20180121,"PAYMENT RECEIVED",1451297055,0,28ffc2ca172f40bf6fa47f056fce264bdc1f92062b2bc0466a044f8c472361af,69960013133
20180121,"PAYMENT RECEIVED",1339672241,0,4e6d38f9e3eac2c33205aa442c444975c7a85ca82322bb755da4161c36b46dac,68508716078
20180121,"PAYMENT RECEIVED",1340937907,0,a019a22afe018b65c81b98c344996d5bec660a2d491c35d005d4121ffaa8af6a,67169043837
20180121,"PAYMENT RECEIVED",1417845839,0,18a92b13c8f28c25e4fc9bed02a59c3cfaee014a14594c44b9775e55f39264f7,65828105930
20180121,"PAYMENT RECEIVED",1335031216,0,3898eb2fa4afd46095a615371185de682d7744076336cdc641238d1a8cc9b9a0,64410260091
20180121,"PAYMENT RECEIVED",1324547065,0,6f04ef3bbaaf0ba9808bb760ce6c38883375120f8a50428ed6dc10b0ea76e999,63075228875
20180121,"PAYMENT RECEIVED",1389645295,0,2fb3b25fbf997fb6310a0b181d6f9acf431ad18eab6e49167a5d3fc78cdb3885,61750681810
20180121,"PAYMENT RECEIVED",1466649027,0,1cb9ff2dda55ec788e0a47a51f83b3427b697321ea555308536f87ca22796dad,60361036515
20180120,"PAYMENT RECEIVED",1367234447,0,9f2b2a4e5799ec8b2fb24d1e18918c347a760037fd3338bf28df3a54b2ff4c70,58894387488
20180120,"PAYMENT RECEIVED",1438207587,0,ffc8f1ab970b168c865e32992a3cc2ddf087ca6a343b72839ca5c23a6e5b7a22,57527153041
20180120,"PAYMENT RECEIVED",1460556465,0,aea5cf123849a5a50533320dd064c03ff506f5d662d991c447b5bdebd72402ce,56088945454
20180120,"PAYMENT RECEIVED",1487500691,0,c43ce0b9c286efdf58a9a6682508d52438179f288e69db0d93bb0b889f7432f5,54628388989
20180120,"PAYMENT RECEIVED",1392673774,0,7a29cc2c2c9d63d7a1f153efdcd197ef864e745ffe94d69a7aac9fd259165e38,53140888298
20180120,"PAYMENT RECEIVED",1553722769,0,97cb65c7a0e90fbe466484082c2efb7b8bc8ed3b0212c08d7aad353310a32003,51748214524
20180120,"PAYMENT RECEIVED",1527927817,0,d853c1ceccdb611528da024b79d321569c1561dc33a19885f249fd05e0593263,50194491755
20180120,"PAYMENT RECEIVED",1524728682,0,982dae6bb11edbe0ee3d590c62966cef4c798af5a1d1d0dafb26ed06539ad09c,48666563938
20180120,"PAYMENT RECEIVED",1552671344,0,1cd3f1fc1d6ad0d004268f9c40a5d05f7e2347c901b3f4adc49f7e10a8607bb2,47141835256
20180120,"PAYMENT RECEIVED",1545737540,0,513c09fba80cb25bd3bdc5603742375ec19577542202ec35727ddf2b7b61ecbd,45589163912
20180120,"PAYMENT RECEIVED",1516482754,0,944d212c556b7ca47a8c083f70586a2fac98e9cd64da3b00d1962195dc969d07,44043426372
20180120,"PAYMENT RECEIVED",1539525763,0,4c200be901bb70cd4f50fc1a46b1e5e62e7634363520bb17bb9c32a9ec2739fb,42526943618
20180120,"PAYMENT RECEIVED",1413907353,0,21101d9b928cc5f5414ff2d1653d6af8d7d94ce925768178a9e7b1307230fb5f,40987417855
20180120,"PAYMENT RECEIVED",1357243205,0,e4d7a5f00318c3452e8d4f0c181e914839483055f18d61624e4fa10b0fdcf39b,39573510502
20180120,"PAYMENT RECEIVED",1589221377,0,44fcec90dff1a9890eb86c3011d0b6b8914818372ebf1aad8fa4d46015721bf9,38216267297
20180120,"PAYMENT RECEIVED",1569689291,0,86fcd82991ea4fe016a3a44802d8cd23c7a191f8b05550c862f18e64c10ebc9c,36627045920
20180120,"PAYMENT RECEIVED",1536653373,0,952e9628e21c400daaa86d94943fdfeb99998f2136a46eb7589a49e15f4e4c7d,35057356629
20180120,"PAYMENT RECEIVED",1250000000,0,8251cce4bb5a758f79d3e89419ad9ca420d3c47298c61b13ffe4c2a3210d660e,33520703256
20180120,"PAYMENT RECEIVED",1358802979,0,6fa4a352cecd2554539438a9829f9244a2c1dcd23a39d64cdd4baeaf3f8449f4,32270703256
20180120,"PAYMENT RECEIVED",1360366405,0,caa13b5fa2c54c6a613dc41b1e821a90590949b9e7ca2ab6a103a93cce8d1db2,30911900277
20180120,"PAYMENT SENT",0,-61184555098,3c40473b4af9e18629231fad9737e89ffb65bb80ee563917fdc714cdb7e6cd9a,29551533872
20180120,"PAYMENT RECEIVED",1539033338,0,ce1c19e1707eba8e8128c96f538f9b56c05a0a44384dc7a04cb7ac5524feb8ca,90736088970
20180119,"PAYMENT RECEIVED",1476897932,0,11742b0c7aaffa9e46dfd62468fdeeeabd927e57ba2385ee9647667ed819d2c7,89197055632
20180119,"PAYMENT RECEIVED",1671933822,0,a20f8410c0b1a31ecb3193c8e5aae995d09b97ac9e3025a70245eb41731477e8,87720157700
20180119,"PAYMENT RECEIVED",1413086850,0,1792a6cd4f0fea76633739c5daf52ec431ca8ca60521ce60894c791fab09577f,86048223878
20180119,"PAYMENT RECEIVED",1403684077,0,247ce9b4171c1598bcb1f58421b7627fce6aa133a35df75298ac3f93e5f8e104,84635137028
20180119,"PAYMENT RECEIVED",1689861262,0,a5bc15b7ab4a45020cc812974bb506c21d06002442d3395d7eb84c8eac97b0e5,83231452951
20180119,"PAYMENT RECEIVED",1410717414,0,c6071ebe0384a59bb7589e071460d2664b1e6e46145832374edc066fe845c2a6,81541591689
20180119,"PAYMENT RECEIVED",1466056928,0,53c371cb63e61e3ce3f128ce61e7463b6983dd333ffe6be3bfdc9634b94dddbc,80130874275
20180119,"PAYMENT RECEIVED",1711985906,0,b6c74c02bb57be3b445f15a52f477f40cc7c946950661ea63c9aa0c6c8011d27,78664817347
20180119,"PAYMENT RECEIVED",1689456111,0,b850139eba0951da480769998b76b182d1d737c6e7acf38334f2a477e301f597,76952831441
20180119,"PAYMENT RECEIVED",1363243753,0,bedab39b1e0fc8bc8cacad0dc92caaa0a4852df2c2221b132ccd3ec0fca43d89,75263375330
20180119,"PAYMENT RECEIVED",1721367883,0,d5e69359787f395dd456c4a6ae84d65514d0b3272df5930bb84570792d5c4316,73900131577
20180119,"PAYMENT RECEIVED",1690618790,0,9d36a1af0c0dea9a4623fb468b8c600cf790454ffe4c148c858c14a0b4eb6378,72178763694
20180119,"PAYMENT RECEIVED",1451499524,0,03467ec510e19060418eb7682af375afdb89816a2e45f9a765ff8203ee87d438,70488144904
20180119,"PAYMENT RECEIVED",1588560468,0,60519da87f121899862b0388e0b55174a2bc955e1d3fb820820902eaa0a3c10b,69036645380
20180119,"PAYMENT RECEIVED",1693115244,0,e4b9ed318bd02505066405bfd4e2f68bec66da9807f828d5fdae1ca93de04049,67448084912
20180119,"PAYMENT RECEIVED",1709489985,0,f9cdb24345c0edd9eecea8ccf2468b5d26177c3d3ea95529f44b792c6dd3113c,65754969668
20180119,"PAYMENT RECEIVED",1774755749,0,b903aeea410dd6df297ecabf7c7e691f745bc141de370e328c86b5425a473deb,64045479683
20180118,"PAYMENT RECEIVED",1646179265,0,19f10d19d230e2bfe8062c10d415ecbdd19fe0003e2840aafe5aa6b5056ef054,62270723934
20180118,"PAYMENT RECEIVED",1771406784,0,816ffac751648c06e5614dbc322885564d56a9011925d41642e08236903fa049,60624544669
20180118,"PAYMENT RECEIVED",1733621471,0,f4aad7c3eb28a45c0ee8dbf19235dd2e92fc447e84785e2635ac42ff2cf9efa5,58853137885
20180118,"PAYMENT RECEIVED",1610805535,0,7183172caf7be7aff7fdb269c7ef81e8c4e0e272b855a213a2b5f6bbb4bd34a4,57119516414
20180118,"PAYMENT RECEIVED",1746419648,0,c8c3ae1bb575ad33a3e2b4faa71cbd18cb80630f7dea2b33781497f37be664da,55508710879
20180118,"PAYMENT RECEIVED",1250000000,0,a23294d60ffbc53246f510fddae65b82a79fb5ece621f7573b21895d60af779b,53762291231
20180118,"PAYMENT RECEIVED",1514948479,0,9dafd6f5418ae055789cf4285ae67df3de14f02200796a251b123e9291e4e144,52512291231
20180118,"PAYMENT RECEIVED",1574871520,0,0b1576260e628398a31d4fdb1963a5ef4bbc80230f59f69b6349c0eae4bd31ad,50997342752
20180118,"PAYMENT RECEIVED",1702001950,0,e9fd26922821de063fed9c6b0b1f7df96bc4b505f6145de5b9c3e0e8b07b2a16,49422471232
20180118,"PAYMENT RECEIVED",1800904088,0,0052be023c0e8a845e620862353fb86bcfa76b8d9e333c071a8c3899c3d4b0e6,47720469282
20180118,"PAYMENT RECEIVED",1497783559,0,6797eb494ba43375042840eaf7984a9fa23554e3b70d6c8e31def9e11cca7990,45919565194
20180118,"PAYMENT RECEIVED",1718425637,0,636bcfc803fb1420b20196aed43b4de5cb848eb2d45352dd43a16e2310b97a56,44421781635
20180118,"PAYMENT RECEIVED",1525066213,0,e1f863a2a3f675899d181c5cf25c730542a97c2662016fcfcd73c1e7629dcdb8,42703355998
20180118,"PAYMENT RECEIVED",1556671161,0,5a273f19b57614a8313ff942e41ac2567ae938dc6577d00d67fe0fb236c63d63,41178289785
20180117,"PAYMENT RECEIVED",1703096641,0,2adf93c3d000ad3dd8958a66094088ed139425fd314ebe0b7ef9926902da737f,39621618624
20180117,"PAYMENT RECEIVED",1785722329,0,bcad792260ecf8f439b41c4922850184142303d268dc07de4e87a7ace57213ba,37918521983
20180117,"PAYMENT RECEIVED",1663513402,0,75b12139d8ac4c10defcc5d49ef12235096db85d3a9d30ad8c90b8e9c08aba75,36132799654
20180117,"PAYMENT RECEIVED",1683683854,0,cdc3540abdd4b715b1ab1fa1c9fc42bd7cb0a7d7b58b93b0bfc438b6c29821e8,34469286252
20180117,"PAYMENT RECEIVED",1723674607,0,a5b75fae7439f71231b226b74fd7670d7210f930d7ef9ce652c2f2f9f1b65835,32785602398
20180117,"PAYMENT RECEIVED",1788761315,0,6b64aed292c3717ec2ec976951ada67eef9f6efdf4caf32107f8b02d984fd4a4,31061927791
20180117,"PAYMENT RECEIVED",1754059784,0,2558a98b585df12bc85aa89c173c842e04c0d4636a51c9b686b4e80836417ff9,29273166476
20180117,"PAYMENT RECEIVED",1250000000,0,dc3393f6648867b7f756b026437803d3f1f5dce48850fea0296cfc47048a19fc,27519106692
20180117,"PAYMENT RECEIVED",1493366737,0,9f34cddc915083f1eb0ed477bb95f467075f2e7708a246ca9c79d005ad5ab4b9,26269106692
20180117,"PAYMENT SENT",0,-39194870401,33b5c521430e6943820bb7314b51a927e4c2664d67471e750d14ed75519c88dd,24775739955
20180117,"PAYMENT RECEIVED",1549200802,0,3230c96239a352a63633f98ece12195d6bf3427e9ad36e1184be53e90edb8d53,63970610356
20180117,"PAYMENT RECEIVED",1377627665,0,5fb05bf9eb20ead775e210ca8494be3769bcc4c3c410592b8ee36a2b1d23806b,62421409554
20180117,"PAYMENT RECEIVED",1734505170,0,b26b8c01327d0ba85d93726e0b87cee9ce1a15fafaba77f519f8c34e2d250326,61043781889
20180117,"PAYMENT RECEIVED",1793137443,0,fdf97015da810e6fe2b29fe0e63d678ff431509b5b2a3190360f6340ead5340b,59309276719
20180117,"PAYMENT RECEIVED",1581109067,0,22a43077edcad6f896f16931cea762a509e0303500927deb7b3f34e936b974bb,57516139276
20180117,"PAYMENT RECEIVED",1580265857,0,55a1fb961e42353932df9da6efa978452c1ded15e63a87d3611fed9d50265c1d,55935030209
20180117,"PAYMENT RECEIVED",1702924915,0,71c5a8feea002192d8b9a0a27aac1e299bd4a63da94cd33070b6d47e794392f8,54354764352
20180117,"PAYMENT RECEIVED",1705647117,0,93c6639d18ecb3e26119bb4bea36cf4817e56e75476d9d3584b93471189f356f,52651839437
20180116,"PAYMENT RECEIVED",1802388057,0,98969f15158b96fcfe46e304b91daa47b60439b4a580ec6b00984d09b19225ac,50946192320
20180116,"PAYMENT RECEIVED",1420151010,0,23c17a36cd770b72fc97c91e95a437c306e027c75ec2086c4d07b1569449cd05,49143804263
20180116,"PAYMENT RECEIVED",1499201246,0,ceff340c50728b43275f51dadd1039fc13f0e8822d41cdd6604cafc4b43a9f7e,47723653253
20180116,"PAYMENT RECEIVED",1527908335,0,dd2e66c7328977f61ea428bc21b6e9aa1dd335a596e553d985e6cf8cdbbb1326,106845916021
20180116,"PAYMENT SENT",0,-60621464014,81f5f9ce7535d1a923ca675f328f7cb29bbd259e271a3af8686db36c63d1534f,46224452007
20180116,"PAYMENT RECEIVED",1506037794,0,eee4f6d8436d8fe735f3c21d55e625f38d42d26a0a69df354d76a9240f95f6db,105318007686
20180116,"PAYMENT SENT",0,-16455407306,95898b137765621936decf93c7181b21f9e5b90bb7d600eb8711d9a8b5664617,103811969892
20180116,"PAYMENT RECEIVED",1711345866,0,6c0f88a32292779ff246de7c6736f93e0ee4cb19e9b171f426147ff4d0cb2860,120267377198
20180116,"PAYMENT RECEIVED",1677914243,0,4d39f01c01d9be31aff3f37603ab5f49c6f638ad95eb0e649e33cc5f9818a64e,118556031332
20180116,"PAYMENT RECEIVED",1706856207,0,4666ed04bf52bcc7078b4234a9daca80bdf60c7ec425f3b0e8479edaed5734b2,116878117089
20180116,"PAYMENT RECEIVED",1250000000,0,57a7d6c6e09c257cd91d17eb1e2a74574e63498636966e0ce882d6486b89dc76,115171260882
20180116,"PAYMENT RECEIVED",1735706660,0,b18c2922fa320912003e508c7472a17b03311fb2883567d9f538c85d872634fa,113921260882
20180116,"PAYMENT RECEIVED",1696485849,0,792f422e1109f5e1392bb84bf4ea87292ef28aa7f130f208082a295d12fa21be,112185554222
20180116,"PAYMENT RECEIVED",1509073776,0,8871127e3e2df918149e5e2d5ad598db78cae6454502d18724d68e9b43b9b689,110489068373
20180116,"PAYMENT RECEIVED",1488792808,0,bf4393309453f32841d359f26e1d47140a27b65aa0123175c2569a2ea0ad1e50,108979994597
20180116,"PAYMENT RECEIVED",1454431954,0,714643208c23c8bdf09c38c5a3877d70e9ffab6f94dce339ed4a71f656611c72,107491201789
20180116,"PAYMENT RECEIVED",1767537130,0,7adbc86483953827dbba5fd42e9ecfa0e1f8319d255b1f346c2688d23c800967,106036769835
20180116,"PAYMENT RECEIVED",1708778670,0,eaed0fdf437e29f869bce7c9f2f6354f3497f81fdde53d610b32589dbb30c55a,104269232705
20180115,"PAYMENT RECEIVED",1712503792,0,2c87eee24cf5fbfc26284ef321d0f7600fe65221b13ad5ce33580a418c98aa99,102560454035
20180115,"PAYMENT RECEIVED",1703303487,0,3edcb032ef6ee8b5d425c1ab794399a7a8f27e779efc7fd13c78eb04101d5141,100847950243
20180115,"PAYMENT RECEIVED",1603476504,0,6143732c4b14186cdca835269206c9b906186318faf894e6c58070f67845c0f6,99144646756
20180115,"PAYMENT RECEIVED",1647929824,0,2f25f2082199a58e8b102ce836351e8f726d310e7d22e813bb55be59c365aa43,97541170252
20180115,"PAYMENT RECEIVED",1437057035,0,cb0a4bf9a281a77ae2e7ecd0d582213a140587c01d356d8e8261f30989c6b9f1,95893240428
20180115,"PAYMENT RECEIVED",1250000000,0,d6f29ab09691cd08de9b48f3272eb020b6b12584821035057273e9a961cef112,94456183393
20180115,"PAYMENT RECEIVED",1724645380,0,c20e85077ef71f095d35070487f362dd4baa074196c529980a46b582b9af10d9,93206183393
20180115,"PAYMENT RECEIVED",1624669403,0,abef51e7744a4169ec0b6a032ed38f8953764b9954a3b18179a49a477fc6e139,91481538013
20180115,"PAYMENT RECEIVED",1545474645,0,a8e94f34b0effd1bab0d0e452fff3be2ab4b4de4942b7f7be78d6b17973e6f4d,89856868610
20180115,"PAYMENT RECEIVED",1718362089,0,f6a85c106a4e157b78dbd4bf9da9d472c172a546783f42fd3c498e2f4fceb517,88311393965
20180115,"PAYMENT RECEIVED",1678691592,0,1f7841ed24183be90067c22c5dc1d0bbddd23a37c57203a38ced2a531738b917,86593031876
20180115,"PAYMENT RECEIVED",1691844626,0,ebf3a28938fc9ee01a0ff8c79d4ed425c51bdf07feb149e3c5c211841ec61564,84914340284
20180115,"PAYMENT RECEIVED",1676203104,0,afb22db2d951eee809a58eb2ef341271462f7c8dd4f3a2858ad5635b7dbc3e0e,83222495658
20180115,"PAYMENT RECEIVED",1707847646,0,625c9e052df1096416836dd6cbefbd74fb341f83acaf2c47adf3ecd1d21a79c3,81546292554
20180114,"PAYMENT RECEIVED",1659629226,0,18d1fee621107d782eb06602df9d36a975fe096f06636d75888c8ea6a0bf497a,79838444908
20180114,"PAYMENT RECEIVED",1403419429,0,e0d8bf7c6ed06c67db5082543aef0e946ffda084f4206656bb5dfef53c99e1de,78178815682
20180114,"PAYMENT RECEIVED",1519581783,0,5809ad9e394d35e765e3d0eec643e6807086dfe57bc422e7f2c98641a473cf1f,76775396253
20180114,"PAYMENT RECEIVED",1413732370,0,25b1999f7ca17d4966752eda8598d83583d6129897ee9f7787162b09f9ac654e,75255814470
20180114,"PAYMENT RECEIVED",1498256135,0,559c6302f22e3fcd57fcaf4c3ec82107ad34b7e3b9d4dd06eb03f3b34b6d462c,73842082100
20180114,"PAYMENT RECEIVED",1583109173,0,eb876547399cfd638e1517e7dba9d90aa3ab811a28656182630419c03fd7cb44,72343825965
20180114,"PAYMENT RECEIVED",1613309167,0,9290e628742736e61b794962c2633b25d9ae1ba4beb8353018acf025925037f6,70760716792
20180114,"PAYMENT RECEIVED",1674858209,0,fed5b5579ffe6f25d4ac072967950df4e42937162e11f98b2b4377cfdfea77d9,69147407625
20180114,"PAYMENT RECEIVED",1376785767,0,1c96674caafc2dd286fbc3a98066a4da8014c1995e97e4fbfac554692e83d44a,67472549416
20180114,"PAYMENT RECEIVED",1472459021,0,d1901ee32d9df8efbece35ba5a1bdb99aa4631dcfa4f06b9f6e1f613e2bab4bf,66095763649
20180114,"PAYMENT RECEIVED",1476480797,0,654b22b11b4009e3a6bf76c7a34ba404b92c45bfbd92feaa09738264c2ec0ecc,64623304628
20180114,"PAYMENT SENT",0,-54968172993,a525257033205c5315c3702a835168abb884fc8bca92c479b1fcd7a244762052,63146823831
20180114,"PAYMENT RECEIVED",1645531886,0,e858ff8d02999fb99f9cc13cffc8eaa8e9921b061fcbb021bbeb6fb862b43dc3,118114996824
20180114,"PAYMENT RECEIVED",1436833184,0,9e7c6c6e290fed9c375772fc2ed17f3ad9774c7d99dcee7802af936f808c58a3,116469464938
20180114,"PAYMENT RECEIVED",1413666527,0,3dc151b73c85293be7fe1c98c1fe21957feafc36e4c78e067f6d7dcec790a82c,115032631754
20180114,"PAYMENT RECEIVED",1465279094,0,c2a32b1647b8fdb29404a16d0e35dd3b1d36b21ccb64fd0ecac8d9d15cf21e72,113618965227
20180113,"PAYMENT RECEIVED",1250000000,0,b6ac082871eebc96aed03098817b937249c2261b58d50da037e8fcd35a989c00,112153686133
20180113,"PAYMENT RECEIVED",1638097477,0,9ea671665e65713eae93be79142cd0eb17385b40a47acd28214894a5133a88da,110903686133
20180113,"PAYMENT RECEIVED",1787150300,0,aed5ce17863fcd2a41153d3e7f807964fcec70dd27a1a7601ed7e3c4257bf7b6,109265588656
20180113,"PAYMENT RECEIVED",1250000000,0,128f3489b394a606f6481043e0295ef169b250c53c4a179074210a17688f1419,107478438356
20180113,"PAYMENT RECEIVED",1679968401,0,424015f03b9c40ca00f93eca2671f9641a62273594adc4e4357f6ef5f0116c5e,106228438356
20180113,"PAYMENT RECEIVED",1250000000,0,2e82c37865056c2514c02f75aaf34943409fea5c51cf0d63e8b005fb94d4ad39,104548469955
20180113,"PAYMENT RECEIVED",1799380439,0,8692961a33a90bbab25f3ef31a9913418ef390a70343bd943be34381575d788b,103298469955
20180113,"PAYMENT RECEIVED",1656693922,0,13001dc9ceda920364087313763d02ffc9b7e248a52241b069b42d6e35bba904,101499089516
20180113,"PAYMENT RECEIVED",1465704324,0,453cb0a6153e340610cc192215e767c337a880b8def2f8961f78eed5cca59ec9,99842395594
20180113,"PAYMENT RECEIVED",1771909321,0,ee4c8327d2844edd8b42393bd3f0b778c7fbe1fded89c4628bf85943ab0c2de1,98376691270
20180113,"PAYMENT RECEIVED",1369286341,0,1345f8e2870f74295a0b61f00c3439007d112e39523694effd3e6889e7de34a5,96604781949
20180113,"PAYMENT RECEIVED",1501099641,0,c1cc6c8c70a23b10b67945b81924b36babcd86057a7a2f7867be664435334be8,95235495608
20180113,"PAYMENT RECEIVED",1250000000,0,f6565a215a89110096c6d4b78da60bebd7632018053d725918e83b1e187298aa,93734395967
20180113,"PAYMENT RECEIVED",1529987605,0,c867d9e386eca5427204b8a68ea87d10bc6114830c0ba53c7f376e44eb885717,92484395967
20180112,"PAYMENT RECEIVED",1714547208,0,298abe43b2423b7da4752f1666f272cdb4174875d0b3cfaf50b865213c34a113,90954408362
20180112,"PAYMENT RECEIVED",1826153190,0,538990b912bf19ed0cda673dcd127af95cd94db804789ff63b03778f99ff9ebf,89239861154
20180112,"PAYMENT RECEIVED",1517169703,0,d824d6db7fad757d28f8a0f8c16de242380e9a9aa3fc0f568bd1c6f63d7259cf,87413707964
20180112,"PAYMENT RECEIVED",1495376538,0,c1e396d2a10afe8492e3d237afe1b38a131a2cca3515d4c8e1549e62001a616c,85896538261
20180112,"PAYMENT RECEIVED",1405345965,0,37725cb545b67b58262e61edeb082d4ff0ac9b969babe0efdc68175747b32c71,84401161723
20180112,"PAYMENT RECEIVED",1548344006,0,a27c011a5071bed131b415c9c3734d23c3e7cfc38ce4caaf7dde9f128a680dcb,82995815758
20180112,"PAYMENT RECEIVED",1506723272,0,4f318b1c1a992e8e59ec0688d85d1e9b99984359fcd6f8ff3704586020414152,81447471752
20180112,"PAYMENT RECEIVED",1795134800,0,4d640d76cd392913aacf8519f3fb171a64b0f34ed525b453fec08c8827f91f63,79940748480
20180112,"PAYMENT RECEIVED",1812635187,0,742ff14cd2dd4eb4409b966aeb384c8b98c61d2bd6f299fec55cf76ad5959559,78145613680
20180112,"PAYMENT SENT",0,-42326834386,6458b549bb364e5f742a1d1e7cc0d9e54c4ceeb984166fc2a401411321923941,76332978493
20180112,"PAYMENT RECEIVED",1762212038,0,fd4f85f3bfe3f6ad19fb786508c91a20f1b5a7f7f04b9dab84854a5463374c06,118659812879
20180112,"PAYMENT RECEIVED",1799962718,0,3836f83b404342255b1fde3c08a75f96e39905c89a65008df52a0d4fc9db1d7a,116897600841
20180112,"PAYMENT RECEIVED",1795176387,0,4879ce476e725e07fb717eba5fed95bc1b8be99cbde0548417a49114de9f53a8,115097638123
20180112,"PAYMENT RECEIVED",1795237929,0,b67f8bb14d931093d5216d151b553be78cbbe929ddb7d77c2a57d90ed6e32f8e,113302461736
20180112,"PAYMENT RECEIVED",1582983578,0,70f8c73c240e2c9a2c0f1c31b79de68615653a205f67a62bb2005576b77c040a,111507223807
20180112,"PAYMENT RECEIVED",1736921992,0,048bd571506b03b5280362c8b7117223fcdc237dba17eca71384affbe2e46e03,109924240229
20180112,"PAYMENT RECEIVED",1608728012,0,d5e199e057765b483c73317d373d98496320a4cee3ced01f36d22e05c6f1ce57,108187318237
20180112,"PAYMENT RECEIVED",1452552717,0,b1f27768228f593c75474b27994f41a5b2ab5a1136811f892a6a0f3592ceedc9,106578590225
20180111,"PAYMENT RECEIVED",1618966606,0,6f2f74eca11b989eb27e47d5f7acdccddaf8525a28bf516d8c03a7c0fe17337f,105126037508
20180111,"PAYMENT RECEIVED",1594684903,0,e517129a47f3880a37b26f7934c7cd93f0b9190b43cac680f26d414db1d7dc76,103507070902
20180111,"PAYMENT RECEIVED",1435925997,0,807a35818079536cb7a9b4a532cfcecce790269e3d58d2a01a80fa740f6257ac,101912385999
20180111,"PAYMENT RECEIVED",1565431637,0,95653a03503297606f220b387aa46c64284d464b3cdf239a533164e1b6dfb37c,100476460002
20180111,"PAYMENT RECEIVED",1769389228,0,1d305ff7f7a0a20b244cb297a71c7af2391292e7e70e74a1a06bdbd3de6cd1be,98911028365
20180111,"PAYMENT RECEIVED",1454818775,0,f33851da28524bc085d0ba373f53e893f60861fd57e4a8d8229ad32eb99b964d,97141639137
20180111,"PAYMENT RECEIVED",1250000000,0,a8e1dd364f47da66feb77db57b59fac3ccfda1c72ba29694741459562cf50543,95686820362
20180111,"PAYMENT RECEIVED",1776855657,0,19457b2c277cb209f53fdfb3a5742e16a3ec18d6e6311fea48a54a47db1c0f75,94436820362
20180111,"PAYMENT RECEIVED",1468604290,0,38b0d6f93c8d072f4cfc6a41b870db2e5f072f3e7f7c50ed2aa2a0a1c90d6494,92659964705
20180111,"PAYMENT RECEIVED",1730565351,0,99c7d4e50450dbb61b1ffac77fd5e29f33f3878589f8f91806c5848e8608c8e3,91191360415
20180111,"PAYMENT RECEIVED",1468738460,0,5d63f736e7381b9e643da2632b247d2350759736814f6a318708e6b5d1c4d791,89460795064
20180111,"PAYMENT RECEIVED",1250000000,0,0d92cabcda16e525b675c999d32b88d7de4eb1eeb237b97d3c42421638764bef,87992056604
20180111,"PAYMENT RECEIVED",1758206864,0,7672ac45411b2bc8d734136129c4c4ec5e8747d389d256324d7006ac2d08f29c,86742056604
20180111,"PAYMENT RECEIVED",1587794790,0,f548cfdf7553d8b72730558885dd09c3ca2d779dcb766af4e67b06f3f42e3749,84983849740
20180111,"PAYMENT RECEIVED",1250000000,0,0e5b28434ba924709436a85939d21e563fe4611323d81a02cc7845253630c917,83396054950
20180111,"PAYMENT RECEIVED",1720416925,0,fcd1ba0f40f780062d9a9ee49185a4a9d0a6d43d6a6480114044691aa0703957,82146054950
20180111,"PAYMENT RECEIVED",1770395355,0,5fea708419067fc9b45b445b88c0cd6e8242ac8e90f14705d13d0530f422efe9,80425638025
20180111,"PAYMENT RECEIVED",1763051599,0,445026f5b239e3ddbe5484ef0600af186cc0b31b07ec946405d57bdf4f97d3f1,78655242670
20180111,"PAYMENT RECEIVED",1563838784,0,b362f71da742afa2e8b17313a364ab18cd902d646989dd3fb10780d3c6c075b4,76892191071
20180111,"PAYMENT RECEIVED",1634649227,0,fe503f43ac72396fafe612029d51f4bd5d4e897ad1d7abefd5f5eaa391a30e06,75328352287
20180111,"PAYMENT RECEIVED",1758525472,0,58eae8e4769d5d5dfac5e5e504eb5679176fb246a2e97a03d08d41d453691d99,73693703060
20180110,"PAYMENT RECEIVED",1613514299,0,7401fa8a2521e30ba83874b8d33315e37b4b4d0121e5eb91a1854afe5e90a6e6,71935177588
20180110,"PAYMENT RECEIVED",1675038090,0,eb54fca4c2238626971aa32fb245af8a456a32b3331bf4d542cc573de6c8e568,70321663289
20180110,"PAYMENT RECEIVED",1663667162,0,d33b69105fe1e2b3fb38252dfb364003476f1b40180937a76841fd30baf48c7f,68646625199
20180110,"PAYMENT RECEIVED",1766752127,0,3632c2e1bddc3f506efb97beac66c65d9ad95e8d502a7f6763710cc3a44c6dc0,66982958037
20180110,"PAYMENT RECEIVED",1778855351,0,6f1e9cb470f2e2822e89ea49464f02a781260a8d3b0a9250294ebc43d89a6bc6,65216205910
20180110,"PAYMENT RECEIVED",1781175737,0,6ede71a7cdea4b5dd224ee1037791e9bb1eda5e416d9b5623ff315d56e946191,63437350559
20180110,"PAYMENT RECEIVED",1571883499,0,382b39ce18090a7413da648ca4c708d86a36eee9c3266c0dee67c261b9a7e92e,61656174822
20180110,"PAYMENT RECEIVED",1613027613,0,9ad640855c22721d33710a36aaec2dbdd5cd795f84f405b62629e2420b499af2,60084291323
20180110,"PAYMENT RECEIVED",1752868293,0,058b37b37516670e74667dc096f11cc144816f83164929f68a85de8484e2cd17,58471263710
20180110,"PAYMENT RECEIVED",1557364215,0,974d489cb22db0ec49bf0eb3a3af3272bcda376ef9eabb5d660f7c4412535172,56718395417
20180110,"PAYMENT RECEIVED",1778461297,0,baa1fa847222d7510c0e332246bf9d85553617e2db8b354c3e6498693e248945,55161031202
20180110,"PAYMENT RECEIVED",1838254266,0,3efe005f5d1cda4134d370015d94ac7e0c94d9674851a364751188fc790dc981,53382569905
20180110,"PAYMENT SENT",0,-16513459622,cb3576f095f46d7da0d1003d7238e131c063fab40103f2dae33cd30f9519f82e,51544315639
20180110,"PAYMENT RECEIVED",1727660794,0,7d98fc4b2486b074bc0b4b73dc3a201197dddaa7d080521a53f274cad73b1aff,68057775261
20180110,"PAYMENT SENT",0,-45836002628,131c2518c13f8ece59e6a0b07d7e9d234ca060cca0db9ef8a57d7975d6f62ab9,66330114467
20180110,"PAYMENT RECEIVED",1648494304,0,c5dd582e46b805a5c15b7c0317b7abc4e3505bfab77a6aa95630db548aeb54af,112166117095
20180110,"PAYMENT RECEIVED",1705115777,0,5660a3fc066345c4a0a0ced0937173b95ef6bfc6585d83374255973125183f34,110517622791
20180110,"PAYMENT RECEIVED",1803593925,0,a1bf0b9e68509918b1c03f272563154fa9dcf4074930cf297f95948b728f5665,108812507014
20180110,"PAYMENT RECEIVED",1804870373,0,6aef7a889b3f2ee3ef29549640c83dfc59b52377cc49a470c48730fe995ef2f7,107008913089
20180110,"PAYMENT RECEIVED",1482908360,0,df2db86a4f633d2816f45bf92c163b693aebf0a4187e52c5ed8b8d302da30210,105204042716
20180110,"PAYMENT RECEIVED",1520012848,0,02e34d93b385366f855f0f36862e44330adf9cfb831b16f7ed2db711288c8823,103721134356
20180110,"PAYMENT RECEIVED",1678372029,0,a4a25a4ef203a213b92ac110a89b2fef6e4767fb01fe82ad53e5b8e23980cfee,102201121508
20180110,"PAYMENT RECEIVED",1650538747,0,fa6622640e20f8e4835ca6fb5421235764758b9623f287733ee59ab552bcbc06,100522749479
20180109,"PAYMENT RECEIVED",1808335411,0,adc3be91f5e1d70a55bde541ceb6e29c8bb34e16e9650910e540f306ef395fb1,98872210732
20180109,"PAYMENT RECEIVED",1742734554,0,df102aed300b7ccbb596610ad2498a5090fa3c5e7005b99c61487474007d4a7c,97063875321
20180109,"PAYMENT RECEIVED",1741580076,0,2939bd11af9adc31cb58289ad5665e9685835a9d162e6ecb2a3aac275be7b158,95321140767
20180109,"PAYMENT RECEIVED",1809024066,0,b256724eea608e49cca074e549b1587f7450feb7490a77956d19d061ccf2ca3b,93579560691
20180109,"PAYMENT RECEIVED",1487435930,0,6d3880e760c93ae98f08dbaa741f652f337256164ff18e5c74ab51e3775606d8,91770536625
20180109,"PAYMENT RECEIVED",1599270928,0,44c9029e0ddf988966b20b4a3919e9ddd999dee6fbc1d21f4ea72110a038e356,90283100695
20180109,"PAYMENT RECEIVED",1705957833,0,ed00ca221801dbb75662a37035b493ffec55e106a414cd9c8ec451dccbc38f4e,88683829767
20180109,"PAYMENT RECEIVED",1806467300,0,f945afa51e7c98d2895a7bc9feeb95a1bb52c3dbf644b0c472177df5175d59c6,86977871934
20180109,"PAYMENT RECEIVED",1761044106,0,7d4ccefd1149b6a75620be67a0eb49c721620563f30833d334b0cf967e58f378,85171404634
20180109,"PAYMENT RECEIVED",1786790574,0,e2fba7a4bb85bf424c0ce3577e87a9f9a12626ff47d9b236a0de0d182934a5b8,83410360528
20180109,"PAYMENT RECEIVED",1738771203,0,1dfdab652476a4f3336f34f794a581c391f87f3927d4828dba56fbf201685c2e,81623569954
20180109,"PAYMENT RECEIVED",1782290768,0,d720d4e25645a2726fb2a44cd25a5de3a2eef9f2b28aed733dc7fa21b00b2ab5,79884798751
20180108,"PAYMENT RECEIVED",1558577373,0,639fcc6bbc84a427eae9470c818015c67513ae5a3a8a53d00d8f6317622e9101,78102507983
20180108,"PAYMENT RECEIVED",1631222758,0,569a41cde3720d9117a23849aaa1b14cefac236f84efc56d19e9ffbc307fa3c0,76543930610
20180108,"PAYMENT RECEIVED",1767042090,0,e4752725e6daa59f90d25b35b4129527daa59fcee5a48619bba0badd71e8247b,74912707852
20180108,"PAYMENT RECEIVED",1727097480,0,12f0394b96ba42c8bfd927019c2195f992d1cf46791a99ff8fb21a7118d5b055,73145665762
20180108,"PAYMENT RECEIVED",1836604292,0,daf88550c7f55088ff2285accf17d70581740553840157f13015bdcce2fd1393,71418568282
20180108,"PAYMENT RECEIVED",1856524512,0,b4243b20e4de3a40e1ee2ad0d97a6ef585ca9efda0d427fdeb8c0c09ef8868ee,69581963990
20180108,"PAYMENT RECEIVED",1676648333,0,85b51e2493f1ea059ff1b3a3965db26a62c75fc58b73bd0bc89a4665a13a2635,67725439478
20180108,"PAYMENT RECEIVED",1755409119,0,a200a4db681d16a904198967ed5fab47bbfc9d7d5df59e585de22dc3e09e0cc7,66048791145
20180108,"PAYMENT RECEIVED",1250000000,0,03fcd2bf0f23c77a098cfaf2ef31dde592bcf93b1a4db7c5673f27b9957b5718,64293382026
20180108,"PAYMENT RECEIVED",1250000000,0,b776850ad59f639707838f4220e5b9ee79b902d8818de5efda0084e1b16b6437,63043382026
20180108,"PAYMENT RECEIVED",1729411929,0,fa138516e5f27365725a9504ea1cdd0a996f93cf140a83408cfd1866e5ecc961,61793382026
20180108,"PAYMENT RECEIVED",1470002382,0,084a4c485b6478f9e29a9d43e783d02886f2bb7c8745630b2aa3394ff79070de,60063970097
20180108,"PAYMENT RECEIVED",1733821823,0,e21a64ebbdbbfee91785058fdc522ecd6d79a83b5f30260f4dce6249d71c8980,58593967715
20180108,"PAYMENT RECEIVED",1627617638,0,e6c776c19654d671c21d685f73a76d6a3bcf0c26a6fecfa8d41d4719c2e6aff2,56860145892
20180108,"PAYMENT SENT",0,-58540309712,b6e95b5db03740d476648873b314946f4c65111d794b97e453aa5bce1b8e85a0,55232528254
20180108,"PAYMENT RECEIVED",1570715263,0,013e211b15c1f4b1bd1e4d55f64ea93ca97ef98bdff661ca5ef125b857ccc7b1,113772837966
20180108,"PAYMENT RECEIVED",1653893572,0,66619409ab514a6daacfb30f5d6313f9a17ef95eace5e0d2dd3533d8504bb064,112202122703
20180107,"PAYMENT RECEIVED",1781625133,0,1b15bb19e8a01f64fe884f31b1bdbf4d6b1de9f9a0f587aaf729d2f315cceed5,110548229131
20180107,"PAYMENT RECEIVED",1575984984,0,431f3c6cf7dcacce0ee57bfe55cdbb9ac747ef3d79a3173d3b4986556a2f506e,108766603998
20180107,"PAYMENT RECEIVED",1496742374,0,d2badd4ca0ad9c0d149fe9f01b5a0eb668b7d53c05a61cc943538cbd076e9fd3,107190619014
20180107,"PAYMENT RECEIVED",1250000000,0,351f752c3b37d3f2e4ce58766df70031ef9f401bd4dff5bacac74efa9a6b957b,105693876640
20180107,"PAYMENT RECEIVED",1755940375,0,6197fca1083280ebb10c4fe1c9e80f3dd7364e314f2bbe17a304ff8f6a549311,104443876640
20180107,"PAYMENT RECEIVED",1735336525,0,5469baa49f27ee0321025acee4d06991800baf21953bfdf883fc0777685d3bb4,102687936265
20180106,"PAYMENT RECEIVED",1521892079,0,c196e0fe99cf3dd27e7fe8b2aeb6cdd870d911be04dcf85fe62e5d9af702a841,100952599740
20180106,"PAYMENT RECEIVED",1469519452,0,ee020153f3def92075e86c3f238290a3e8902f9581c97b928aeed67af1f84a05,99430707661
20180106,"PAYMENT RECEIVED",1480082798,0,e49fceed3b814ba4e9e1fde0e105c5f3e102886532990fc0b086f1a0cc2e6a3b,97961188209
20180106,"PAYMENT RECEIVED",1724041414,0,9d8bc5faec1ed1cdcc0778c9a7f1dc6ee6f2e68d6ae8c68680e372a471ecfaa9,96481105411
20180106,"PAYMENT RECEIVED",1684708296,0,4d48c2fc6340658f8926662b1c875df2af9332eb121d900ba723ca72696388e3,94757063997
20180106,"PAYMENT RECEIVED",1527906539,0,8d6d595c807b9bd15555b55bb186e9f3e0aefe4792c49b37a561582af8810fa8,93072355701
20180106,"PAYMENT RECEIVED",1504027186,0,10e50d3f844a222b08e6afdbdd5818c044ae9e090a2c2a4db4249cea55f5aa18,91544449162
20180106,"PAYMENT RECEIVED",1720660156,0,1d32a690c8242ea02f6ae9e9b5a34e3ccc8e3ede09f4cd0bb13b21223b2c5cfe,90040421976
20180106,"PAYMENT RECEIVED",1740056084,0,c81f4083e2dc6de8427ae274e1014ac89703ed13dafbfcb4a86b0ae06f2a173b,88319761820
20180106,"PAYMENT RECEIVED",1578772949,0,00a7f6b82f924b349f8f11d123c62b025667cb4144336101a8803c5178b89ee1,86579705736
20180106,"PAYMENT RECEIVED",1640122255,0,17f78f4fe5141a1cc6fc40990484e9d758d7413cfce68fe4d4595174412a96a7,85000932787
20180106,"PAYMENT RECEIVED",1502348772,0,ed6d1f5557b1cac8333bbfef534c8b307b8eadd30f2ad52b789e5994cda919ed,83360810532
20180106,"PAYMENT RECEIVED",1717639060,0,a9e5db574cb5c91a5b54202b8d27bbb76c5aed7f33ebb6fd2bc70fa5d0a2f776,81858461760
20180106,"PAYMENT RECEIVED",1590338959,0,3b412fa99e56add3aa38679e40806dfb3b228f9bf77ca24e3414e360696f5c26,80140822700
20180106,"PAYMENT RECEIVED",1566225893,0,a6cd066f2bbe44ba00a9964332552164143614c4e5fcaf763f9c75ceef7c0b0b,78550483741
20180106,"PAYMENT RECEIVED",1612848155,0,c1fa5124bc953925d977ac9a47d1ac4cc8ab8c2d717e648c9507d6a127dbe018,76984257848
20180106,"PAYMENT RECEIVED",1684539493,0,7587fb7eeec09379dfd86625cca4296786591f143129392fd490472b6f505f17,75371409693
20180106,"PAYMENT RECEIVED",1699364852,0,c962b2ffaa34b58856645621b562b03f7848c301bfde43464e22ef0a7e8e74c7,73686870200
20180105,"PAYMENT RECEIVED",1791775732,0,5e9809f63005f0cfdba7fd96aa09748e8f420fa405c82c93e538fd3dc58a5ec6,71987505348
20180105,"PAYMENT RECEIVED",1779195864,0,59d4359b07f0cfc00b5e34dabfb0913872cd9d77a32419cbc02d6c3465defb87,70195729616
20180105,"PAYMENT RECEIVED",1703996807,0,cad1f8adce69db0507abf53902ce65f8e14cda71e5bada05ebebd5cda342abd7,68416533752
20180105,"PAYMENT RECEIVED",1707671287,0,b4d77f25cc993823eddeafbfc999ce3138958691d59aaf56bac0b5c75e6311a8,66712536945
20180105,"PAYMENT RECEIVED",1663666175,0,e99af9e239f3af25b84e633e6fba6b0251eccf97d6db44e9055286d3d2987ea7,65004865658
20180105,"PAYMENT RECEIVED",1722786947,0,b36c761ecabaccdeae32cabdbdfb02f0e1fe144cbf130b3fcc51b2fd06873d5d,63341199483
20180105,"PAYMENT RECEIVED",1900295444,0,eb4e34247cc44e4a506f247a37d9bfe9fa0c5275c9382fb63e8839d6b3c00720,61618412536
20180105,"PAYMENT RECEIVED",1877132503,0,4b5c5df6899a53a9e787ab7ad65106db6cb2416845b4bc1e6aa16c2c87d72831,59718117092
20180105,"PAYMENT RECEIVED",1682985175,0,edc79c196fe38485196ba7315b812e2ebf489a48874c6b222016b3326b359c85,57840984589
20180105,"PAYMENT RECEIVED",1735104911,0,85b048e8512419150b0eaea3b4f5fe3daa4888fb51db43c6834a1759c89e0cee,56157999414
20180105,"PAYMENT RECEIVED",1712318053,0,8f170c89c5cc5d1ef635851c3b964b5a7406c1bcd78ff138b12b08baaa2ee7d8,54422894503
20180105,"PAYMENT RECEIVED",1763934304,0,2f0a330593a918cecb8a3e732250e0e35f352a22ea93c35fcdc58690cbc5529d,52710576450
20180105,"PAYMENT SENT",0,-18982429416,d5077f32ca73f862f158d8dc0715e06a5648dea466eee496824effb9cbc10475,50946642146
20180105,"PAYMENT RECEIVED",1635920543,0,592fa7e18aad97d17ae31c1fc8a9a3936f900c434116be6d0e8789f5905538c3,69929071562
20180105,"PAYMENT RECEIVED",1712889967,0,cb47c0682103509ccc44982175c7253032734c533507e10ba0efbd37a969aa0a,68293151019
20180104,"PAYMENT RECEIVED",1786058937,0,301bf8082c26f09ef2aa500dfa59908147ce53279c7a18df0e6babc86a22c1b9,66580261052
20180104,"PAYMENT RECEIVED",1585511711,0,196e86e8c65bff98a38fdb4bf3205c1b1fcf4f55c0f15d921df14f74b55b16c1,64794202115
20180104,"PAYMENT RECEIVED",1731648923,0,e9a0ac7e956acb909290fb1f3bb05d2dec64446cc75f366cdb9c866b1cdba85c,63208690404
20180104,"PAYMENT RECEIVED",1762684149,0,1b686c673a1cf6fd577962ca1f452d7f294ab59383caa08ec84a6e77047a5333,61477041481
20180104,"PAYMENT RECEIVED",1689595922,0,3f92b2c530b0643f3e24bd13d10284c10a509ca2fd8268e3308d1736841c60cb,59714357332
20180104,"PAYMENT RECEIVED",1729730209,0,224ad59d643d6b94811823c8a7eb50661a28c061ce168cfe4e20eb0acdf17d47,58024761410
20180104,"PAYMENT RECEIVED",1666998988,0,e93a3c6a639c40966b2a129512ac1fa287d1f6b182d838459b68f372f54b77a9,56295031201
20180104,"PAYMENT RECEIVED",1631210204,0,b4f3211afd69b5694ce8c5b301709fe5581ab5eccac5e98ec76938790ef41ece,54628032213
20180104,"PAYMENT RECEIVED",1621034993,0,844415f1b5ade325a0cc29764f6fb0d9e2f69f1e69210b3e3e78a14d47a0997e,52996822009
20180104,"PAYMENT RECEIVED",1718543737,0,473a076e79d70f9e0cc384bfcb2e1456ef8e0bf38e967b26d8cd6461684a5e12,51375787016
20180104,"PAYMENT RECEIVED",1706484725,0,ddb7e607a118aca85d4a7e17eb9e3989ff7fc72b7f0566f31af82402ef4cdafb,49657243279
20180104,"PAYMENT RECEIVED",1823694536,0,7527785d3b3dfd1e43bd4d1bdafa10523924ed8f631fc0601a0d8f42f7925b9d,47950758554
20180104,"PAYMENT RECEIVED",1733520097,0,d0df3bb7e25aa1ea2192993ce0c2fe1403903b295c51aede3acafec1db988cbd,46127064018
20180104,"PAYMENT RECEIVED",1549381684,0,95da354f1179fefc82b2010aaee9c9c5c9e6c205ba63845257524531c052c019,44393543921
20180104,"PAYMENT RECEIVED",1582883120,0,3d836db5d57e2bc0b46fe7c294d5118cdbd940bbdc0f350b9ecadd765e3cfe85,42844162237
20180104,"PAYMENT RECEIVED",1860299986,0,9acb24e928e0094d3f6bbd519ebb0aab005be1d8aa9090df780f2f3a3cc1ed9c,41261279117
20180104,"PAYMENT RECEIVED",1689399884,0,0505e197befb13f9b8253c1515735c4865a373f440d78ffbb9abcc9efe6bfd1e,39400979131
20180104,"PAYMENT RECEIVED",1698428748,0,de6533536daee2339ef49298a97dd9f87dfa82c390fc9571e5ea3c0652534163,37711579247
20180104,"PAYMENT RECEIVED",1694012148,0,da45ea37775f4ade7d560951249af546203b176c8b2aeaf5ac6443c80cb234e2,36013150499
20180104,"PAYMENT RECEIVED",1754384911,0,3554d9b6cc2655aa4b4247037359cde57bd1709eee43711cd8e53175d629e30c,34319138351
20180104,"PAYMENT RECEIVED",1717228875,0,4249b516c13e669317a868260ecc0d0322108b7bf03eb9dbb4621f24aaacd834,32564753440
20180104,"PAYMENT SENT",0,-42025347979,cb238c5f60e399c9e587a46717928033b431c9d777ae2fe02a1719572c43cdeb,30847524565
20180104,"PAYMENT RECEIVED",1865751142,0,6d24f8daa3f21f29646811e82262e8e6d7802d133f724e06c7a5bfa175628e4e,72872872544
20180104,"PAYMENT RECEIVED",1795977160,0,c32edf90128f2d477825725fa4378a413d8fa9e325989c6f966329c94c8182fe,71007121402
20180103,"PAYMENT RECEIVED",1744643336,0,1a7bb0f58a5d235d232deb61d9e2208dabe69848883677abe78e9291a00638e8,69211144242
20180103,"PAYMENT RECEIVED",1537439484,0,10f5e875509c34f5e7d7ba550fa91e08f8d6304dab9d2996217bed5b37b5206f,67466500906
20180103,"PAYMENT RECEIVED",1645747303,0,dfb1dc15675d7e73d3e2cc5aaafa07a447d123503d4e27d80eda5cbc7d5a004e,65929061422
20180103,"PAYMENT RECEIVED",1753515046,0,2482527859eacabf595105891b55a4c57bb24bafe692401036e38c3ab461417a,64283314119
20180103,"PAYMENT RECEIVED",1883022098,0,4d2d4cb5cab0adece6f56f77e9c52d29c73a1b2e4e79782a633f52c4f58bb337,62529799073
20180103,"PAYMENT RECEIVED",1862112100,0,f2a8a20fe06bd67507212d2f87d698101379838d1a5ed980a68fd573d667425f,60646776975
20180103,"PAYMENT RECEIVED",1695004666,0,6864bbd5a54db2fdd9e6c9812b72caae075599380b66c6e756c726c7de28a42a,58784664875
20180103,"PAYMENT RECEIVED",1761401132,0,5025d80a31ce536ddf6e55bbed7e5b034977ef241df874df2af67af609c3ffab,57089660209
20180102,"PAYMENT RECEIVED",1602102922,0,7739f3a905cee7cbbb0deb6ab1bee86866a00e527c261db9bc37fbc4157b35f1,55328259077
20180102,"PAYMENT RECEIVED",1653516485,0,2b7f55da5dd3ddeb079cc799cef704b70c2f8e348b81870f8d6263767d10474e,53726156155
20180102,"PAYMENT RECEIVED",1937226895,0,aa8faa2eae76a9e5047a65f674f3e9c720a6421221f92152b3c619ae251669ee,52072639670
20180102,"PAYMENT RECEIVED",1599314661,0,675f6a6dc48f2924128eb40076cc239232b54e23e21f52c5706a4cf018ccc43a,50135412775
20180102,"PAYMENT RECEIVED",1746519154,0,8592b169cf39ecbb1aa4507e9f5aa934e6066a4cf51efbafeaac1268bc7d0a39,48536098114
20180102,"PAYMENT RECEIVED",1660116468,0,0b35f3808eee8934398d5c7f3b1a512533e9bda6ae99faa0af89e4f76801b44c,46789578960
20180102,"PAYMENT RECEIVED",1945289197,0,5af0563508f677dc783c25a31c57597fd358b771e7e2ce6a0141dd2ac5237c6f,45129462492
20180102,"PAYMENT RECEIVED",1558676520,0,9bfc35d90aca05fb9753164fc93bad5a12d731511e01e1ce8695cbac0cb5f52c,43184173295
20180102,"PAYMENT RECEIVED",1775901295,0,280269f9c698a7ad954401f7fb640e50a60a6f683b9fd2aa8d36d470fe4cce53,41625496775
20180102,"PAYMENT RECEIVED",1680116695,0,0f790934897fb99f031f38812cadfdc7c3fc7372e801bd0ba5f9699d0e73a2eb,39849595480
20180102,"PAYMENT RECEIVED",1755898042,0,c9aec7362eb959f9c1bb8375fabcecd9d3e48c4b73ddac82e0776a6c49469edf,38169478785
20180102,"PAYMENT RECEIVED",1413273911,0,c49ce98e2c07e4d9014880d7418e03444e5f7296e6d0b3d541f9425eb0f2bfac,36413580743
20180102,"PAYMENT SENT",0,-35831238793,c29236c3be27fc954c7484f6faf34fe9c5f881ac11087a3cf92228a8362eb226,35000306832
20180102,"PAYMENT RECEIVED",1423849491,0,e2b0506b38d482bd10663ac6baa46eec6dbd8570f5cdf8a93de5acd45a50034b,70831545625
20180102,"PAYMENT RECEIVED",1696966557,0,9c8a4bc0630ffe365a28df445a8d6a0a755e2c81204d696242fbfe60006c2a0f,69407696134
20180102,"PAYMENT RECEIVED",1584855260,0,26844a695d1f33e2563a512855bed40364461a6ffab5b22d9ec5e9c34d95d5d0,67710729577
20180101,"PAYMENT RECEIVED",1765447403,0,1982fa9d99e04045cfa25eb910333d214879afe998e09ce0df2f90cfaeef3abf,66125874317
20180101,"PAYMENT RECEIVED",1640058245,0,8b61fbd8c2a6b461e3d356371f59c6bb64b94ddc984b32efb738c5ead14ad4c1,64360426914
20180101,"PAYMENT RECEIVED",1626231377,0,db663a0a0f671823f7aab4f05d2bf45e0fea9728c3a3a90705a08b4ff717d105,62720368669
20180101,"PAYMENT RECEIVED",1538485418,0,65487005ad32bde015663618f87c1f7a9461996b693c0e3c2193977bb039b580,61094137292
20180101,"PAYMENT RECEIVED",1901411844,0,96dacf3c7aa705e6980a4e54edc2d41e9ba97e1ee5b2c19a7e6ce0db1626c841,59555651874
20180101,"PAYMENT RECEIVED",1484794500,0,4c477ec96f2fe0abb8891f996c38d37e1604cc04a1eaecb657568ce2ce2bb857,57654240030
20180101,"PAYMENT RECEIVED",1893861961,0,5666d50b44d85edf74dcb2483213e566c1da59f581f5e9e76d9aa4402f7cb800,56169445530
20180101,"PAYMENT RECEIVED",1513904319,0,53a98b923e8ce7484c122354834cdcf4ef85350946dd6f6d7545ef01ee5fa3e7,54275583569
20180101,"PAYMENT SENT",0,-15011263394,12cd84d5a17b6d1e5605200ecee166ac8f69e22d0d0efb2e67976ee356dca8dc,52761679250
20180101,"PAYMENT RECEIVED",1416231553,0,1303c8a0dbef79ecd476ecc3ab085614693da20115e6cbbc758d0a88783db980,67772942644
20180101,"PAYMENT RECEIVED",1315490514,0,63b0ed77766092ed36ace50e09cf6372717451d937d8dc77e56dfc038bdc05a0,66356711091
20180101,"PAYMENT RECEIVED",1401658298,0,2f795c3f909808c0de0ef88419f6ee9372f1dab862b44f802d9b089df3bd9cd9,65041220577
20180101,"PAYMENT RECEIVED",1483777707,0,6c6abd577054cd1b5adccfd3ab7dc9d3bdeaffb9e13dc47fe0edafcfe59ccdae,63639562279
20180101,"PAYMENT RECEIVED",1608191627,0,192865cc07abfdd80bebe0848d6e6f7fb40ff53852d842e2126187c4bb6a5bd2,62155784572
20180101,"PAYMENT RECEIVED",1456283332,0,3c63556a7ae3ab2dc1a575a0b2dd037bd49c09f2de0abd518c381d98658f059e,60547592945
20180101,"PAYMENT RECEIVED",1385761522,0,2352b7139fd8a8dd1cea5994a9636a6317e845c6387a6112f0497cb6f985f2b0,59091309613
20171231,"PAYMENT RECEIVED",1403819573,0,2b6086db38773deb46d2220e5f393e6d487cfa9d20d0f8729edfe2881cdd429d,57705548091
20171231,"PAYMENT RECEIVED",1395477849,0,0169382f9a7bc84649a3b38fb6e8e320b4295c50f2b7ee85d8d4339a3436cc7a,56301728518
20171231,"PAYMENT RECEIVED",1363330903,0,0ab381fa98f5c50f8cbacdf58254a0400e110acb1e772c798a0de6212f91b235,54906250669
20171231,"PAYMENT SENT",0,-13222324882,8a5308985fdb5e7c282b9477011a7e68a61624af225905c8905d8d51073ea420,53542919766
20171231,"PAYMENT RECEIVED",1490008274,0,f189775ca58fbce72f9e5befd05d916830e8d5a8708e1fa6ff98eb8f7872d0a4,66765244648
20171231,"PAYMENT RECEIVED",1250000000,0,cd76f6cad87e75c2a05d40a88b51a64ba135dc2d02f055fbab0d10046258e391,65275236374
20171231,"PAYMENT RECEIVED",1648550424,0,d0043efe05cb71f3a7cffe31a2ba40324cfb690e0ee8504efb7c50018a271d8e,64025236374
20171231,"PAYMENT RECEIVED",1362021389,0,cfc0ff4a6bb165da4d076f32a3a3f3d4354779489d17796ec0ec460f9297a42f,62376685950
20171231,"PAYMENT RECEIVED",1887799649,0,74297c482d9604b811608e098cb87638053280aabbbab5c28075f29013e06f38,61014664561
20171231,"PAYMENT RECEIVED",1342239791,0,9e72a907006720810c874f04719c2c0725e9e351e7554c2c3526802d1803490e,59126864912
20171231,"PAYMENT RECEIVED",1406290543,0,9b10fa5ccc9f5ba24df941c8f9a58146def1ff94f19bc5b05640413e1e1dc7dc,57784625121
20171231,"PAYMENT SENT",0,-18116625121,ac9a1930892e5e820474745dd397266cf596cd4bf99cae3f78e2ce1b26aec106,56378334578
20171231,"PAYMENT RECEIVED",1385227996,0,c03ccf1c06aa41b0fb186f4e68bbe97cc234575f7810e32b9d550c531e372b6b,74494959699
20171231,"PAYMENT RECEIVED",1522454060,0,5816c1082032975eae8f8e9d6eaee17ee0885aa38ba856e66c193088cb98b036,73109731703
20171230,"PAYMENT RECEIVED",1972378251,0,0a8f773c9d885f073dcf371b9152cafb8d6650ccd5733fddd7df60c8bf3b7460,71587277643
20171230,"PAYMENT RECEIVED",1652682243,0,42d2e3aedfc8d5169c7b93faf4b57e2def05f2d01568688794a7f3b0f930f0d8,69614899392
20171230,"PAYMENT RECEIVED",1881513354,0,327daf6549a5223e185d8ce2408a992516b9990865ba64c13fb6c879452d2dd8,67962217149
20171230,"PAYMENT RECEIVED",1994380168,0,fb21ea2eaedc7f6571629fb559bd1ee1c919699b169f0008dfad301ffbd72289,66080703795
20171229,"PAYMENT RECEIVED",1509678878,0,e62d3a591650e935ba333ee3dcdacd35a72d754799f1211339a89c2cf3fa6b2b,64086323627
20171229,"PAYMENT RECEIVED",1596465804,0,70113f59673cb28529d48029717739e221cebece0636014fd0903f9f8b10f0e1,62576644749
20171229,"PAYMENT RECEIVED",1522923907,0,76073303ddb7181600a6eabc51fb9cc64df4379209200d5473738e02f4777fb8,60980178945
20171229,"PAYMENT RECEIVED",1876257300,0,d07c66927e4e5d198f8c198ae4241cda681a89d4ef16af4049aaa04ffa690ed5,59457255038
20171229,"PAYMENT RECEIVED",1913434225,0,b7876a9823d1c586cb4d2cb8835c181126131d134bcd360800ae6faa3ed65b7f,57580997738
20171229,"PAYMENT RECEIVED",1375836829,0,63376a9f887cc1ed5da1390c94aea4a527e71f5a4d94671d64a1eba1ab60476a,55667563513
20171229,"PAYMENT RECEIVED",1961384722,0,baef8a22891cd3babefc04fb5c06726a6e4cc0f53e7146be9223cc17280d2ea2,54291726684
20171229,"PAYMENT RECEIVED",2040265698,0,15b5b7ef50e9d5852313edd526e29e203719c39af42f4582b1b88822d6183f40,52330341962
20171229,"PAYMENT RECEIVED",2049464885,0,bbfee972a1fbe166dab4454fc309f246d8264f324d5cd34403175c83627ac435,50290076264
20171229,"PAYMENT RECEIVED",1882714678,0,87a8cfeadb826cdf668195ff10a928ef1d1b066a8b25be9ffaa0440f48887753,48240611379
20171229,"PAYMENT RECEIVED",1369509238,0,478b82b75685054400999b6778b405cf4e9a72fce4d98b286800a9dea2e13c7a,46357896701
20171229,"PAYMENT SENT",0,-40743708034,095521ca4f23fe29c14b378a4d56483b861daa8a5e8290ea510a9ad59736cc33,44988387463
20171229,"PAYMENT RECEIVED",2050513753,0,e1332f176ab451ed9a9bb699d1c87458cf2b11d74cd83d35a8f16ff71ebf3b3a,85732095497
20171228,"PAYMENT RECEIVED",1948273973,0,3a45ef503a34b1109b2d0c1d7c1683d72b804ad2c65ea282d47c74851a780180,83681581744
20171228,"PAYMENT RECEIVED",1573074531,0,d10b27d1c9e1055479430eff595fe7fe0f5429ec12a698c432a1db5810ce84fd,81733307771
20171228,"PAYMENT RECEIVED",2169297793,0,6a5cc8d629287bcbd1ed0246879f1e6af6db7b8ebb7eb4c766301c528a9ffe3a,80160233240
20171228,"PAYMENT RECEIVED",1693175684,0,2e26896d01d13a4c5979c16504d5b3923125dcbde74ffe9b99121c6e702ab7bf,77990935447
20171228,"PAYMENT RECEIVED",1702937167,0,eaa889247d8df2172460a8ff765f20eb82420b80d507a52315faeee81c99df37,76297759763
20171228,"PAYMENT RECEIVED",1402963143,0,10632263421c59fff6fff86d931fee007eb527ab55e99783ade3195f6d9aee71,74594822596
20171228,"PAYMENT RECEIVED",1578775681,0,d2f3248e15ff217448308e68bd5201abc20c92a8d7826501a14f44310267acee,73191859453
20171228,"PAYMENT RECEIVED",1807065101,0,1ba3e3fc8d4960e7e1c2c57d7e4ccb56fe2fab824fd39948499f15c951e66f6d,71613083772
20171227,"PAYMENT RECEIVED",2027851271,0,44fd7b6909d3db5110f954531a874d9c367055ff8c95abc6721d78aaeb65f68e,69806018671
20171227,"PAYMENT RECEIVED",1762003547,0,3c0b7c0e31ede66dd063a791cf1d0c6569fbc7b13a75008ed68df14aea34e0a9,67778167400
20171227,"PAYMENT RECEIVED",1911005403,0,6edc77e6c9b823dda6753f94c55aa21b43c7525db02efaf5345fe63eca2f3dfb,66016163853
20171227,"PAYMENT RECEIVED",1798947733,0,1d8e024cf26094fe815780a0b4a58449408b506b8f5fd39bf816153c8a0af811,64105158450
20171227,"PAYMENT RECEIVED",1535110630,0,0a9f78fc2c4aab5e30e5f50b7d2e152f9bc8f9b1e77db1620647abcdac622f88,62306210717
20171227,"PAYMENT RECEIVED",2154911115,0,86383367208b3de812a0689a8ab15d447a2f68fd29640118bfeade0e644516a2,60771100087
20171227,"PAYMENT RECEIVED",1745070656,0,6f1d5fcfa607cb7a0077c20419a59d189bfe88abcee1ff7147141c2b9e934f9a,58616188972
20171227,"PAYMENT RECEIVED",1530535478,0,1194a98ca0b5a07ef9f7caf377cc1ad5580e7d56ebe6241916d9a1858004fef9,56871118316
20171227,"PAYMENT SENT",0,-46863966544,68425ab79467babfa570de49490efcf5de0c1545907fcbe6973474ff1281960c,55340582838
20171227,"PAYMENT RECEIVED",1686789315,0,e6090f182a58006018e1947912cb85cd2b84316b413ccc5df9470cd95d174957,102204549382
20171226,"PAYMENT RECEIVED",2159557833,0,b71e38faceef2274edc867e47e1536c04aa34929dbb39dd9888412a5ab68d4e6,100517760067
20171226,"PAYMENT RECEIVED",1563707870,0,cd442eeecab8559b3ad58c896ad798432d95cc64b801a7070500df95e886c860,98358202234
20171226,"PAYMENT RECEIVED",1861649954,0,f9bef3a717d19b2ec6708df1693cac0deebc5ecda933d3c9db0d2b5d06bbf6f0,96794494364
20171226,"PAYMENT RECEIVED",2340484940,0,6f1f515025e578bb8876ec86724c20d3871ef0d40a258f56e47f9b0389e851a6,94932844410
20171226,"PAYMENT RECEIVED",1551193697,0,50f9f25a4655e1fcf5764bf54d3f9ed1b7d28862c296006035a0ca8c177378a4,92592359470
20171226,"PAYMENT RECEIVED",1626352867,0,2ed22527c3f4a21ed02b301b2c34bee33386bf22a953f842f826b1237ab1b733,91041165773
20171226,"PAYMENT RECEIVED",1720952288,0,1e7317d628f7809af93615117107478c5617cfe3ece7c06a47e21c5f927600fe,89414812906
20171226,"PAYMENT RECEIVED",2118222873,0,043008b52bdc69492658c8e387fd8c0c561ab13882ca48fcec0d20e338763f3f,87693860618
20171226,"PAYMENT RECEIVED",1901547799,0,eca726ebdd977006c036f023cb1b50c89ce7864c3d7cee0687b53c61e9b4ca7e,85575637745
20171226,"PAYMENT RECEIVED",1402500082,0,4d401a9996d1c71a9ae9100ef9930cf758fe4ed01eacc839738780b97cf66033,83674089946
20171226,"PAYMENT RECEIVED",1641002538,0,4c1d612c21e6fb5cb423ed64ce8ae2a0ccaf3753c432b8dc93ac8581d992331f,82271589864
20171226,"PAYMENT RECEIVED",2116026838,0,6be984f4230f48a7c8c8ff532a1d446faec9003b73da8b568a25946ffa345d5c,80630587326
20171226,"PAYMENT RECEIVED",1540139870,0,8ce8d4bbf6d987dc49423ebd499acdc5322a827447eb8c52b199ceaca849e025,78514560488
20171226,"PAYMENT RECEIVED",1555895888,0,fb1037617372dc90056c426a5bf21b4d6149b5cf22e9cd046dd93892b632b14b,76974420618
20171226,"PAYMENT RECEIVED",1696467000,0,dc496e96fc0c2e3cb79806c69a93724af6676736eb719368f888499c6f9c6788,75418524730
20171225,"PAYMENT RECEIVED",1952883352,0,9392a889b713f82ec2915587b7c83604e337d56b55069caf815cf1b4496c39ff,73722057730
20171225,"PAYMENT RECEIVED",1806629180,0,47c46a29ee05f6c93c45db6d90e9adb42dc93f83fc3da398b5e6d4184f11afb0,71769174378
20171225,"PAYMENT RECEIVED",2220417230,0,72209c1d343c6b0d00e97a02d7300bccf9099fd8ac0a58508531dc9ab133522b,69962545198
20171225,"PAYMENT RECEIVED",2159772188,0,57c189fbf0eb6613bc9f9761659a4045771bb510f77ecf28eb5b054aedc2ee75,97893639946
20171225,"PAYMENT SENT",0,-30151511978,7d959162f1b71fa5fc61978aa6ede8c1d0f23cc378cda03647cac055ac1f1678,67742127968
20171225,"PAYMENT RECEIVED",1823970683,0,3c0f59d6eb4094377ba430486c230834bb57b1441c46fe080c602a912dddfc2e,95733867758
20171225,"PAYMENT RECEIVED",2190110794,0,4d1822418183574a82637a3b8a7a935432b9231f315f2457d65e4b0dc73ae982,93909897075
20171225,"PAYMENT RECEIVED",1618189883,0,cee1c7350016c37213e961cf70fbf2aa40ec5b75e88afbebb2c42948bef56c5c,91719786281
20171225,"PAYMENT RECEIVED",2023143947,0,a225ff381412a31eddea5d45e3147f72d9245d40e811c81fb7af39bd1fa8c37f,90101596398
20171225,"PAYMENT RECEIVED",1698919439,0,a154edf550a4cb59f02983c1b1eced9411542bb96ab7fb622bf6247744a911ae,88078452451
20171225,"PAYMENT RECEIVED",1432354145,0,5daa12144197534883e60759792e067a524f714a827d1d8198a7affad1b7957d,86379533012
20171224,"PAYMENT RECEIVED",1548235421,0,b44829ef3a92c1fd463d15c9c988517395cb03c7cf3a1cc29e78150aa1222bec,84947178867
20171224,"PAYMENT RECEIVED",1569820171,0,12ebf28efecdc395335cebfe63e411493230bd80a1b5926c9679ad3ec298bf5a,83398943446
20171224,"PAYMENT RECEIVED",1509526329,0,44cce58e183156ea2d9305c4375ad1163430238d29f121ef74b57f791d12546a,81829123275
20171224,"PAYMENT RECEIVED",1661857544,0,3d47d774445db9108ae0b1c8115cd94633cac201f5a2fe14be13cdad0b67b3eb,80319596946
20171224,"PAYMENT RECEIVED",2142014038,0,34c16cd35a7c9803fe54e4def0f36227bff18b2bc96fe5bd170ff9c82aade6c9,78657739402
20171224,"PAYMENT RECEIVED",2055155901,0,41d3e3c9f2fb93a4c3044642b722cca8b2735342abda4a1943156efb21e7fa39,76515725364
20171224,"PAYMENT RECEIVED",1991861566,0,bddc23088155318271c8da0876f2799c3d5cc7688607e4c53e2cf0c85c49aa52,74460569463
20171224,"PAYMENT RECEIVED",1549654361,0,a0915fdd1ac345d35beab8316fa2cccec4967887a191e5df6f64c988d6df9f4a,72468707897
20171224,"PAYMENT RECEIVED",1558927345,0,fe30f82e8e1d141f152d235990920d9e09312fac9abb6ac8346356da0a9580bb,70919053536
20171224,"PAYMENT RECEIVED",2167554309,0,bc110304353ad00b6af426ab50ccd03c2165646aac9b92df5048aae23bc678c5,69360126191
20171224,"PAYMENT RECEIVED",1746238810,0,6aa7438965e782b858fec83bf1f7f4ddd448103bed2b2d79a65f33e2e91abe42,67192571882
20171224,"PAYMENT RECEIVED",1574412128,0,7f591bc916e07fded77a0a424d4591de92c6698e3e01ea099e3cb8ffa82ae87c,65446333072
20171224,"PAYMENT RECEIVED",2018978170,0,5b753fea450ae5858e09f35e92290ea17e1f626687e882caf50792ddbd9d1403,63871920944
20171224,"PAYMENT RECEIVED",1853871456,0,d81f376513a8d017c89dfdf42090d2ee595df9c1f97bed15937ac6ad9a74d75d,61852942774
20171223,"PAYMENT RECEIVED",2309191421,0,4b7c17537244dea8f020c89843b9b9e2d4188863a20b58fc34f3bb8d8fbed267,59999071318
20171223,"PAYMENT RECEIVED",2017533756,0,7417cb058c79e33e61c87248359ca7e22b017afd2be966c0da47e74614b1a8b3,57689879897
20171223,"PAYMENT RECEIVED",1777480454,0,201e9cc824bd9be74cecc2c2c62570d1133fcc0d4d9172c8cc0c06505184857d,55672346141
20171223,"PAYMENT RECEIVED",1676536164,0,15145301c40c6406e4d6b99908777c759a6305ff037847e9d4cb258fd2dcb037,53894865687
20171223,"PAYMENT RECEIVED",1647299757,0,11442c3d3a7d79b2e06cd72e2efd4572e4d572dbb0dc79610ec746da4506e0cd,52218329523
20171223,"PAYMENT RECEIVED",2295447148,0,ece3195bee2d6570c3da6a1f97de5f4936b4fe3b6cd46bcaf304d120c6679631,50571029766
20171223,"PAYMENT RECEIVED",2395311286,0,b2aacbc71e718cf3d4c24b748a49e993227867a5d72a3aaea9dd0d74e9fe0375,48275582618
20171223,"PAYMENT SENT",0,-31585301431,062f2b9df034814cf7b802ab1dbcd563b354edf4df1c607e0bca985ba36c2853,45880271332
20171223,"PAYMENT RECEIVED",2249850230,0,38d89405ae959e55574c33bb251905e91a0ba7d87f13badc7db892c239a8dee6,77465572763
20171223,"PAYMENT RECEIVED",2374111777,0,62e8750d08a71b7c87edfb93a4f2dfd378e182c5c4c84051779f69fa60a41786,75215722533
20171222,"PAYMENT RECEIVED",2058647219,0,194ec598464fcbf1d2c98ed01f3b85b89ddda2f453ffa1c27e806869ba651fcb,72841610756
20171222,"PAYMENT RECEIVED",1774993442,0,d1b0cd109c242baa5e43463c6f6da20593ee9e153df21728ec1f4a9fe5817e4d,70782963537
20171222,"PAYMENT RECEIVED",1869526484,0,e0154c72868b9e61b4639582b7a8bf088794740f3489772f8181eb369210d6be,69007970095
20171222,"PAYMENT RECEIVED",2116142133,0,f1bcf3d6e4d15a5e0bcac35afce182500b677f9198889009accb69032d68c85d,67138443611
20171222,"PAYMENT RECEIVED",2494138988,0,bbd7126b24be419aab524631413eb11dd31cc9110760cd1df32ff7e2609436ae,65022301478
20171222,"PAYMENT RECEIVED",2294563444,0,c67265c5af09f1ebcd68afb1bfa21b32f2418cd54719a78edc2de64efb74f22b,62528162490
20171222,"PAYMENT RECEIVED",2252583130,0,3c7c3c223c8f2628524e893e97620f49840079637826c6d0f9b78c2c47128f2c,60233599046
20171222,"PAYMENT RECEIVED",2408611728,0,c1821aa133d4d80c546c15a45e868cb891050b773587760c9fdca0c075958b7f,57981015916
20171222,"PAYMENT RECEIVED",2448257240,0,3ea7997de40b210476de36fad7403f38a5a148d98384bea403c215793e070e01,55572404188
20171222,"PAYMENT RECEIVED",2291331143,0,d86c7d63f72eb0236917ee07fb9f58b1d68b736331e92a41530f9fd9da5fc441,53124146948
20171222,"PAYMENT RECEIVED",2307616663,0,0d3bfed09a0629af0a8e193f5bfaeac02eaea4ba3d20a8a27813672147247082,50832815805
20171222,"PAYMENT RECEIVED",2343497617,0,1486c4f8c8d3783fa5cdc2eb282baf82375c259543ade860b08ae4b836408900,48525199142
20171221,"PAYMENT RECEIVED",2069136032,0,4136f55a31659e298db4c0cbfa4cae348f2e8d6485fd7cb79de59085b4cb56a0,46181701525
20171221,"PAYMENT RECEIVED",2000136603,0,4548c5e9b1a7645452a2582faeea343b7a61a47b7df99d1c2f23bf20f92fccbd,44112565493
20171221,"PAYMENT RECEIVED",2118418936,0,aa21f97e643a1f044c27d364ca4fdd36c25e300b9d8c996ae4ea879aa99b4ea6,42112428890
20171221,"PAYMENT RECEIVED",2080235148,0,480ea68a6320018782bd85ff5a239482aa8a2eeb4c04fe6c3a41867f7961d488,39994009954
20171220,"PAYMENT RECEIVED",2037208067,0,0c20ca7c51d43900c49745b58578ffab6a063576ee7dc44bcfa6b3e942ef3b83,37913774806
20171220,"PAYMENT RECEIVED",1962310452,0,1805310b142d81c20fa7aaeb90907a798968bf3743a6e5bb0ca445153a30175e,35876566739
20171220,"PAYMENT RECEIVED",2034806323,0,77753a47df01fdc75a4b5919543154b647ef4c377fe6e71776414a7364113a58,33914256287
20171220,"PAYMENT RECEIVED",1992338307,0,f18c4cff8c0f58c7a784a9aca1f1a1c77d13ae6a16c5772efd7bc37b4fbae551,31879449964
20171220,"PAYMENT RECEIVED",2039839252,0,3ebfe8b224809a318889b28a28dd02187fcad6ef2608fdc322bff07c6ef1b0fc,29887111657
20171220,"PAYMENT RECEIVED",1838864477,0,78138d6c4d4e13014de66aca8b113948c08e816e4afd8f233fafb6cf1b382972,27847272405
20171220,"PAYMENT RECEIVED",1944496264,0,7cfe59e196ae27ba88a7c6b397336d44dbd6b1b5a7eaa422ae75301d61b605ca,26008407928
20171220,"PAYMENT SENT",0,-19904622162,9098f2813fe555b3d76eb9588beb05c4ef7653ca325606079059fec877c629e1,24063911664
20171219,"PAYMENT RECEIVED",1865822722,0,6049cfca7097039e35dc23005bdeb0b883639d67d6cec479339f67fb73ed4ca3,43968533826
20171219,"PAYMENT RECEIVED",1748572508,0,64799f648f25a6d34226b3e8681c2dec3b9e4887be614d959fb758c2528225dc,42102711104
20171219,"PAYMENT RECEIVED",1813686362,0,df6cf41301ef6accd037639662dea72466097dc8f9ca6c082f18f83aaedd03f0,40354138596
20171219,"PAYMENT RECEIVED",1715631255,0,cbfae1beb2a9d804d0ae7511ac78707902811ee23909df78115bac69e8a1355e,38540452234
20171219,"PAYMENT RECEIVED",1622043305,0,0a76b11c125c38e77db376c7e72432f514c1dbf87263ae7cbbd578c45365afdb,36824820979
20171219,"PAYMENT RECEIVED",1724065469,0,d4cf961d713cf1b6fa507d41e5d3b51d52d7c7956cd45defed2b5e75fc114a13,35202777674
20171219,"PAYMENT RECEIVED",1569123012,0,01bcb347cf609f5b33b404ef2d3a217b8f49b664e510f8c3f06cf362a0234979,33478712205
20171218,"PAYMENT RECEIVED",1646853461,0,d217d41b884a6ae02dee2f42010c33116c9ba8e3bc6feff3b37f8cbd68c45276,31909589193
20171218,"PAYMENT RECEIVED",1681156971,0,0ccec6e5216ca84cf40cf350f1eae022b6e40edbb0b8f81247ac49a6b4f8ea94,30262735732
20171218,"PAYMENT RECEIVED",1649889896,0,dea5d0ad535764530245c07d4aaae6d7976611c3ac31450e0977b6fa8ed9f19e,28581578761
20171218,"PAYMENT RECEIVED",1489811879,0,0fd7425c4e740a4e5bdf3b5e817cab664b996463c783b7d0a088c5d6307b2aeb,26931688865
20171218,"PAYMENT RECEIVED",1614212597,0,efe4d1676eb966332656c5d2337d5f0bde876f099539000f7e32f7da33ab1c57,25441876986
20171218,"PAYMENT RECEIVED",1508120935,0,612a7ba5a607de283ef9782e55721b5fb8b6c0d486d9dcd190954aefc3d65156,23827664389
20171218,"PAYMENT RECEIVED",1502418780,0,b86eecaf5de2a1be901908873b95c56a123873c3d43873f7f9419933837d16fb,22319543454
20171218,"PAYMENT RECEIVED",1500419158,0,a7570e2a458fba6ad675612d8bb45d41831373761b3ae77224938df16a7ccff5,20817124674
20171218,"PAYMENT SENT",0,-28906918496,beb2ca32511091adf9e161340d4bc7ec4656de61e83d0bbcd5d478361605a851,19316705516
20171217,"PAYMENT RECEIVED",1668563142,0,bde4f9420484c2220e5d183337d8c548516e16583fa248adb6aca97076853334,48223624012
20171217,"PAYMENT RECEIVED",1579862745,0,7cbb074f2a26010376fffffe9231ed6373512352c72000872bf87b76376b32d4,46555060870
20171217,"PAYMENT RECEIVED",1374987044,0,eb3a2fd776bb7157dc28c4cf4ca3c7d3d39c07c833742dee95569b06de31c845,44975198125
20171217,"PAYMENT RECEIVED",1527457159,0,c9f9d39041dba3a5e5e8544758148e6876edad00ddea2e1fd833cf34787b29e7,43600211081
20171217,"PAYMENT RECEIVED",1515342526,0,33c94333b6a2c6b48f2208134acec8adfbdaeb46b66b1aa07f5d67bfaa9b87b4,42072753922
20171217,"PAYMENT RECEIVED",1468042760,0,6c827a41de8c52fc524b54a19404508bec4239e3edf2a3c72cf3dae24723f980,40557411396
20171217,"PAYMENT RECEIVED",1365764737,0,70eca665fd92a931dd4ab13dacbc768e7d96ede6212fbe0a03f3e14f4472abf3,39089368636
20171217,"PAYMENT RECEIVED",1632134139,0,013e5b1acc78d8050deef766194b9b010c639ff21788834fd5adfc0a5784f338,37723603899
20171217,"PAYMENT RECEIVED",1659754358,0,8423dc19554c3f24d2db1ae663e30d6dbb23de883c442a46ef58dd3035f69542,36091469760
20171216,"PAYMENT RECEIVED",1679089012,0,f0fc000c47d4acd47da478989b7ec65522f954c07d3d94188c5e5b6d3199cae9,34431715402
20171216,"PAYMENT RECEIVED",1623981081,0,2b9d1471998c0d28ff9129a9c480aaa500f250facdeae97f340a1511be46e7b4,32752626390
20171216,"PAYMENT RECEIVED",1554286235,0,e3fe6f126c5034918428c7b5f5f662fd853a618be49049eea31e69702ad8c875,31128645309
20171216,"PAYMENT RECEIVED",1622888520,0,ceab179c737a08b9d732fc0551e01ea27cea679b0b84fc85fc36fb0600483689,29574359074
20171216,"PAYMENT RECEIVED",1568194164,0,14f108063b0c264b2be367a2925639c39a46499248f3333829cc974afd63d84c,27951470554
20171216,"PAYMENT RECEIVED",1561581633,0,04b27874c1dc37b12cea6a29cdecc653fbf64b2008132e825803642f91470947,26383276390
20171216,"PAYMENT RECEIVED",1424808305,0,4cf7b8b9ef3fb1330e4ac7a73d139052c78deee6c13ff01b3613924d82cf6e8d,24821694757
20171216,"PAYMENT SENT",0,-15992342428,492b8ec140f3c523e6eed753b2a9d44f9b6b098e8ee7e9f1883f49d34c5bec65,23396886452
20171216,"PAYMENT RECEIVED",1664995469,0,e8196f4b2f6cd76df196651210f80dc4fad821c341d47a3abca1b7a7cfa5ac61,39389228880
20171215,"PAYMENT RECEIVED",1446835096,0,07938f3f01bd3b04c6eaf44c2e1a43a7f75308d82f5e5728eb16320380ad8dfd,37724233411
20171215,"PAYMENT RECEIVED",1602980736,0,eb067e6914e8045f8c8a3ddfda43279ca77d89656260347fe25149ec74d7e9ea,36277398315
20171215,"PAYMENT RECEIVED",1679775593,0,1ad5755cb968cda69dd91d35434ec05292d35d8238ebba3ed9007aebd4db3b34,34674417579
20171215,"PAYMENT RECEIVED",1607977704,0,d3c8dbbf616c2a87846d84b42e73da8814c94ab2dfdca6515e77b2dacdec5880,32994641986
20171215,"PAYMENT RECEIVED",1610724085,0,ac56e71a5652a1a6ecb58c18cec8f58448267afe166c93a53eea8f5622ad75f9,31386664282
20171215,"PAYMENT RECEIVED",1646569091,0,fd5df9a4d574cbdbc194496cabe3936ba653f7257fcb67c1eaf48bf2d6261998,29775940197
20171215,"PAYMENT RECEIVED",1688879011,0,e746a93caae8ae501ce15228f5bf4a91a88c3aa5cead75ce06b2d1f18813b5c2,28129371106
20171214,"PAYMENT SENT",0,-24054968325,21fe9f5965b0375ac7fa18b461a69fe77e437a1d5d8d1522e32348db3869d5d6,26440492095
20171214,"PAYMENT RECEIVED",1647962582,0,b83b0ceb852945537aa2695e2cd15d07407aee3ad3b04c6868f8d91e332dd0a5,50495460420
20171214,"PAYMENT RECEIVED",1617108133,0,a43630685d6b3c69b2e0cecbf953061b81f78f0d2c74c46d9aa80c5a1c2fa828,48847497838
20171214,"PAYMENT RECEIVED",1648575204,0,ec39f8b5fe25bca0ca304aec6c2d89d88e343b927b8422edd303d44d91843787,47230389705
20171214,"PAYMENT RECEIVED",1647072630,0,22a7b79ef37d7b9fb1ad0609edf65cae1415ec39705e7f88ef272bd55d55fa01,45581814501
20171214,"PAYMENT RECEIVED",1481544352,0,d129f174f408a9954a1c5c1d2346b51b9bb2f8912713673795c896cdddda46b1,43934741871
20171214,"PAYMENT RECEIVED",1500627250,0,e25c9f6465509fe4cf1d676b9b0118c67ddbcbefa7ef449968396646b1efcbe4,42453197519
20171214,"PAYMENT RECEIVED",1570891900,0,c186554cb2734beeb0e188e0fdf84b07c83c25c19834e5f195e137e7e67b4628,40952570269
20171214,"PAYMENT RECEIVED",1561437814,0,c71fd78fb9818cebfeab3d67e3de06adb492dd4ecd69a56cd7afe03486f1240b,39381678369
20171213,"PAYMENT RECEIVED",1636754183,0,b6f2d22c8262887fa2a796a41c9754bd74667ddd47c1bcfccdb1967032efa736,37820240555
20171213,"PAYMENT RECEIVED",1663165800,0,6f218a773aff82c1cbf45accbc8caeb03ec4793aab0645f1f81bef6bfa9cc9e3,36183486372
20171213,"PAYMENT RECEIVED",1649742379,0,363eb5ddb4162b176bef22f189cad874aecdc62af60e88500ba2c71860e9043d,34520320572
20171213,"PAYMENT RECEIVED",1566345774,0,ec79e7ae5b5b211c02ca33adc5bc75670e05505e96f5ea96ed2a32d4a32cd974,32870578193
20171213,"PAYMENT RECEIVED",1674951617,0,9e234574689654c1c902ebb6ef58cc30d91c7a4269d60d2eee790ef7dab308f3,31304232419
20171213,"PAYMENT SENT",0,-14983421180,99c1a8f5602077494bc2ad89f1ed5262d7d8cf5c1258fc3c0f1324a50ae95c4f,29629280802
20171212,"PAYMENT RECEIVED",1687408372,0,4b4802cff46d14e3cc8dc54025b6b4ae1f26f7d38953b6fab81920ca1bdbceae,44612701982
20171212,"PAYMENT RECEIVED",1490039572,0,65550808a528faf514d8cb657d49fdda5600e51a0f61893741b7a233c040316c,42925293610
20171212,"PAYMENT RECEIVED",1540408249,0,1414e9055b74069f0ea740a2cf826b94bffb0abb61d4369fec91c5b36c53551d,41435254038
20171212,"PAYMENT RECEIVED",1676138252,0,28d4b4a0146328219096d1aef257bc27a6aba80556188f02999b31df267dc442,39894845789
20171212,"PAYMENT RECEIVED",1656619513,0,70b0f719ae98db666200a00ed4de626b0f28e9ed42b08bbab0b54ccf7f106062,38218707537
20171212,"PAYMENT RECEIVED",1580644010,0,8ff62a24964d50bbf80029115ff1857e49db5bc44cdfd81702586665d1501c03,36562088024
20171212,"PAYMENT RECEIVED",1556714176,0,cb01a3e76fd18ed2a52566b7f1e3512b171d3eb66102fea5bd90f66f9b644cc0,34981444014
20171212,"PAYMENT RECEIVED",1629835132,0,cfc864295c669f008c6fc7e768d7592fb77a76db7d9612273379e085c6084bd1,33424729838
20171212,"PAYMENT RECEIVED",1628232399,0,6357e97f43c43f5d90231ab3cbf9dcb71322386e18ea6b4416118cafac37b750,31794894706
20171212,"PAYMENT RECEIVED",1660642858,0,9e7e35b58dd9dcf1eb8998d0d3e76ba896041418fd52b3f99cce567f916ae975,30166662307
20171212,"PAYMENT RECEIVED",1639010527,0,3043d2263eded6f8dc07e6d5dc129e419391a2876b0e75705d27c957cdb801b4,28506019449
20171212,"PAYMENT RECEIVED",1631540301,0,d152283e38f1b6945d458631b8c2176bbe97870c25930986b13d6eb729bf3a29,26867008922
20171212,"PAYMENT RECEIVED",1448243024,0,c43beca1e2a30bd94875a620b197181b5856d0aa3caf2658f8a778c67a796e32,25235468621
20171212,"PAYMENT RECEIVED",1622638027,0,fb71e6aef4ef9b446fcfd6a0a61815e955de199399cb2ce23faa6307de6cd4c3,23787225597
20171211,"PAYMENT RECEIVED",1687866987,0,04a96c1e61a20efb3245b1d369870af4dd7a56e22129f52a24c2241a4cd542ca,22164587570
20171211,"PAYMENT RECEIVED",1569485379,0,5232862b4b7b2ed8acff5e2ea20620b699f21f2dc9a47547f888ad4649fb1d10,20476720583
20171211,"PAYMENT RECEIVED",1640002807,0,e8692635c8b9cbb52e643a6d76832c445b4fd571a590d64485448fe673f73b10,18907235204
20171211,"PAYMENT RECEIVED",1390139626,0,d5c9923149bdd9f755b1d1402e1c34629bb518dc9c1a791fd4bfddf8e0069e75,17267232397
20171211,"PAYMENT RECEIVED",1559930389,0,244b9dc878f54442255f8c023812cb8e9bd6de47f08f789f94eec73faef74546,15877092771
20171211,"PAYMENT SENT",0,-34560884691,8d2c8412a72d15cade49892072bfda866b6d0188783bf0eadf2e5a7cb48d4e0c,14317162382
20171210,"PAYMENT RECEIVED",1668848724,0,ccae71e516853651182fcfdd4b54cdd0745a83bc8256205f621749ee63acc7ea,48878047073
20171210,"PAYMENT RECEIVED",1525072053,0,633fb26d228ae238c19f3d4891806177c612edd040da449db694b6d446f33653,47209198349
20171210,"PAYMENT RECEIVED",1505763132,0,aadd372245ea95b85dd0e0ca7ff3ccd90bbb7b93c139b5658b9f4bceb6a1426a,45684126296
20171210,"PAYMENT RECEIVED",1368708618,0,8f4076c2f9be75c961123641a0f5b0b6507df6a11cf03db6aabd83760bef3ea0,44178363164
20171210,"PAYMENT RECEIVED",1572678433,0,562383cddcabf051fec2470ad11620560f36b19ff480549a5a41411d27db05fe,42809654546
20171210,"PAYMENT RECEIVED",1517435455,0,0e1149585b433beca6f2b60d2bf0a6b6d74ce3938cac339e5b53140d958e75ba,41236976113
20171210,"PAYMENT RECEIVED",1362628460,0,639bab2991bc0c22ca0b8af0d6bdd757ae804ecf8465cafb5a7f3d173fa1a387,39719540658
20171210,"PAYMENT RECEIVED",1418700799,0,a3c030f42a8640b179aa4575a5419753e7f98e293469fdff158a321a0ebf63dd,38356912198
20171210,"PAYMENT RECEIVED",1518536875,0,325b3aa86f81e6066d9c1a9409c9c7007ebb7afffee64bbb36f7de6b5f83e9da,36938211399
20171209,"PAYMENT RECEIVED",1409569771,0,75e839dc7c8146210a1448543cff09cb4231a19ce9c7abdeb3af71e6306300f1,35419674524
20171209,"PAYMENT RECEIVED",1663301123,0,b6c35def33aff4ce8a354fad8e718eae44198837ea00f5ed8f8278cda4f6f49a,34010104753
20171209,"PAYMENT RECEIVED",1697844963,0,c405551ec479f0444c56eec18dd515c0b5abdc5905b74956fdfae2e3b559ec96,32346803630
20171209,"PAYMENT RECEIVED",1701800979,0,7473e2dfd882a767b28fcc32a436dfd7f6dbfad95eadbc327be951099fa879c8,30648958667
20171209,"PAYMENT RECEIVED",1727497916,0,7004f7445b1dac304ebe043ea7e37b5365b5d43d1d5146b06a3580dd4b97001e,28947157688
20171209,"PAYMENT SENT",0,-30871404767,624609b92e2e42127d0bd4d084ce4fc2e8c657c5e543973f76017ae54bcf0b9e,27219659772
20171208,"PAYMENT RECEIVED",1680685634,0,bdb4f044c8d21804b4c95d481e3f679ea10cf07981b5d03d018e38302d2c089a,58091064539
20171208,"PAYMENT RECEIVED",1639599022,0,24f01ccefd0d2e12feafcea4e9f25a844dca8ef337daa19e518dfb2cb0cbeb9c,56410378905
20171208,"PAYMENT RECEIVED",1649146213,0,ac157cb49a5caa16914a69266c2a7b052fbccdc027a47ae6ecb73017eec6214c,54770779883
20171208,"PAYMENT RECEIVED",1700259685,0,38880ad20def80814c4df1bfa74ffd44c3bc3d241885a7ceac0eb4d01e1eb1e4,53121633670
20171208,"PAYMENT RECEIVED",1650938894,0,0ef990219cd5efdb49a4fbce7bf488809c085594a02db09086d88d2e37face1e,51421373985
20171208,"PAYMENT SENT",0,-15512103230,741f82e292ea0fff4c5ca197a1ea45be6acb4d6de2db992ce060fefade4b4402,49770435091
20171208,"PAYMENT RECEIVED",1643695733,0,9a10db7df3c97a24e1b3801b366791f2144892f678ed880ba9ec0395e59cacb9,65282538321
20171208,"PAYMENT RECEIVED",1848201816,0,fa157aef5d0c5f45b7ec179966efddb31591071440038ae0be673b6495f84cff,63638842588
20171208,"PAYMENT RECEIVED",1610095746,0,02f72532a7833411ca266f2fc329020475d8c28cf977315b088fbd7287fe63b6,61790640772
20171208,"PAYMENT RECEIVED",1250000000,0,72248a81a81eb13e90ee47fe0aec9448331563961dc7112c4f0fa0a1c0f29853,60180545026
20171207,"PAYMENT RECEIVED",1656136604,0,2aa87427a8881c65b2f90193219d3c39127742417e0b6251373cafb6b10743b9,58930545026
20171207,"PAYMENT RECEIVED",1557881775,0,4a1ab649262a999535016a6fd905a71926ccbb562b33819f55d98fdec9c7be21,57274408422
20171207,"PAYMENT RECEIVED",1445739094,0,80b7b07b8214c9cfe0585f0234e3da8fad1645940a14cf6b9eabfcf1a4f07a23,55716526647
20171207,"PAYMENT RECEIVED",1419385606,0,05fbe8b70c177ebeaa1985ea996c927c4302973136b43d0f392ca229ba3c59d6,54270787553
20171207,"PAYMENT RECEIVED",1401074126,0,fdbc69dc3ecd96008e037ddbe000655edf427f273889fa7e3dda04ea0f761c6d,52851401947
20171207,"PAYMENT RECEIVED",1425483277,0,0772185d209a016db0411396cbc98dcebf3e28ebf0ae2d08beec14ec2950658e,51450327821
20171207,"PAYMENT RECEIVED",1411485565,0,704d2c436ef02d95cbe2421a788c329ad4352462c7c2784f864d5ba13e4077e1,50024844544
20171207,"PAYMENT RECEIVED",1392323546,0,b4b29293c9762005492d439dc643d5ee9c2701f289cae7467cb9d15166478b35,48613358979
20171207,"PAYMENT RECEIVED",1400250501,0,76f79705f18c592fafe98a6a627e625f10186fd6635726725d9395dd8821cdf9,47221035433
20171206,"PAYMENT RECEIVED",1415622384,0,c60703b8759b06e00da75c314e04ee0573e4b733703b84cf9da397fa56130b32,45820784932
20171206,"PAYMENT SENT",0,-13820978325,617739816df5ea9ec0e022997f9fe654c80b5ba27e88bc3cc30e9be7019b50a6,44405162548
20171206,"PAYMENT RECEIVED",1419388532,0,c317e53437fe3bae5e619596655cd49c455ad76fcce742adcab5211b7c9bf75a,58226140873
20171206,"PAYMENT RECEIVED",1326463823,0,15ddc2842c338e9920b295b5846f19b3c69c94ca7d10c8b1f868e7602ec5a4c0,56806752341
20171206,"PAYMENT RECEIVED",1327831909,0,bc6898fc52955e50cf01c5f5e426e7072e63e1b97525e43c89eb2a00ce30ddac,55480288518
20171206,"PAYMENT RECEIVED",1314525706,0,4df4163fb8f101202fd805933423d4942f40ead8060ca6758b9c76e4b3f5d178,54152456609
20171206,"PAYMENT RECEIVED",1358740801,0,15d413472494ab6fbe61a429c84a683acac192a29186e7ba0d9b8d150ce9992b,52837930903
20171206,"PAYMENT RECEIVED",1420427386,0,7a9bcd551b4d9195d3de34e8f613d250157d88f82638187fab8b33e8f6817be9,51479190102
20171206,"PAYMENT RECEIVED",1381103080,0,830908a5d168ca0b5ad6cbca110857fd71687299eaca7360253ee5e1928ee24f,50058762716
20171206,"PAYMENT RECEIVED",1250000000,0,08c0e728ba59b78736b796cf966b7d8ae9b6342f861f5e2dddfd8696261e56d4,48677659636
20171205,"PAYMENT RECEIVED",1389521527,0,532f89623052a58591ee87f656311bed667b222223556150c604db5bc39043e3,47427659636
20171205,"PAYMENT RECEIVED",1406977335,0,a5def8b3847f47a1c2bbcf99dcf6a309f23b8f69711e2d0769999d5c4b69495a,46038138109
20171205,"PAYMENT RECEIVED",1315267491,0,87eb43d7690cf3915ccd98a1f4d855bd06cf7c966f2921a1d5271ffe858b96e3,44631160774
20171205,"PAYMENT RECEIVED",1418106989,0,5441f6f31864324933d4017c732bab39b1a1e6107a1ec274911526a882d2360e,43315893283
20171205,"PAYMENT RECEIVED",1364480599,0,01272c7c12d0d804beeb94f28146b735e82296ec59a6b0ba3585016b30b57595,41897786294
20171205,"PAYMENT RECEIVED",1250000000,0,24f3c562c907a5e819949830eeb06efa9e3b6af9a8ba28edcfa0072d1db6c6d1,40533305695
20171205,"PAYMENT RECEIVED",1361259792,0,c4964739bc34b9802e248f7350e63fda2304c0b5bbf6828f5ec7f5c3f52e8929,39283305695
20171205,"PAYMENT RECEIVED",1283946796,0,2cf3d4426b30e50a065a14ac095143cd86a6b488049583701c5eff4410eef6fe,37922045903
20171205,"PAYMENT RECEIVED",1411764265,0,7c65a15611dfa48801b03e3ee7c806c3a31907b30aab7930078c5de62979eaff,36638099107
20171205,"PAYMENT RECEIVED",1308955817,0,132083c17e19b1427a6217ac72b5bd8283e9a8168276fa749e88311d5a39d032,35226334842
20171204,"PAYMENT RECEIVED",1355322448,0,8f8d7412c57abde70f993d6f2a9703b223d9b308a33dda6c076067242df76498,33917379025
20171204,"PAYMENT RECEIVED",1314625290,0,82a8080cb70d2ce630a5791781eea23df498524eb3d4b644c5a964cc9f069695,32562056577
20171204,"PAYMENT RECEIVED",1417242067,0,45d5c037376addc3d95960c5a24adbf642a53fdf7fc1c09d86af8d5384e29c6b,31247431287
20171204,"PAYMENT RECEIVED",1347350911,0,7c33d194bbce7da4ddcdfd80ca993d321882ff1eb8a121168df7943f59bf81b2,29830189220
20171204,"PAYMENT RECEIVED",1449018645,0,c5695be757e6eda66bf69a2d94253c45bbb8d1b3f704a32b84e2c23f87104f36,28482838309
20171204,"PAYMENT RECEIVED",1416891112,0,619fb7b902140c0a5197c89c19d9baf97f5eb4516bc9042a1a40b7573f1412e6,27033819664
20171204,"PAYMENT RECEIVED",1296870629,0,37fb66e44d84d448f4fd116c3a2ab4b540be547034434d99cd349c17f4ba91dd,25616928552
20171204,"PAYMENT RECEIVED",1339746500,0,a3388467da7a4f7bea8d01fe27358b2838569114ccb947ac0f19d6d24d140208,24320057923
20171204,"PAYMENT RECEIVED",1347145799,0,1709eda1414a9e04251d6d9dccf98f9f11881c4eed960b128cdcc64fe870a805,22980311423
20171203,"PAYMENT RECEIVED",1369985952,0,493b6248ed145e81ec68177ef2afdbe0b387494c5a6869bdf64ee810985eafde,21633165624
20171203,"PAYMENT RECEIVED",1559467415,0,163329f7802751a91410366da43eec7109f56b8e1dae742e7f1621b89c9e95a7,20263179672
20171203,"PAYMENT RECEIVED",1383206609,0,0f13dd9610d3b2b948294f6de3439bab784893256872d88b7e86e5cfdf7cfd88,18703712257
20171203,"PAYMENT RECEIVED",1284977059,0,3f6f264dd18cb64aca7f62aa194ea3c768bd2d84f870f537ee03abf2d2ccfc43,17320505648
20171203,"PAYMENT SENT",0,-19214539192,d3807634bfb2cb7d4dd1081dbae0e1c0e8008a1a6f9a0f37ba110d43ae522ef7,16035528589
20171203,"PAYMENT RECEIVED",1277336616,0,c9071be15de815053c0e12fcf6337c14a84bafc7d8b08db73f0908e72b068988,35250067781
20171203,"PAYMENT RECEIVED",1403907490,0,37557ac4b4c4715b7c9ac1fbc05120b7e8f138e695118153d9e19020ff85f4b8,33972731165
20171203,"PAYMENT RECEIVED",1374169821,0,2a2f49e7c02f9dc94a362a3605d8f8c3ae7de7b75862e375e38d1f9a73a43a21,32568823675
20171203,"PAYMENT RECEIVED",1398536625,0,b5b6fec1b923b397f392eb6251b5f7cb938de782a37e6a25606c767ca9e394ec,31194653854
20171203,"PAYMENT RECEIVED",1265076801,0,f32c3c6a7ae05d6ca22265a3662c7f52c56667219e510200e2cdba9098f643db,29796117229
20171202,"PAYMENT RECEIVED",1276268312,0,4b548f6ef825775217bc4d224aff9d9645273719642e941b8aa75f5412fd68ea,28531040428
20171202,"PAYMENT RECEIVED",1368668461,0,372dcd3fbb40dc9362a4a56dcf2fe64d902447022044f9b1da6537e69c6864c9,27254772116
20171202,"PAYMENT RECEIVED",1459239670,0,b61265a3f6a88b587a61f0e27f7305a9eb5d37fc8e7c036136f184eccfc718a9,25886103655
20171202,"PAYMENT RECEIVED",1347409142,0,df221f37ec7ee926dc2424b7138722ef63380b01388a58b0b7e271f7af1ec67c,24426863985
20171202,"PAYMENT RECEIVED",1313155512,0,75f02704853f2d1440e5244a37845e58573712c7fe605f68b3f0e8559676643c,23079454843
20171202,"PAYMENT RECEIVED",1310042582,0,ab3d1b32d2ad02b9379e48c54c0929c9d31bd8b38c12955308633b897563a10d,21766299331
20171202,"PAYMENT RECEIVED",1342414945,0,6e63eee6b8eb211b40a8deb72137c04179af03fdb0740d43df7322c833741b02,20456256749
20171202,"PAYMENT RECEIVED",1365751286,0,51b7b2d0f5533876b17bad65bcb89fd8b5dddfd0d2a8bbd799d1739380a089bc,19113841804
20171202,"PAYMENT RECEIVED",1388452003,0,1a9d6fbd8bf5844866c44667a5e4a2d628f77043075f5338537be12361082210,17748090518
20171201,"PAYMENT RECEIVED",1329218821,0,eb1b06ec6f83f18116760949d2f0ed23105800b89c3e39fb8c5507d17d5f34f3,16359638515
20171201,"PAYMENT RECEIVED",1377861029,0,b1eec9fbcff50db417333010e369939318755ef2650cc98107953aebf4174a91,15030419694
20171201,"PAYMENT RECEIVED",1452086392,0,20a0fec928e908164ae8b7e3972de7e827dc94518696a612cd0736888b3c2e07,13652558665
20171201,"PAYMENT SENT",0,-12608861796,37ae9815a379c29c010f60cf9b99880b1c2fef70e610cd634367f4f966cf0f63,12200472273
20171201,"PAYMENT RECEIVED",1381795178,0,eda5b000141f524bd296e4ca87f23f8b2846538f92e5b703eda61a5002f43072,24809334069
20171201,"PAYMENT RECEIVED",1418818587,0,560406bcc2fe11aceb377863359b7275abe69f1ca6ed160b1c0be2cc533146f9,23427538891
20171201,"PAYMENT RECEIVED",1392999162,0,cc0d452418059e47f685dbb28cd75cac1ddf67e92008c8baa68dacb583d6a28b,22008720304
20171130,"PAYMENT RECEIVED",1444385011,0,4dfc4f5130779e936e42a57f78ccd53a07acf97298de436669bc0f518e8d7cd6,20615721142
20171130,"PAYMENT RECEIVED",1354887512,0,e71b906493120572bc7135a313acecf711c86c672caa51abb84fa0ab95e42f8e,19171336131
20171130,"PAYMENT RECEIVED",1418502733,0,4ebe1dc7c56d989f0a692be76f00c03f509e3bdfb391f999edfa44275ed06d1d,17816448619
20171130,"PAYMENT SENT",0,-11229962990,441346eaaf2e1322714ce8d92ecdac6bef14bbe3fab19a11faccde40064725f8,16397945886
20171129,"PAYMENT RECEIVED",1455791712,0,32d9128529f9387b6b5bf310313bec8569ca32a0308d2205dc56ec6299aba660,27627908876
20171129,"PAYMENT RECEIVED",1422664865,0,4b23cab0f86361859a8fa03c822e6dda4008efabdecaf057baa546378d2a9dc1,26172117164
20171129,"PAYMENT RECEIVED",1440095442,0,b54ca27b898b61eb47d5a44d577da9db457fc38675cf574e5d6f5b89a1460ce2,24749452299
20171129,"PAYMENT RECEIVED",1452399054,0,19f5bc241d9efbf1f770d0109ac695a3cf94179a8811af1722301d743d71b728,23309356857
20171128,"PAYMENT RECEIVED",1409729437,0,56c5e5bb75b53167c870a21fbf5e3a062c7d4e1e3d2c17f53b0848c56988cef9,21856957803
20171127,"PAYMENT RECEIVED",1392607637,0,10c0a75352ab67883ecca6bcf82e8d2f1c27e4d89a09db2cf94350952f5e0678,20447228366
20171127,"PAYMENT RECEIVED",1431120477,0,a2a7d04ede5de7c3448d8a278bd0902e9eb6f78072ef2bbb5ea48f85524dbd76,19054620729
20171127,"PAYMENT RECEIVED",1393384815,0,cc8f61387ea95327c3f0c414ed832ca2a2b9eb05a74f50d3eefaf13379e2a849,17623500252
20171127,"PAYMENT RECEIVED",1437767774,0,3612b1b31d4e046b3232223a09700f2d4bb46e90478e646fed1ea250b774deb7,16230115437
20171127,"PAYMENT RECEIVED",1266117304,0,ae918e89a16447eab2f6c7c7d1b108f176e7d8006418a7fc49e17f6cefb35e7f,14792347663
20171127,"PAYMENT RECEIVED",1316611429,0,6d245f5e31e118f524ca00a69687d35781324d5a573af7b7d5e416d89bdbdf79,13526230359
20171127,"PAYMENT RECEIVED",1343477425,0,ca478e462333e70e0e3711389d3dde8af53d1bf29b568aa3dca01c94f4c71dfe,12209618930
20171127,"PAYMENT SENT",0,-11233282978,f33f3fc22ef9699bca394023dbb6ee3efda6a6b20815751ecf6c1b54e2e6374c,10866141505
20171127,"PAYMENT RECEIVED",1420527791,0,bea23615792f3c9f7ef8e4be3d0f173a4c0e5059531029ab209230167fe012c3,22099424483
20171126,"PAYMENT RECEIVED",1373836719,0,84470dceef86acc90b8b692d2f5db4645a0aac1c1c79925e43c159511cb7cb8e,20678896692
20171126,"PAYMENT RECEIVED",1395780242,0,631e2164545cc484e7171514166edf0429164464f57f9079de238b116d67c1ec,19305059973
20171126,"PAYMENT RECEIVED",1340653139,0,20517efa84a6a63583dcb6a0017b22b78c79a3731878cea30b9979b51ee7e81d,17909279731
20171125,"PAYMENT RECEIVED",1308536016,0,0bc4ddcedabb84f4a7e5e1bddb9b329d0729b505217e5af31263bc87fdb89a8e,16568626592
20171125,"PAYMENT RECEIVED",1446699481,0,b6bdb2c9d42bad1925368ff4d8d68502f00d3e76b4862ead6977d9689c2362a4,15260090576
20171125,"PAYMENT RECEIVED",1362803757,0,d27c3f8ce331e910024a6019cb58c176e0b29dd99a82607007a894a0110f6bb1,13813391095
20171125,"PAYMENT RECEIVED",1404001779,0,122cce6e90026f2f982476b40126531c45b11d82f001b85f9340fff221e42d2d,12450587338
20171125,"PAYMENT RECEIVED",1389205929,0,fc6fe1fd70c0bee91811bb30da86fbeb87797c921f9e2402ae144f508cb5b0e0,11046585559
20171125,"PAYMENT SENT",0,-8316178174,fe7d0cd7a843d0654a6be1fc7a16b3b661c60bf3dd7725e460868eeb7cba60b6,9657379630
20171123,"PAYMENT RECEIVED",1500775119,0,919739666ae0b9d5477eab520ed6e7f8daafeb87a27507e7c80f84a8e0bfe6d5,17973557804
20171123,"PAYMENT RECEIVED",1420422589,0,8d4235989c9ba063e731cd4646a9b139bd468dcb55b18012f9119e4d92890734,16472782685
20171123,"PAYMENT RECEIVED",1250000000,0,d3cd7167daf3edf99075217d6c004a08ff04079417f239c9d4e7468e8ee4c979,15052360096
20171122,"PAYMENT SENT",0,-9627764125,4d9132f6768fce8ca8cc13dc3d3f6eac46bb1d90fca5cbc583019fc94bd6270e,13802360096
20171122,"PAYMENT RECEIVED",1377300926,0,210197ca6720a2b1b9f929cb187fc9eba9069d310b5feaae630de91ab8b9484a,23430124221
20171122,"PAYMENT RECEIVED",1481422716,0,dca398ea28166e134112c09981a54c3b0be994f5c77a8ee37253885a692e5a57,22052823295
20171122,"PAYMENT RECEIVED",1288532075,0,cc6389f721b09527fb67bcaf68620a0c46ad8ef9223ec09d506fd3a07e91fb03,20571400579
20171122,"PAYMENT RECEIVED",1375471766,0,7d2d7017e8893d5b4ee67c96a83b940dd6fb76d2f3de25d8d0d0797e8b0026cf,19282868504
20171122,"PAYMENT RECEIVED",1325542659,0,974d183b250810aaf56e544c51108fe08d4d1a33462fd0ffe885ee1219112abd,17907396738
20171121,"PAYMENT RECEIVED",1377516315,0,f113349ba00a0a6b257f720ed1ba30f6cc7d9af1ec678edfac1f26bd68cf7d7d,16581854079
20171121,"PAYMENT RECEIVED",1445146583,0,4457f9194b368cc95e315a26e50ee5857262fd93fcc4e5fad6114b4c0106f40f,15204337764
20171120,"PAYMENT RECEIVED",1411331087,0,bd4aa26f6df02b52e0629800eb3461437f7499870cc69900d8097e3166e69ed9,13759191181
20171120,"PAYMENT RECEIVED",1273581062,0,3bad82d927f7b5e64d04c048dde49388b5a03ea62693cd6be732f700dae23e03,12347860094
20171120,"PAYMENT RECEIVED",1289766705,0,4f7646e1cfa1103aec7af6fe42a09c26442907257328f5aa7e841b2c347a64ba,11074279032
20171120,"PAYMENT SENT",0,-13213218417,db71e4833139c2a53a89d2056c5d68ea3d11f49284324e3d4292db3fdf330380,9784512327
20171120,"PAYMENT RECEIVED",1545295411,0,234624f2572694d4cdd30ca76ddc580365c7659ca32af46cbe19015cf6b8ec5e,22997730744
20171120,"PAYMENT RECEIVED",1468670975,0,6eb933478a02cceaa27d1aeb26336f5ca94210ac581f2e0dc0474d19c87126dc,21452435333
20171119,"PAYMENT RECEIVED",1309987095,0,9b2d4be75e25bb5e9bd06a5bdacfe7fc9232bb82133aa21bd44f969df43d8281,19983764358
20171119,"PAYMENT RECEIVED",1323697868,0,2cc7a2f6e7f013ab380db3b6387deb2ddaa962060ca5e12653e2974dd4c61b88,18673777263
20171119,"PAYMENT RECEIVED",1472455001,0,4e27bdec4c5f244fc5e73aab170165c3040354172b88bbe6e427e049c9437744,17350079395
20171119,"PAYMENT RECEIVED",1372989376,0,fb6b642bdf213228ebad6665549ebbb2246448e4c523da7186c4e53d3ac31f84,15877624394
20171119,"PAYMENT RECEIVED",1335526657,0,5ab3b445966e57dc10d277696e3a1ceb095d30a8d1fc28ef700bab6682c24546,14504635018
20171119,"PAYMENT RECEIVED",1357110951,0,e82df1794399aebd6390b8c9cddc5d75809afe027012216f97edd71f7f1e8ebf,13169108361
20171119,"PAYMENT RECEIVED",1291416601,0,941f24213f8fc080392d5e177066b2557042db2e9cb55109b8cf648bd82689b5,11811997410
20171119,"PAYMENT RECEIVED",1264274290,0,e2127719c98736c38c38d49e9b7448dc1ef6544ce9ba40089414be143327bf05,10520580809
20171118,"PAYMENT RECEIVED",1454699200,0,e87a97cd9499b53eeab50424a8540b4f082330730b692c6a2aaa959821dbee4c,9256306519
20171118,"PAYMENT SENT",0,-5118363255,20c9039c80226f99fc3d76441b9f9570b9d99bc9b975852276e76a30075076cf,7801607319
20171117,"PAYMENT RECEIVED",1306763701,0,8d4edee624456751ca5cdd4d5e529aff18a9ba628955c7130fdfe344da0cde2c,12919970574
20171117,"PAYMENT RECEIVED",1632830890,0,f398e9020ed8793dd880d7506b2589e452bd3ae512d5348022e11ce766eb2c33,11613206873
20171115,"PAYMENT RECEIVED",1466629539,0,30ac2fc77d343c1b5b053487f55b386c4078604e0c64d63cc2b6202d663e357d,9980375983
20171115,"PAYMENT RECEIVED",1762408448,0,06661e5ec4577d5a02846af0541a800f44fafd889938d267024916cfaaeacf8d,8513746444
20171114,"PAYMENT RECEIVED",1659212060,0,4f195bc0a6a7320ebd5a532309a1de4812ed412a5448b5bd24c2ee1b4e5ffd3e,6751337996
20171113,"PAYMENT SENT",0,-4936476255,cf53da17f18c92a51b2f17e763b9b7a0d2886b5f074efc464a6be176cbc924f8,5092125936
20171113,"PAYMENT RECEIVED",1736171129,0,9efc6a99f34a369e6ca80b04635dc7b3fa51550d362e64feba4ec4bfe6f5972a,10028602191
20171113,"PAYMENT RECEIVED",1979489317,0,8f3a948ff373f6aeac41b26bbff8fc9111ab631ac91807602095cdceaa21e955,8292431062
20171112,"PAYMENT RECEIVED",1816876699,0,1984f90271676d2924d59b92c33a188276c80ef0bca2b47829c8f5eb90557b67,6312941745
20171112,"PAYMENT SENT",0,-4151174473,2aef5adb2905433cca3df302ce23e244016dfef4c67901e10be885afa00810a2,4496065046
20171110,"PAYMENT RECEIVED",1613380046,0,9f9af8ac007ec5c4c9b7b4ea08b72d60d4282a6733f0facef12fa545566d46e1,8647239519
20171109,"PAYMENT RECEIVED",1532907433,0,78cd06bea35dfeeaeded395d39a1df8e1aeb8c0ab299f3699543e9fd461efdb0,7033859473
20171109,"PAYMENT RECEIVED",1376465490,0,e7a98bf401a39e51d6f1dd2cd3af3fce8aa2f4924b660bcd1825eb0ed901ab0c,5500952040
20171109,"PAYMENT RECEIVED",1275244778,0,846d59a23dc90a03fb493e28970ef7f55164f562401e9a0744f893d39cc03e03,4124486550
20171109,"PAYMENT SENT",0,-5910551306,dbb130960b0a56e6264366478f0d64d2cd17249bfc255cb4b04ff406b035d1d1,2849241772
20171108,"PAYMENT RECEIVED",1506219510,0,96404b036f1835b0afa1194ed095b4a257ac432225bc146603bb13c41514c67f,8759793078
20171105,"PAYMENT RECEIVED",1343022262,0,0f6a9b37dddbe048d030e136ac758a23609df0889cf612d302e100fea712750f,7253573568
20171105,"PAYMENT RECEIVED",1534194056,0,08bd1eaa06ee08c31b36fb27f04a063b4f1244e0be255e6a6d1335f988dc073e,5910551306
20171105,"PAYMENT RECEIVED",1481689556,0,7c7f19998700c10e5835b7017036ee796897de04c7389e7101ee08591961907e,4376357250
20171105,"PAYMENT SENT",0,-4354463125,8c26db1ce436cd25e43cce6bd9ab1502f8d1082b1da3f77307f2a9c3e55427d0,2894667694
20171104,"PAYMENT SENT",0,-1304882211,44760f9b88d3676a280b519d783f9fdbc524e8a25f3c50afe66d71f1c3b75966,7249130819
20171104,"PAYMENT SENT",0,-7352514190,16057ae94e711bd4749a8dd6f21e75049dcaf9c8b3fa3f9a5c8caa4cc9cf3a6e,8554013030
20171104,"PAYMENT RECEIVED",1500582759,0,19acc0890997712d2e3347ca35c12a45565919a80bcd5ee2a9e279c9ff74c31d,15906527220
20171103,"PAYMENT RECEIVED",1467828629,0,2689d04e2b4eb84003e486975edb69893f930204108204410d1655bd3f7a11f1,14405944461
20171102,"PAYMENT RECEIVED",1356413682,0,bbb345c8acb46266725bba93e0d14f3db6d8a9a241cb3fdf39858d4f6f33a0bf,12938115832
20171102,"PAYMENT RECEIVED",1426839065,0,b35a3ca8ee8158d4605a96a9840de6e8c2abcf8442545ccb7eab7753e83c6691,11581702150
20171101,"PAYMENT RECEIVED",1304882211,0,968e4d9ad203cc39c0fb608678af44a4c4006a3e69557aa51fd14038ac4912da,10154863085
20171101,"PAYMENT RECEIVED",1512665661,0,d2aa048b8f743d4064ccf6338ea17aceb04094ef6e799a45f697d789d16e3d1e,8849980874
20171101,"PAYMENT RECEIVED",1453525657,0,800a8dbbb496ab4851125dbe3ab9d4543e65fbb7b2456c5fa20664e0ea901a43,7337315213
20171101,"PAYMENT RECEIVED",1491932269,0,273b99650491b7dca5f040742487b7c8617a0d68689710ee0ebc32853ad444b2,5883789556
20171030,"PAYMENT RECEIVED",1441554210,0,78a0085fe6d700752a5a278b0dfc3b30f38dedbbfb93d62ce6d5f12388c443f4,4391857287
20171030,"PAYMENT RECEIVED",1452836393,0,9244c28dc2955d9482359fe68de498c4b33fa6c48bcc9afd7c0a82f558ba64f1,2950303077
20171030,"PAYMENT SENT",0,-2697037136,44d1be82798ebfdb286b507703246f899d920e7c787f01dd181303636952ca8d,1497466684
20171029,"PAYMENT RECEIVED",1497466684,0,ef1fbb54a83704f1d2674eb2df91e49a81f9138d046807a87afa5ce16874478e,4194503820
20171029,"PAYMENT RECEIVED",1419704222,0,aaeca3e326168133f946f528672187b47761eb6681e8e845cd24d33f197e77fa,2697037136
20171029,"PAYMENT SENT",0,-1407195346,76184918a2a05590018a237991b68d8849f5a6bee2cfe28d2f3d83cb7456618c,1277332914
20171027,"PAYMENT RECEIVED",1407195346,0,041c2334ca4e3d19f24cd955c93a5b8017740149a0e1f4825880b3617c36bc8d,2684528260
20171026,"PAYMENT RECEIVED",1277332914,0,96fc8ee2a5387e5929004fc8dc03067a081ca1550998643da6b44887a275b049,1277332914
20171026,"PAYMENT SENT",0,-6785713862,37fd79f6a94ca4362239ac594493c03057770a8352a3252887876ee6fa84e244,0
20171024,"PAYMENT RECEIVED",1395502285,0,8a60fbee42d5379a8de65d3248a55a9c0b08998a04a905b73579e2e52d631efd,6785713862
20171024,"PAYMENT SENT",0,-1267423511,99cf5b694c7b7412a8a83d85eb5f4eed5e0f4911e3e2086a7f250bed033fa948,5390211577
20171023,"PAYMENT SENT",0,-10626642115,796aef37a7f0a9e549bf2814b8a71150a7c1e25032bf52bef42445de181bf9d5,6657635088
20171023,"PAYMENT RECEIVED",1376979305,0,297e75119a420492e1adf9b0f25613ecfcca1f846aac5ee6b635b6970b19599c,17284277203
20171022,"PAYMENT RECEIVED",1352096855,0,51673c5cd1cbd60cc996f97fef3a16453891595c40241930fc26cae1247ea233,15907297898
20171022,"PAYMENT RECEIVED",1349628273,0,c65f29cfd125dcc91d2ad1745cbd0f2ff85ef0050c22c03b875c0ee456aa06c3,14555201043
20171022,"PAYMENT RECEIVED",1295649190,0,cd3a34604986e5d176b3e289321b11b757f4b32050e01af6a1aa592cc65dc31c,13205572770
20171021,"PAYMENT RECEIVED",1360716020,0,ef1cf3b2fb5ae5cb170026bd134ae80bcbcad3f70a35cc02ddb485976572a6ac,11909923580
20171021,"PAYMENT RECEIVED",1298501737,0,12e4de0b5f7f010befa343f270d7d3a61952e62ac4d6f7657f139b6e2c66cc2c,10549207560
20171021,"PAYMENT SENT",0,-9810501945,d8d6dae759196bcb5d1dd43f303b7e0cb030b0d5f1ac7c478d72c5ddc0ba1dc7,9250705823
20171020,"PAYMENT RECEIVED",1284495958,0,ed2485481fae9a71b06ddf1df4057af61b2b398a86e94d1c56887fe82e49c5fb,19061207768
20171020,"PAYMENT RECEIVED",1351061776,0,f540d8aaeb7517b8dfd84bb5082d0ee4763340aebb9e67a079f8688385437e33,17776711810
20171019,"PAYMENT RECEIVED",1265614713,0,29e8396b57f4e13cfa27334b11a9e9b525dc341aefff02abf840ccedf9ff4338,16425650034
20171019,"PAYMENT RECEIVED",1363388638,0,50bff4a22a48d8ce087f6910339346b934f59a6ff6709cc51268ad9885b726fa,15160035321
20171019,"PAYMENT RECEIVED",1426446319,0,8bda4713141daf8db9f1ffce33d8ee74f56aa7747dca2f8a2898ead0180b5fde,13796646683
20171019,"PAYMENT RECEIVED",1425126439,0,e7365db74189dff6b7af0e3eb4b04f0e8ffd49d652e60df28a3c3b0efc73b9f2,12370200364
20171019,"PAYMENT RECEIVED",1362832365,0,10651c737e12c4a41573758ab7383423b9b8dffe0ed056b2777eebd0f0522b18,10945073925
20171019,"PAYMENT RECEIVED",1419903580,0,d8e4c92e9670ec0ea19c7f08e5339907045e7954d6cd7c4c542ea925f125a3b9,9582241560
20171018,"PAYMENT RECEIVED",1376639459,0,f3c19dc594c4840468cc5489daa311f2f366106206adca0e3cbbadef73bc69a7,8162337980
20171018,"PAYMENT RECEIVED",1288884679,0,552e7bd893a8deb22ccc3e9816904799d3eaaaf1a97f7fa178ea72c4687dd6e9,6785698521
20171018,"PAYMENT RECEIVED",1404258865,0,1900b4039f9478f797923823da9bec48fee268cf28bdc0fceaa0cec8103c26b8,5496813842
20171018,"PAYMENT SENT",0,-1400559226,aafccd52c23424d1f4b006dd6e3b64b6681fa6bbe05ed44d4452f39c6604a667,4092554977
20171017,"PAYMENT RECEIVED",1345648226,0,49a8b4201e480df7eabca18ad8362a4a59ca380f3f70b4c899b2058d73238346,5493114203
20171017,"PAYMENT RECEIVED",1479483240,0,9d9069443ae91457843ff8e5e3b1a34ed26a358118071f32dda2c41ebac1a72b,4147465977
20171017,"PAYMENT RECEIVED",1267423511,0,838bfefa25e275f59650fd6429345bede5735d74f7dad0d89377d026ed553ed1,2667982737
20171017,"PAYMENT SENT",0,-5487100024,fff3069dd62f8e44ae31ddf6c81a29149a9ffc1887205c7581662611755986e7,1400559226
20171016,"PAYMENT RECEIVED",1386738895,0,ba988be7ba4f355712fd07b0f5e758227497f15e5ff5272b36dfba50cc9c4cbe,6887659250
20171016,"PAYMENT RECEIVED",1378839076,0,488123743b926b6d85f66d5fbdaed593750e4d99a9ca6821d10b2aa730a48b29,5500920355
20171014,"PAYMENT RECEIVED",1414577783,0,1e0bfa6f38ee15e2d0dc5376ffbb6696351a3f797b1cc6e70059d673e3c2f6da,4122081279
20171014,"PAYMENT SENT",0,-6703693542,668282dbdc6b6bc8adcb3ad7ba2bc5674a9d972fd4dfb4e18e90ce7b8cfbbfc9,2707503496
20171013,"PAYMENT RECEIVED",1373373012,0,f0d4146ff898ee65504db995d76122248901ccf3c02492729658a49620916bc9,9411197038
20171010,"PAYMENT SENT",0,-5351312819,e74ce4b61f9e28eb15a437862ab3eb05457fc3386231571c843e73a5fcb99a7d,8037824026
20171010,"PAYMENT RECEIVED",1395600574,0,d39102427accc7af9862c35174f3f442c5dc6cfd71b19fdacf0d469cf6a1c707,13389136845
20171010,"PAYMENT RECEIVED",1400559226,0,5b36e37bf86da1f09e44d13afbdff771d0e25fad7ca9ecd9e409176aa3dbee2f,11993536271
20171010,"PAYMENT SENT",0,-5390361914,16729687ed3d6247bc152689ddd1d0f1361939e350d918909ac35608f892d1e9,10592977045
20171010,"PAYMENT RECEIVED",1316209897,0,f3d85bf6a2cb666c9b83ac6277b4672863ca0e2744f5fd0b78291a84c989f78b,15983338959
20171009,"PAYMENT RECEIVED",1289854637,0,091d1cee7a955d0bfd8e8bd7757c7d8007ee0b693fcda75e2f5a320f1913acf2,14667129062
20171009,"PAYMENT RECEIVED",1431411932,0,39fef91b86ccef96329514448349b5a0f627d7babae187bfe8d6fa455614495d,13377274425
20171008,"PAYMENT RECEIVED",1357601122,0,0f09401cc1ae2b0c94670012bbc16313843db3043cb7c2c25c33b0f4d0edffd7,11945862493
20171007,"PAYMENT RECEIVED",1286384918,0,926ae6eed4404469cda5095a4c144827d9ac1e6e8b456bbd6e4e71cefec8de1e,10588261371
20171007,"PAYMENT SENT",0,-6772473257,9bbb54ad3c1dcf2e3c6148c517e7cde3c7c04491b3f74424f83c6c3b5105e249,9301876453
20171006,"PAYMENT RECEIVED",1314963942,0,4f590c588a56032f520b4df9af564871d93b9da071c359e9a40119671eb99e86,16074349710
20171005,"PAYMENT RECEIVED",1377709181,0,4167a783adeccf4db25403b2271eeeea1a6c876b901e12043af83470f99b8897,14759385768
20171005,"PAYMENT RECEIVED",1408973379,0,f84ebfca968c6732c9a5807f3db70abba9b1209d3d1e4e74a91d4e6c2de8c4e2,13381676587
20171004,"PAYMENT RECEIVED",1271892478,0,d833fdfa8e80d1fb2b26e2f9fa463b3b34f90b3f81f766ec2cd680f86a32a796,11972703208
20171004,"PAYMENT SENT",0,-4154011352,a88a97aebec549837e361dc13129ec764cd11c3edb478def981381cdbdd20313,10700810730
20171004,"PAYMENT RECEIVED",1298458499,0,875640e279568df9bd0f4056ee6a5334b70abfb5a019d8b9906bb55e72054ad1,14854822082
20171004,"PAYMENT RECEIVED",1306944270,0,e3e0a99f62788df30a008ed1bb288bb22563b552269594f03e4c27c379b4ac3f,13556363583
20171003,"PAYMENT RECEIVED",1367539104,0,caf24bc7a18abfb5bed8d67631b21f1317d0eff8efc1f15a00aa836eb968e803,12249419313
20171003,"PAYMENT RECEIVED",1418492900,0,2c2357367eb138be20def51a4ea1f18102e9e07ad0f008f2cdc3886f198532a2,10881880209
20171003,"PAYMENT RECEIVED",1326400208,0,204748b3a32136cc18c129acadac7ede2bd809241602e151a06433d2f7682808,9463387309
20171002,"PAYMENT RECEIVED",1383309417,0,bf5a84ef12101b896c72b045b26bd87628ed10b36243beb017d3bfa496aed7e5,8136987101
20171001,"PAYMENT RECEIVED",1400196198,0,a7c81ba7edae4b9693b0a9d4e8c506d4662660e45a503622ee41584b1c65a045,6753677684
20171001,"PAYMENT RECEIVED",1320409977,0,2b5bcbde4831ded9bde44fadad22baab72c9402f9d18b63cb5e7c457537240cb,5353481486
20171001,"PAYMENT SENT",0,-6546029260,8436619406b278ec620bba504ef9f22d3e6eca42dd32bf0c4bccdb0882c94bd5,4033071509
20170930,"PAYMENT RECEIVED",1352704523,0,c1b4589cc90002f0aaeed2be18d4885cd3bea0eb3132fd1e6093dca4917301c0,10579100769
20170930,"PAYMENT RECEIVED",1370505737,0,41d782e8a797a4b0ec86cceeed551f09c1f9935602f24bf2c4c3dfcb35642acb,9226396246
20170930,"PAYMENT RECEIVED",1309861249,0,97434506f615c19d816fe4e476ae4a681349ecf5970defb87b75461e9e3606df,7855890509
20170930,"PAYMENT RECEIVED",1253454287,0,64934f17069720f4702ea29ba79919d4250c853f9103fe022665189d44d2a552,6546029260
20170930,"PAYMENT RECEIVED",1278818864,0,5895ac255fdf7989b98b08715e5eb191a957b56c5548a20e2dc1ee45c512a478,5292574973
20170929,"PAYMENT RECEIVED",1251575048,0,d5f72bd2bf3753e301498e865c4fc47a197c83baf82da38c87690f95a16142a7,4013756109
20170928,"PAYMENT RECEIVED",1392107422,0,c1ff2460427c975889e8bb62af6f0289c9d8e49990590de80869eeb59fd25f9d,2762181061
20170928,"PAYMENT RECEIVED",1370073639,0,abc6db4a056f78f09ea3888d4c4d5418d7292d1f5a327656a9a094952b1d0a97,1370073639
20170928,"PAYMENT SENT",0,-10902132424,a08a8000d4e97129516240447d3d1f596a02deba43c920b55a76056919a9b302,0
20170926,"PAYMENT RECEIVED",1390879093,0,1218ac1f98209620f039548db47e72665cd6814dbd7214ca341d3085863182c8,10902132424
20170926,"PAYMENT RECEIVED",1265013669,0,c3f18562b33f535bb81931e2b8c060e15609428e608f66d1ffc5104d35497c45,9511253331
20170925,"PAYMENT RECEIVED",1430420488,0,11caf492656a6fd2372088d9f718bed7553b55a93f2fb144eab6ee526faf04bc,8246239662
20170925,"PAYMENT RECEIVED",1434389671,0,86efb8ad79989143fe36241c13485dfd5d14eaf02606ff6f2a7ede5e151ce2c0,6815819174
20170925,"PAYMENT SENT",0,-5037508367,46c8c1445d90be3fc5f96fb9e1973719a07c069cfc23bcfd47244c5438221faf,5381429503
20170925,"PAYMENT SENT",0,-4117947534,9715d882e0d69165b53001f461cfc8054b06503d4c102178c0d4b3f7a6b26f52,10418937870
20170924,"PAYMENT RECEIVED",1400898195,0,47df65563890ce5227baf086c4053262be1f35bd7243c3e71db4c713a568b3db,14536885404
20170924,"PAYMENT RECEIVED",1336496822,0,e922f3b361d10b8ba7d4bf37897a689f71e50a8703fcd9b99ab111516b024d0d,13135987209
20170923,"PAYMENT RECEIVED",1263924869,0,d7ac2a816f97452c6c0c1d33ce932cadb104d040cdad941818099c1f4fb13299,11799490387
20170923,"PAYMENT RECEIVED",1324520751,0,2786f4ba399bd8c8baca326fbca5f8ebf4548d0801889e92ea95ce2ae4ae7f5e,10535565518
20170923,"PAYMENT RECEIVED",1417224550,0,8251e9645139e186267ed7956118965c3785e14be0cdb11b325022d695edc165,9211044767
20170922,"PAYMENT RECEIVED",1387303055,0,3abf3e57f1bc4374940278c96932560e555a89f356b456ce8b3deb0c4d417214,7793820217
20170922,"PAYMENT RECEIVED",1319513735,0,ce45db1edf8cca198c15f79f9fc8d199a2f67f3dd2584b1ff5ee4892cfe41aa5,6406517162
20170922,"PAYMENT SENT",0,-5534582858,787ea31fee9f21eb4324349d1ebca194c6d0fc49e65720c614166ab3a18efd30,5087003427
20170922,"PAYMENT RECEIVED",1256043987,0,93f926f95ac3aa5300f2dbab55135471cbe882f6e1e061284d8df4c31b50e077,10621586285
20170921,"PAYMENT RECEIVED",1265165809,0,60174e4a8b78126ae8d8f8d72721525eda403312d1601ce79f3dfc5e5be0ecdd,9365542298
20170921,"PAYMENT RECEIVED",1313419929,0,210831772d74be624c1090c11a31b68195a2d0078e52a7db0b95a93f8ae6dc42,8100376489
20170920,"PAYMENT RECEIVED",1415628513,0,d65911b869c717edbc1724e1efddb44cf6d28b340c151f8c63eeef47fac26879,6786956560
20170919,"PAYMENT RECEIVED",1396279715,0,eda28448be03028e6a531a57368c0868eb7807031df20282d38ce51ec817ce6a,5371328047
20170919,"PAYMENT SENT",0,-8004019239,893b9ab9820d4f95dcbeed0024da7d27fa047fef906b4c38d9e9a7e257a64284,3975048332
20170918,"PAYMENT RECEIVED",1385182570,0,6cb63c08d4d2b7fe06f2a314081c3c3add7f25ac61f1b7a0c025683589923d3a,11979067571
20170917,"PAYMENT RECEIVED",1285022481,0,34497c037dfe25d9baa9f53541d192db51692290839600c0272426f2a6a26032,10593885001
20170917,"PAYMENT RECEIVED",1398514904,0,b48822d6d3b2cdb997d790a95ce29f7b54ff73f8a52d8d8f6ce2072cb2fe44b9,9308862520
20170917,"PAYMENT RECEIVED",1323118304,0,d4c5995e72cb94a6155b50e2af88699b4904a32eb17f11f31ebad34991cbe0df,7910347616
20170916,"PAYMENT RECEIVED",1308383034,0,6e1fb7d0aaea348b4ceb823db921efcaa2ff10b3afd84f7cba8f4a62e4cc83a4,6587229312
20170916,"PAYMENT RECEIVED",1414892621,0,1d511c04aba5a02c51f305addd516a29494f3aeebb6fb37dc80c6689a1aec48f,5278846278
20170916,"PAYMENT SENT",0,-2577075241,7dca949d2ec455e7fdbdd13baad5960f54451cac1831e8f0966aaadecc6e1656,3863953657
20170915,"PAYMENT RECEIVED",1274087895,0,96a98e16b69cc7bd4914f3f308e4a94135118f76e0c4c3d4ccdc5840ca5a5b63,6441028898
20170914,"PAYMENT RECEIVED",1250582829,0,1d842780c18479132da14d9d580b8e7d3fed556a6c3f8fd2f779fba3eb5deaa1,5166941003
20170913,"PAYMENT RECEIVED",1326492412,0,cff0cfaa4a51075bb2da6fdaf5f04217a1e2460831b1b9f59b502d34a02ef974,3916358174
20170913,"PAYMENT SENT",0,-8090340447,42c41495368c16808e3cc09da23f0a5e3431ebc08760d6c62933311a1c5f52bb,2589865762
20170912,"PAYMENT RECEIVED",1252373702,0,2d01715cdb420a44526cb841351f0b24e31efbd8fb9d744acc7678bff71e03b1,10680206209
20170912,"PAYMENT RECEIVED",1360252741,0,32acd1356a221d6ffd5ea2b1be12af47e6fad3c34df8344fd918e43bab996b5d,9427832507
20170911,"PAYMENT RECEIVED",1434549986,0,71c50dc20acb808110f8e590936af127a8fe5b4090b6d3b754cfc68817788af3,8067579766
20170910,"PAYMENT RECEIVED",1353767990,0,8ab48a20ffe50204a6e7e84242a456733cc89748e6419ca8cfd8f866c9c263b1,6633029780
20170909,"PAYMENT SENT",0,-9742865123,ff628cbdf79796e5e9b0e35cd01991041a4bacf23e41a6d14f9f998a0b52637f,5279261790
20170907,"PAYMENT RECEIVED",1536701857,0,1db82ac7b92b127aa1be84c8cf19d4dda1a9da8a9b17871e0fb402d4df551629,15022126913
20170906,"PAYMENT RECEIVED",1252749063,0,29a6e7a4495e989fdbf4714b94e5461c74a033bd7b4033f87429042bd613d07c,13485425056
20170906,"PAYMENT RECEIVED",1522063186,0,7c8a941d4461f00fc2bb03f311a143c92186994be623cf5461bd0219f70a62a9,12232675993
20170906,"PAYMENT SENT",0,-8597678212,26c380f78832d29268fe55937a803b83836e8268c03114b78de5f8fbda89dfd2,10710612807
20170906,"PAYMENT RECEIVED",1356682968,0,ede62165399ab3d738f24c4a87e85b03900e9d094ec21ac6f20194dec5acb012,19308291019
20170906,"PAYMENT RECEIVED",1294626852,0,6bc977623ce44b4fae92eb1f730d8241c3f7800a02fe0c65aeff2605e7ed3bac,17951608051
20170905,"PAYMENT RECEIVED",1337492060,0,a6e96e5faa65677f01e9c2c8558ed1da72fbc00eae985df2e365960cc74fe645,16656981199
20170905,"PAYMENT RECEIVED",1542564358,0,4a3d61312dc00cdcf5883e9ab16820273e2a543366fbfff066d6fd8b0153685c,15319489139
20170905,"PAYMENT RECEIVED",1381199113,0,d0846debf31b17580a22d1bc9795701d4a1fa089ea7c5fbe1591deb56e14b4bd,13776924781
20170905,"PAYMENT RECEIVED",1290459910,0,0b6c321658c5010134e18cf6621680aafb04c7255d0a372bc7acdb682052e452,12395725668
20170904,"PAYMENT RECEIVED",1536653805,0,aef4118bced39325ec04cd8bb36f824ec17e3f4dcb4735584c0463fa6c471547,11105265758
20170904,"PAYMENT SENT",0,-2621402797,73a4a2f62df07eaf00f57e1e4cfd1e2b5a3e0e958ac8fbf649a6f56850311b05,9568611953
20170902,"PAYMENT RECEIVED",1258077314,0,f1f811ea04091b8c2312b03521452737d5441f1c41d04367b17cc60fa77f4ad2,12190014750
20170902,"PAYMENT RECEIVED",1255479608,0,327c2062a8786a2594f3fbb9ba62c0224f5559bd3d8ef759f53d318ff97a43ff,10931937436
20170902,"PAYMENT RECEIVED",1442341873,0,c06c884f1f2d7cdb9d5e3d93ec4773a28abae1f3ad2ad29509c8f4bb86648795,9676457828
20170901,"PAYMENT RECEIVED",1388290712,0,0cfaf17f9a66deb1db5155fe4179762b894e64fb522cfc0f6fcc61567d8ac56c,8234115955
20170901,"PAYMENT RECEIVED",1349732717,0,fcc439a2fb7d45ac81c2ce2e8e726e5f7df5cda1d3ed657b94813667f1b5047e,6845825243
20170901,"PAYMENT RECEIVED",1320448091,0,1a6c5b4d6fed55b370fc68847696e3fa6d33b96fd944b992925ed7c9772eeb11,5496092526
20170901,"PAYMENT SENT",0,-7684988362,8143b24abc59d96d513d95f4b5ce11aa1e9d8c20e12acd93bac4d5b7b088ff45,4175644435
20170831,"PAYMENT RECEIVED",1481728967,0,8e3bacbb5f46177344b947e0ba3c64a410261a6fe21e0603126581e247d3844d,11860632797
20170831,"PAYMENT RECEIVED",1300954706,0,755e67f74d4cff5b694169f3557050d7eef97dd7e1c21f37bdb13a8108fbf656,10378903830
20170831,"PAYMENT RECEIVED",1725762814,0,ef4a10e039ed640e3f5cdd5295e4aef332be0b863ef50ae5d66521341a5224b4,9077949124
20170830,"PAYMENT RECEIVED",1558488888,0,8930c10891e0f56bbbb737c6e8752e6ef8715257bef46a589f2704ad9f8ccd16,7352186310
20170830,"PAYMENT RECEIVED",1392960762,0,63c26e61f804584b11960373abf3c960a3763687bad581cc91d42e5c23d16ce5,5793697422
20170830,"PAYMENT RECEIVED",1342965910,0,fe884077fea3fa9eec7785c1824cbb88395a4d6625d16192f394306a98738273,4400736660
20170830,"PAYMENT SENT",0,-6037805684,e52e2be968a5dbbf45ecb4124fde8f4484bec879917b2a044ed36de0e4cdf72a,3057770750
20170829,"PAYMENT RECEIVED",1618818297,0,280c14fcda6ad5e6fae69e8873257dcc1b2d8a0df47cce7449a50c04211ac4b9,9095576434
20170828,"PAYMENT SENT",0,-3375226999,9c45367766a0606dd125c8acc2250ae3af252775d355334314fee78216525525,7476758137
20170827,"PAYMENT RECEIVED",1438952453,0,5b930483da508e303e459a44ef476a7e2ba8f6d137e214137ee612dcdd8aa5cd,10851985136
20170827,"PAYMENT RECEIVED",1520555554,0,af4d34637c6c4f7d0781e999fe1682e8271e52325252ffc023e3e7abe3d1ca99,9413032683
20170827,"PAYMENT RECEIVED",1514758825,0,bc636742389ba79ed694bdce2fa86a0f7c7cc6affd780de8ebf1b5af071f9cc6,7892477129
20170827,"PAYMENT RECEIVED",1736767715,0,2f54786345ddfac3ae3d705919347221085b5870c864599d3bd6ccc1d496344b,6377718304
20170826,"PAYMENT RECEIVED",1638459284,0,3436c5fbacdd8c8c907f85bbc49cfee6fc1ec92681514446fadcf498240277f1,4640950589
20170826,"PAYMENT RECEIVED",1649798554,0,0f814ab55a4940480ebbb8951b1fe8451e651db4b4b04bc43b64bcda0f517725,3002491305
20170825,"PAYMENT SENT",0,-2712747334,1d3cdd5738ac26c28d89c435072a0c475d77c4fbda971567480be4411afa5ddb,1352692751
20170822,"PAYMENT SENT",0,-9080118016,f2c362b5cfa8c50961babaa1c6b2eab90af72686194a7b473e9e0bf6349c39af,4065440085
20170821,"PAYMENT RECEIVED",1527342334,0,f386647763bba9f0d380693af8117ab2c954ee7b04860f41b8a78099735c9a1b,13145558101
20170821,"PAYMENT RECEIVED",1564934870,0,6b90c6edb56b1779f8f34a88c26163203ff9077825d13eb3de93bf3bfa4468b6,11618215767
20170820,"PAYMENT RECEIVED",1470812612,0,6dc0d556f2a58831e0cfc4cdc24aded801c5112994390792a0dc9751584f50ba,10053280897
20170820,"PAYMENT RECEIVED",1508885375,0,ce1729766da3a11d99531b1f76934b9ee09a2182f02016405d5d9e2db87ae2ea,8582468285
20170820,"PAYMENT RECEIVED",1464580031,0,41a814c7a5beb044bc02087b5fd8b7ceecc8cacf65418ebe9db79ced3b677b3b,7073582910
20170820,"PAYMENT RECEIVED",1264552666,0,1cc11eb9f5113d42c49f73d3f88b518efb243167f4ec4c8398d242662fd33418,5609002879
20170820,"PAYMENT SENT",0,-2936761138,6257aed41c2d68b1168e92b3f00407205c8d8749a2a6944c9687d1fed5799cc0,4344450213
20170819,"PAYMENT RECEIVED",1352692751,0,f2d0782b962390f48932584cde6b688f42956cc924f4027ac34c774598351ceb,7281211351
20170819,"PAYMENT RECEIVED",1543562794,0,36e1af68303f69576c15071e0a5789f732fd37fa8d61fa0d5b65c6466146806c,5928518600
20170819,"PAYMENT SENT",0,-1540675303,ba5d71a05c60b405aded55d48a7d83fb784c647234af306221f71cd54d7b3ae3,4384955806
20170818,"PAYMENT RECEIVED",1448194668,0,cbf555321e8f23e677d15079ffd5b8f26a56cf7d77f810f4cd4cf56b14b22c09,5925631109
20170818,"PAYMENT SENT",0,-4601526596,b07d8775a783c95094ef97f46e6799c9f9225e69060aedfd204d2c34d4f302f0,4477436441
20170817,"PAYMENT RECEIVED",1541754958,0,80cccc73622c7ae94a42358648f0ccb5514964580c9a7f5c95dc000d4eb9ef0e,9078963037
20170817,"PAYMENT RECEIVED",1418168301,0,b35768dded0fe57b7ebdf89ccab6b2023a04a5d63312847a0ae899d73ae2a72c,7537208079
20170816,"PAYMENT RECEIVED",1491106376,0,385b16d15d4c1ab0b0ea8f369631a55a347c7c093a34f2b1c244cf161e8c144d,6119039778
20170816,"PAYMENT RECEIVED",1568665262,0,713200cb4f0ab1f0aadc9c2cb761c37c58e2119eb9decf1b14d823dfb1019ed3,4627933402
20170815,"PAYMENT RECEIVED",1518592837,0,f6352f456f04191847ed98702bac417320560bbea5312b3f1b52f64992a02959,3059268140
20170815,"PAYMENT RECEIVED",1540675303,0,148911a99b503a94a8b1b8f4ce8011b48ab11758de4f90c3ffc8723c34cfc42c,1540675303
20170805,"PAYMENT SENT",0,-1332038453,d1c51e10bb8f0b323f31b3a041191801e8088db920d18482ad60e0337bfb3a2b,0
20170804,"PAYMENT SENT",0,-1368436013,74539b93c06c76159a2f00fb4c54675a5107677654ea45d645ef55585b66c038,1332038453
20170801,"PAYMENT RECEIVED",1332028453,0,7475940aba9210e75d1ab1121fa2815c319317d076f99c1bcf12e5a24b0d3ad1,2700474466
20170801,"PAYMENT RECEIVED",1368436013,0,21b5192c99152fdb050fb73c685d868dfcdd72f729dbd191c0eef0f264bf1330,1368446013
20170730,"PAYMENT RECEIVED",10000,0,f41a131a1e0c1c9bd0a07f10ad53248005e776e577edcc94a63718ad91fae6b3,10000
